width 66
height 66
@@@@@@@@@@@@@.....@@..@........@...@@@@@@@@@@@@@@@@@........@@@@@@
@@@@@@@@@...@@.....@.....@.........@@@@@@@@@@@@@@@@....@@....@@@@@
@@@@@@@@@@....@..@.@........@.......@@.@@@@@@@@@@....@......@@@@@@
@@@@@@@@@@....@....@@..............@@...@@@@@@@@@@...@......@@@@@@
@@@@@@@@@@....@....................@@...@@@@@@@@@@........@.@@@@@@
@@@@@@@@@@@..............@@@@.....@@@...@@@@@@@@@@@............@@@
@@@@@@@@@@.............@.@@@@.............@@@@@@..@...............
@@@@@@@@@......@.@.........@@.............@@@@@@..................
@@@@@@@@@@......@@.............@.............@@@..@...@@@..@@@@@.@
@@@@@@..........@@@...............@.........................@@@@..
@@@@@@@...@.................@.....@.............@............@@@@@
@@@@@.@@...@@.........@...........@@@.@..........................@
@@@@@.............@...............@@@@@............@.............@
@@@@@@...........@@..........................................@....
@@@@@@@.........@@@..........................@....@.....@.........
@@@@@@..........@@.........@...........@.....@....@....@@@........
@@@@@@..@@@................@@@.........@..........@.....@@........
@@@@@@...@@@@@.@@.........@@@@.@...........................@@.....
@@@@@@@@..@@@..........@.@@@................................@.....
@@@@@@@@...@@........@@@@@@@...........@..................@.......
@@@@@@@...........@....@@@@@.@@................@..........@@@@....
@@@@@@@...@..............@...@@.........................@.........
@@@@@@@......................@.........@..............@..@@.......
@@@@@@@.................@.........................................
@@@@@@@@................@..............@...............@..........
@@@@@@@..@.....@......@........@.......................@..........
.@@@@@.@@@@@...@............@....@....................@@......@...
.@@@@..@@@@@......@@@.............@...........................@@@.
..@@...@@@@@@@.....@@.............................................
@.........@@@@@....@@.........@.................@....@............
@...@........@@....@@@...............@............................
@...........@......@@@........@@.....@.......@......@........@....
@..................@@@@@.......@..@@........................@@@@..
...........@.......@@@@@.......@.@@@.......................@@@@@..
@..................@@@@@@@.....@@@@.....@................@@@@@@@.@
...................@@@@@@......@......................@..@@@@@@@@@
..................@@@@@@@.@.........@.@..................@@@@@@@@@
.................@@@@@@@@@@@.....@@@@@@...............@@@@@@@@@@@@
..@@....@.........@@@@@@@@@@@....@@@@@@@@@..............@@@@@@@@@@
....................@@@@@@@@@@@@@@@@@@@@@.....@.........@@@@@@@@@@
.@..................@@@@@@@@@@@@@@@@@@@@@.....@@........@@@@@@@@@@
...@......@@@........@@@@@@@@@@@@@@@@@@@@@..@@@@@.......@@@@@@@@@@
@...........@@......@@@@@@@@@@@@@@@@@@@@@..@@@@@.....@@@@@@@@@@@@@
...@................@@@@@@@@@@@@@@@@@@@@@@@@@@@@.@.@@@@@@@@@@@@@@@
...@@@@@@..........@@@@@@@@@@@@@@@@@@@@@@@@@@@@@@@.@@@@@@@@@@@@@@@
...@@@@@@..........@@@@@@@@@@@@@@@@@@@@@@@@@@@@@@@@@@@@@@@@@@@@@@@
@........@.........@@@@@@@@@@@@@@@@@@@@@@@@@@@@@@@@@@@@@@@@@@@@@@@
.....@.............@@@@@@@@@@@@@@@@@@@@@@@@@@@@@@@@@@@@@@@@@@@@@@@
...@@@..............@@@@@@@@@@@@@@@@@@@@@@@@@@@@@@@@@@@@@@@@@@@@@@
@@@@@........@@@....@@@@@@@@@@@@@@@@@@@@@@@@@@@@@@@@@@@@@@@@@@@@@@
@@@@.................@@@@@@@@@@@@@@@@@@@@@@@@@@@@@@@@@@@@@@@@@@@@@
@@@@.................@@@@@@@@@@@@@@@@@@@@@@@@@@@@@@@@@@@@@@@@@@@@@
@@@@@...........@...@@@@@@@@@@@@@@@@@@@@@@@@@@@@@@@@@@@@@@@@@@@@@@
@@@@..................@@@@@@@@@@@@@@@@@@@@@@@@@@@@@@@@@@@@@@@@@@@@
@@@@@.................@@@@@@@@@@@@@@@@@@@@@@@@@@@@@@@@@@@@@@@@@@@@
@@@@@...............@..@@@@@@@@@@@@@@@@@@@@@@@@@@@@@@@@@@@@@@@@@@@
@@@@............@..@@@@@@@@@@@@@@@@@@@@@@@@@@@@@@@@@@@@@@@@@@@@@@@
@@@@................@@@@@@@@@@@@@@@@@@@@@@@@@@@@@@@@@@@@@@@@@@@@@@
@@@@@@..............@@@@@@@@@@@@@@@@@@@@@@@@@@@@@@@@@@@@@@@@@@@@@@
@@@@@......@@.......@@@@@@@@@@@@@@@@@@@@@@@@@@@@@@@@@@@@@@@@@@@@@@
@@@@@@@....@@@@@@..@@@@@@@@@@@@@@@@@@@@@@@@@@@@@@@@@@@@@@@@@@@@@@@
@@@@@@@.....@@@@@...@@@@@@@@@@@@@@@@@@@@@@@@@@@@@@@@@@@@@@@@@@@@@@
@@@@@@@@@@..@@@@@.....@@@@@@@@@@@@@@@@@@@@@@@@@@@@@@@@@@@@@@@@@@@@
@@@@@@@@@@@@@@@@@@@@@@@@@@@@@@@@@@@@@@@@@@@@@@@@@@@@@@@@@@@@@@@@@@
@@@@@@@@@@@@@@@@@@@@@@@@@@@@@@@@@@@@@@@@@@@@@@@@@@@@@@@@@@@@@@@@@@
@@@@@@@@@@@@@@@@@@@@@@@@@@@@@@@@@@@@@@@@@@@@@@@@@@@@@@@@@@@@@@@@@@
8
31 11 0
17 59 0
38 16 0
3 37 0
16 11 0
57 32 0
20 10 0
30 17 0

5 56 0
12 58 0
13 44 0
31 20 0
14 15 0
45 10 0
19 43 0
39 31 0
