width 66
height 66
@@@@@@@@@@@@...@...@@............@@@@@@@@@@@@@@@@@@@@@@@@@@@@@@@@@
@@@@@@@@@@@@.....................@@@@@@@@@@@@@@@@@@@@@@@@@@@@@@@@@
@@@@@@@...@@@.....................@@@@@@@@@@@@@@@@@@@@@@@@@@@@@@@@
@@@@@@@......................@...@@@@@@@@@@@@@@@.@@@@@@@@@@@@@@@@@
@@@@@@@@.....................@.....@@@@@@@@@@@...@@@@@@@@@@@@@@@@@
.@@@@@@@................@............@@@@@@@@@....@@@@@@@@@@@@@@@@
.@@@@@@@................@@.........@.@@@@@.@@@....@@@@@@@@@@@@@@@@
...@@@@@@@........@@....................@@..@.....@@@@@@@@@@@@@@@@
@...@@@@...............@@.....@.........@@.........@@@@@@@@@@@@@@@
..@@@@...........@.........@@........................@@@@@@@@@@@@@
..@@@@................@@...@@@...................@...@@@@@@@@@@@@@
..@@........@........@@@.@@@@@@@........@..............@@@@@@@@@@@
...........@@@.......@@@.@@@@@@........@@...........@...@@@@@@@@@@
@@........@@@@..@@.....@.@@@@@..@@@@@@@@............@...@@@@@@@@@@
..........@@@@.....@...@@@@@@@@..@@@@@@@......@@....@......@@@@@@@
...@..@.....@@..........@@@@@@@...@@@@......................@@@@@@
............@.......@@@.@@@@@...@@@@@@..........@@..@....@@..@@@@@
....@.......@....@@@@@@@@@.@@...@@@@@@...@................@..@@@@@
@@@................@@@@@@@......@......@....................@@@@@@
@@.................@@@..@.@..................................@@@@@
@@.........@........@@.........@...........@.....@......@...@@@@@@
....@...............@.........................@..@..........@@@@@@
@....@..........@.@...........................@..@..@.@........@@@
@@@..@..................@@@@@..@@.............@.................@@
@@@@@@...@..@...........@@@@...@@..........................@....@@
@@@@@@..@@..@@..........@@@@..............@..............@@@.....@
@@@@@...@@..@@..@.......@@@@...............@.......@@..@@@@@@.....
@@@......................@@................@..............@@.....@
@@......................@.................@.......@.............@@
@...............@.......@....@@.@................@@..........@..@@
@.............@........@@..@.@..@.....@.........@@@@............@@
@.........@............@...............@@..@..@@@.............@@@@
@@@@@.@@@..@......@....................@@.....................@.@@
@@@@@@@@@....@.@.....................@@@@..........@............@@
@@@@@@@...@...........@@....@@@@....@@@@@.........@....@........@@
@@@@@@@.....................@@@.....@@@@@........@@...@.....@.@@@@
@@@@@@@.......@@...............@.......@@@@.......@.@@@.....@@@@@@
@@@@@@@@@....................@.@........@.....@@@.@@@@.......@@@@@
@@@@@@@@@@...................@@@........@......@@...@@@......@@@@@
@@@@@@@@@.........@.......@..@@@@@......@@.....@@.....@.......@@@@
@@@@@@.@..........@.@.......@@@@@@..@...@..@....@......@@@@...@@@@
@@@@@@....@@......@@@..@.....@@@@..@............@...@..@@@....@@@@
@@@@@@........@....@@..@.@...@@@..............@..........@@...@@@@
@@@@@@.@@..........@@........@@............@@................@@@@@
@@@@@@.....@..@................................@...............@@@
@@@@@@@.................@.....................@@............@...@@
@@@@@@@..@.........@........@.................@@@@..@@@.........@@
@@@@@@@.@@@...@....@@@............@@@.@@......@@@@..@@@@@@@@.....@
@@@@@@@..@@.........@@@@@......@...@@.@@......@@@@@..@@@@@@@@....@
@@@@@@@@@@@@........@@@@@@@@........@@@@@....@@@@@..@@@@@@@@.....@
@@@@@@@@@@@.....@...@@@@@@@@........@..@@..@@@@@@@@@@@@@@@@@@@.@@@
@@@@@@@@@@@.....@@@@@@@@@@@.........@.....@@@@@@@@@@@@@@@@@@@@@@@@
@@@@@@@@@@@.....@@@@@@@@@@@@............@@@@@@@@@@@@@@@@@@@@@@@@@@
@@@@@@@@@@@@@@@@@@@@@@@@@@@...........@.@@@@@@@@@@@@@@@@@@@@@@@@@@
@@@@@@@@@@@@@@@@@@@@@@@@@@@@..@@.........@@@@@@@@@@@@@@@@@@@@@@@@@
@@@@@@@@@@@@@@@@@@@@@@@@@@...@@@.........@@@@@@@@@@@@@@@@@@@@@@@@@
@@@@@@@@@@@@@@@@@@@@@@@@@@...@@..........@@@@@@@@@@@@@@@@@@@@@@@@@
@@@@@@@@@@@@@@@@@@@@@@@@@@...@.........@@@@@@@@@@@@@@@@@@@@@@@@@@@
@@@@@@@@@@@@@@@@@@@@@@@@@@@............@@@@@@@@@@@@@@@@@@@@@@@@@@@
@@@@@@@@@@@@@@@@@@@@@@@@@@@@.........@..@@..@@@@@@@@@@@@@@@@@@@@@@
@@@@@@@@@@@@@@@@@@@@@@@@@@@@@@............@.@@@@@@@@@@@@@@@@@@@@@@
@@@@@@@@@@@@@@@@@@@@@@@@@@@@@@..............@@@@@@@@@@@@@@@@@@@@@@
@@@@@@@@@@@@@@@@@@@@@@@@@@@@@@@@.......@.....@@@@@@@@@@@@@@@@@@@@@
@@@@@@@@@@@@@@@@@@@@@@@@@@@@@@@@@........@..@@@@@@@@@@@@@@@@@@@@@@
@@@@@@@@@@@@@@@@@@@@@@@@@@@@@@@@@.......@@..@@@@@@@@@@@@@@@@@@@@@@
@@@@@@@@@@@@@@@@@@@@@@@@@@@@@@@@@@.@@...@@@@@@@@@@@@@@@@@@@@@@@@@@
8
21 24 0
10 22 0
20 36 0
33 63 0
52 45 0
59 34 0
40 55 0
33 8 0

14 50 0
8 13 0
60 41 0
38 12 0
9 33 0
46 19 0
3 31 0
49 5 0
