width 66
height 66
@@@@@@@@@@@@@@@@........@@@@@@@@@@@.....@@@.....@@@@......@@@@....
@@@@@@@@@@@@@@@@....@....@@@@@@@@@......@@@......@@@....@........@
@@@@@@@@@@@@@@@..........@@@@@@..........@@.......@@@@...........@
@@@@@@@@@@@@@@......@..@...@.@@@..............@@...@@@...........@
@@@@@@@@@@@@@@@@@@@....@...@..................@..@.@@@....@...@@@@
@@@@@@@@@@@@@@@@@@@@...@.....@..@..........@.......@@@..........@@
@@@@@@@@@@@@@@@@@......@.....@..@@........@@.......@@@........@...
@@@@@@@@@@@@@@@@@......@..................@@......@@@@@..........@
@@@@@@@@@@@@@@@@@......@.................@.@....@@@@@@@.........@@
@@@@@@@@@@@@@@@@@@@@@..@....@.@@@........@.@....@....@.........@@@
@@@@@@@@@@@@@@@@@@@@@..@.....@@@...............................@@@
@@@@@@@@@@@@@@@@@@@@@..@@...@@@@..................@..@.........@@@
@@@@@@@@@@@@@@@@@@@@...@....@@@@....@@@.............@.....@@@@@@@@
@@@@@@@@@@@@@@@@@@@@@@...............@@..@................@@@@@@@@
@@@@@@@@@@@@@@@@@@@@@@..@............@......@@@.........@@@@@@@@@@
@@@@@@@@@@@@@@@@@@@@@.........@........@..@..@............@@@@@@@@
@@@@@@@@@@@@@@@@@.@@@................@..@.................@@@@@@@@
@@@@@@@@@@@@@@@@....@................@.@...............@..@@@@@@@@
@@@@@@@@@@@@@@.......................@....................@@@@@@@@
@@@@@@@@@@@@@@.........@...................@@........@..@@@@@@@@@@
@@@@@@@@@@@@....@@....@@@.............@...@@....@@@......@@@@@@@@@
@@@@@@@@@@@.....@@......@..@.............@......@.........@@@@@@@@
@@@@@@@@@@@....................@.........@......@@........@.@@@@@@
@@@@@@@@@@@....@......................@..@@..............@..@@@@@@
@@@@@@@@@@@@...@@@................@...@@...............@....@@@@@@
@@@@@@@@@@@@..@@@@..........@@........@@@@.............@..@@@@@@@@
@@@@@@@@@@@@...............@@@@..@@...@@@@.@@@......@.....@@@@....
@@@@@@@@@@@@@@@@@@....@....@@@@@@@@@..@@@@.@@@................@...
@@@@@@@@@@@@@@@@@@....@......@@@@@@@...@.....@..........@.........
@@@@@@@@@@@@@@@@@@.........@.@@@@@@@............................@.
@@@@@@@@@@@@@@@@@@........@..@...@@@....@.@@.............@@.......
@@@@@@@@@@@@@@@@@@@@.....@@......@@......@@@@................@@@@@
@@@@@@@@@@@@@@@@@@@@@@............@....@@@@@................@@@@@@
@@@@@@@@@@@@@@@@@@@@@@....................@@........@........@@@@@
@@@@@@@@@@@@@@@@@@@@@@..........................................@@
@@@@@@@@@@@@@@@@@@@@@@........................................@@@@
@@@@@@@@@@@@@@@@@@@@@@..@@..........@@.........@..............@@@@
@@@@@@@@@@@@@@@@@@@@@@@@@@......@..@@@...............@@.......@@@@
@@@@@@@@@@@@@@@@@@@@@@@@@@............@@.............@......@@@@@@
@@@@@@@@@@@@@@@@@@@@@@@@@@............@@.............@...@@@@@@@@.
@@@@@@@@@@@@@@@@@@@@@@@@@.....@.@..@@@@@..................@.......
@@@@@@@@@@@@@@@@@@@@@@@@@@.........@@@@@@.........................
@@@@@@@@@@@@@@@@@@@@@@@@@..........@@.................@.......@@..
@@@@@@@@@@@@@@@@@@@@@@@@@.....@....@...................@@......@@@
@@@@@@@@@@@@@@@@@@@@@@@@@....@@...............@............@....@@
@@@@@@@@@@@@@@@@@@@@@@@@.....@@.@..............................@@@
@@@@@@@@@@@@@@@@@@@@@@@@.....@@.....................@@.....@@@@@@@
@@@@@@@@@@@@@@@@@@@@@@@@...............................@...@@@@@@@
@@@@@@@@@@@@@@@@@@@@@@.@...................................@@@@@@@
@@@@@@@@@@@@@@@@@@@............@@.........................@@@@@@@@
@@@@@@@@@@@@.................@.....@...............@..@...@@@@@@@@
@@@@@@@@@@@@.......@@@.............................@@@@.......@@@@
@@@@@@@@@@@@..@....@.....@.........................@@........@@@@@
@@@@@@@@@..@.@@@.........@.....@................@.........@@@@@@@@
@@@@@@@@@....@@@.......@.@.....@@...@..............@.....@@@@@@@@@
@@@@@@@@@....@@@@..........@@.@@@..........@....@@@@...@@@@@@@@@@@
...@@.@@@....@@.@@.............@@@........@@....@@@@@@@@@@@@@@@@@@
.................@...........@@@@@...@..........@@@@@@@@@@@@@@@@@@
.....@........@........@.....@@@@@...@.@...@@@@.@@@@@@@@@@@@@@@@@@
@....@@.....@.@......@@......@@@@.......@..@@@@...@@@@@@@@@@@@@@@@
@@....@.................@@......@@@........@@@@...@@@@@@@@@@@@@@@@
@@@....@................@........@@........@@....@@@@@@@@@@@@@@@@@
@@.....@@@..............@..................@.....@@@@@@@@@@@@@@@@@
.......@@@@...............@@@.......@@.........@@@@@@@@@@@@@@@@@@@
.......@@............@@.@@@@@@.....@@..........@@@@@@@@@@@@@@@@@@@
........@@@.....@@.@@@@...@@@@..@..@@.....@@...@@@@@@@@@@@@@@@@@@@
8
50 37 0
46 0 0
56 9 0
62 29 0
61 4 0
55 31 0
20 64 0
41 5 0

46 16 0
43 0 0
1 59 0
23 53 0
26 23 0
1 64 0
19 60 0
10 64 0
