width 66
height 66
@@@@@........................@@@.....@@....@...@@@@@@@@@@@@@@@@@@@
@@@@@..................@..........@........@@..@@@@@@@@@@@@@@@@@@@
@@@@@..........@@......@..@................@...@@@@@@@@@@@@@@@@@@@
@@@@..........@@@@@................................@@@@@@@@@@@@@@@
@.............@@@@@............@@@..................@@@@@@@@@@@@@@
@..@@@........@@@@@@....@......@@@..................@@@@@@@@@@@@@@
....@@....@...@@@..@.....@@@...@....................@@@@@@@@@@@@@@
.............@@@.....@.@.............................@@@@@@@@@@@@@
.....@...............@@@..............................@@@@@@@@@@@@
.......@.@@@.........@@....................@.....@.....@@@@@@@@@@@
...@..@..@@@........@@@........................@@@.@.......@@@@@@@
..........@@@@...@@@@@@@........@..........................@@@@@@@
...........@@@...@@@@@@@...@@@....................................
..@@.@@@@..@@@@@..@@@@@@@....@.....@.....@..@@@@..................
.@@@.@@@@@.@@@@@@....@@@@@........@@...@@@.@@@@@......@...........
..@@.@@@@@.@@@.......@@@@........@@@@@@@@@@@@@@@..........@.......
..@@.@@@@@@......@....@..@.............@@@@@@@@@@.........@.......
.......@@@@@@.............@......@@....@@@@@@@..@.................
........@@.@@......@..............@@@...@@@@@@.@......@......@....
.@..........@@@...................@@@@@.@@@@@@...........@........
...@......@@@@............@@@.....@@@@@@@@@@@@..@.................
..........@@@@.@......@...@@......@@@@@@@@@@@...@.................
.@........@@@@........@..@@@......@@@@@@@@@@....@@...@......@.....
........@@@@@@............@...........@@@@@@.........@@....@@.....
@@@@....@@@@@@........................@@@@@@@.......@......@@@....
@@@@@@@.@@@@@..................@......@.@@@@@@.@..................
@@@@@@@.@@.....................@....@...@@@@@@@@@@@...@...........
@@@@@@@@@@..............@@@@...........@@@@@@@@@@@@............@@@
@@@@@@@@@@...............@@@...........@@@@@@@@@@@.............@@@
@@@@@@@@@@@@.............@@............@@@@@@@.@@......@@@@@@...@@
@@@@@@@@@@@@...................@.......@.@@@@@.........@@@@@..@..@
@@@@@@@@@@@@...@.........................@@@....@................@
@@@@@@@@@@@@...@@.........@..@@@@.........@@....@...............@@
@@@@@@@@@@@@@..@@............@@@@@@@............@@....@.........@@
@@@@@@@@@@@@@@@@@...........@@@@@@....@..........@@......@@......@
@@@@@@@@@@@@@@@@@..@........@@@@@@...@@@@........@@@.....@........
@@@@@@@@@@@@@@@@@@@@@...@@@@@@.......@@@@@...@@..@@...............
@@@@@@@@@@@@@@@@@@@@@...@@..........@@@.........@@@@.@@....@@@@@@@
@@@@@@@@@@@@@@@@@@@@@....@@..@......@@@.........@@@@.......@@@@@@@
@@@@@@@@@@@@@@@@@@@....@........@@...............@@@@...@..@@@@@@@
@@@@@@@@@@@@@@@@.......@.@.......@.............@.@@@....@..@@@@@@@
@@@@@@@@@@@@@..@....................@.....................@@@@@@@@
@@@@@@@@@@@@@..@....@...........@@.....@..................@@@@@@@@
@@@@@@@@@@@@@.........@..................@..@@......@.....@@@@@@@@
@@@@@@@@@@@@@@....@....@@..@@@..@@..@@.....................@@@@@@@
@@@@@@@@@@@@@....@@....@@@@@@@@@@@@@@@....................@@@@@@@@
@@@@@@@@@@@@@....@@@...@@@@@@@@@@@@@.........@@..........@@@@@@@@@
@@@@@@@@@@@@@.@..@@@@.......@@@@@@@@...........@@.......@@@@@@@@@@
@@@@@@@@@@..@....@@@@......@@@@@@@.@..........@@@@@.....@@@@@@@@@@
@@@@@@@@@@.......@.....@@..@@@@@@..@.........@@@@@@.....@@@@@@@@@@
@@@@@@@@@@.................@@@@@@.............@@@.......@@...@@@@@
@@@@@@@@@..................@@@@@.................@@.....@@.......@
@@@@@@@@@....@......@.....@@@@@................@@@@@...@@@@@.....@
@@@@@@@@@@....@.@@..@........@@.........@.......@@@@.......@.....@
@@@@@@@@@@@@@@@@............@@@......@@@@.......@...............@@
@@@@@@@@@@@@@@@.........@....@@@@....@@@.............@..........@@
@@@@@@@@@@@@@@@......@@..............@@@..@..........@........@.@@
@@@@@@@@@@@@@@.......@@..............@@...........@...........@@@@
@@@@@@@@@@@@@@.@@.....@.........@....@.................@@....@@@@@
@@@@@@@@@@@@@@@@@@@..........................................@@@@@
@@@@@@@@@@@@@@@@@@@@...............@.......@.................@@@@@
@@@@@@@@@@@@@@@@@@@@..........@@...@........@@............@.@@@@@@
@@@@@@@@@@@@@@@@@@.............@.......................@.@@@@@@@@@
@@@@@@@@@@@@@@@@@@@@@@.........@....@..@.............@...@@@@@@@@@
@@@@@@@@@@@@@@@@@@@@@@.....@@@@@.........@@.........@@@.@@@@@@@@@@
@@@@@@@@@@@@@@@@@@@@@@.....@@@@@@....@..@@@....@@...@@@@@@@@@@@@@@
8
14 48 0
26 53 0
28 33 0
52 46 0
20 16 0
25 5 0
54 43 0
4 3 0

21 39 0
42 41 0
8 20 0
4 18 0
25 18 0
54 29 0
2 11 0
60 32 0
