width 66
height 66
@@@@@@@@@@@@@@@@@@@@@@@@@@@@@@@@@@@@@@@@@@@@@@@@@@@@@@@@@@@@@@@@@@
@@@@@@@@@@@@@@@@@@@@@@@@@@@@@@@@@@@@@@@@@@@@@...@@@@@@@@@@@@@@@@@@
@@@@@@@@@@@@@@@@@@@@@@@@@@@@@@@@@@@@@@@@@@@.....@@@@@@@@@@@@@@@@@@
@@@@@@@@@@@@@@@@@@@@@@@@@@@@@@@@@@@@@@@@@.......@@@@@@@@@@@@@@@@@@
@@@@@@@@@@@@@@@@@@@@@@@@@@@@@@@@@@@@@@@@@.......@@@@@@@@@@@@@@@@@@
@@@@@@@@@@@@@@@@@@@@@@@@@@@@@@@@@@@@@@@@@..........@@@@@@@@@@@@@@@
@@@@@@@@@@@@@@@@@@@@@@@@@@@@@@@@@@@@@@@@@@.........@@....@@@@@@@@@
@@@@@@@@@@@@@@@@@@@@@@@@@@@@@@@@@@@@@@@@@@.........@..@..@@@@@@@@@
@@@@@@@@@@@@@@@@@@@@@@@@@@@@@@@@@@@@@@@@@@.........@.....@@@@@@@@@
@@@@@@@@@@@@@@@...@@.@@@@@@@@@@@@@@@@@@@@..........@.....@@@@@@...
@@@@@@@@@@@@@@@......@@@@@@@@@@@@.@.@..................@@@@@@@@...
@@@@@@@@@@@@@@@.@...@@@@@@@@@@....@.....................@@@@......
@@@@@@@@@@@@@@@@....@@@@@@@@@@..........................@@@@......
@@@@@@@@@@@@@@@.....@@....@@@@......@............@@.....@@@@@.....
@@@@.@@@@@@@@@@@@..........@@@...................@@@..@@@@@@@...@@
@@@@..@.@@@@@@..............@@......@....@......@@@@..@@..@@@...@@
@@@@..@..@@@@@@@@@...........@@.............@.@@@@@@......@..@....
@@@@..@@.@@@@@@@@.............................@@@@@@@.............
@@.......@@@@@@@@.@....................@@......@@@@@@@......@@@..@
@@.......@@@@@@@..........................@.....@@@@@@@......@@@@@
@@.@@@.....@@@@@@.@@.........@..........@@@....@@@..@..........@@@
@@@@@@@@@.................@..............@..@..@.........@.....@@@
@@@@@@@@@...@.................@@@..............................@..
@@@@@@@@.....................@@@@@@...@...@@@.........@.......@@..
@@@@@@@@@@.......@.............@......@@....@@@...................
@@@@@@@@@@........@@...................@.....@@............@@.....
@@@@@@@@@@........@@......@......................@..@@............
@@@@@.@@...........@@..@..@.............@@......@@.@@@@........@.@
@@@@@....@.............@.............@@.@@@.....@@@@@@@...........
@@@@@......@...............................@....@@@@@@@..@........
@@@@......@............@..@.....@.....@.........@..@...........@@@
@@@@....@..............@@@@........@@@@@........@..@.......@.@@@@@
@@@@..@........@.........@.@@@@....@@@@..@@@......@@..@@.@@@@@@@@@
@@@@@.@.....@@@@@@.........@@......@@@@...@@@@............@@@@@@@@
@@@@@........@....................@@......@@@.............@@@@@@@@
@@@@@..@.....@@..................@@@@@....@@............@@@@@@@@@@
@................@......................................@@@@@@@@@@
......@.................@............@....................@@@@@@@@
.....@...@..............@@@.....@@......@@..@......@@......@@@@@@@
............@.........@...@@@...........@@.........@@@@@@@@@@@@@@@
.....@....................@@@..........@@@........@@@@@@@@@@@@@@@@
........@@.....@..........@@@.....@....@@.........@@@@@@@@@...@@@@
@..............@@@@.......@@@@@@........@.....@...@@@@@.@@....@@@@
...............@@@@......@@@@@@@....@@..@@...........@@.......@@@@
.................@@.......@@@@@@....@@@..............@...@@....@@@
@.........@@..........@..@@@@@@@@..@@.......@........@..........@.
@@@..@.................@.@@@@@@@@..@@@.........@..................
@@@......................@@@@.@..@.@@@@........@@................@
@@@@.....@........@@.....@@......@...@.......@@..@.......@......@@
@@@@.@....@.....@@@@@....@@@..................@..........@.....@@@
@@@@@@....@....@@@@@.....@@@...........@..............@@.........@
@@@@@@@@......@@@@@@@.....@@@..........@@@............@..@.....@@@
@@@@@@@@@@@@@@@@@@@@@.....@...........@@@@@......@.............@@@
@@@@@@@@@@@@@@@@@@........@...........@@@@@...........@....@...@@@
@@@@@@@@@@@@@@@@..........@.........@@@@@............@@@...@.@@@@@
@@@@@@@@@@@@@@@@..........@....@@.....@@.............@@@...@@@@@@@
@@@@@@@@@@@@@@@@@@........@@.........................@@@@@@@@@@@@@
@@@@@@@@@@@@@@@@@@@@....@@@@........@..@..............@@@@@@@@@@@@
@@@@@@@@@@@@@@@@@@@...@.@@@@@@@.....@.....@@..........@@@@@@@@@@@@
@@@@@@@@@@@@@@@@@@@@@@@@@@@@@.......@.....@@@.@@.....@@@@@@@@@@@@@
@@@@@@@@@@@@@@@@@@@@@@@@@@@@...........@..@@@........@@@@@@@@@@@@@
@@@@@@@@@@@@@@@@@@@@@@@@@@@@..............@@@.........@@@@@@@@@@@@
@@@@@@@@@@@@@@@@@@@@@@@@@@@@.@@....@@@@@@.............@@@@@@@@@@@@
@@@@@@@@@@@@@@@@@@@@@@@@@@@@@@@@@@@@@@@@.....@....@..@@@@@@@@@@@@@
@@@@@@@@@@@@@@@@@@@@@@@@@@@@@@@@@@@@@@@@....@@@..@...@@@@@@@@@@@@@
@@@@@@@@@@@@@@@@@@@@@@@@@@@@@@@@@@@@@@@.....@@@@@@......@@@@@@@@@@
8
60 11 0
24 46 0
28 30 0
57 19 0
29 36 0
46 35 0
12 31 0
32 48 0

22 38 0
40 56 0
11 44 0
22 40 0
17 41 0
5 19 0
24 54 0
57 33 0
