width 66
height 66
@@@@@@@@@@@@@@@@@@@@@@@.....@@@@@@@@@@@@@@@@@@@@@@@@@@@@@@@@@@@@@@
@@@@@@@@@@@@@@@@@@...........@@@@@@@@@@@@@@@@@@@@@@@@@@@@@@@@@@@@@
@@@@@@@@@@@@@@@@@@@@........@@@@@@@@@@@@@@@@@@@@@.....@@@@@@@@@@@@
@@@@@@@@@@@@@@@@@@@@........@@@@@@@@@@@@@@@@@@@@@.....@@@@@@@@@@@@
@@@@@@@@@@@@@@@@@@@@@@@@@...@@@@@@@@@@@@@@@@@@@@@.....@@@@@@@@@@@@
@@@@@@@@@@@@@@@@@@@@@@@@@...@@@@@@@@@@@@@@@@@@@@@@@@...@@@@@@@@@@@
@@@@@@@@@@@@@@@@@@@@@@@@@............@@@@@@@@@@@@@@@...@@@@@@@@@@@
@@@@@@@@@@@@@@@@@@@@@@@@@............@@@@@@@@@@@@@@@@.....@@@@@@@@
@@@@@@@@@@@@@@@@@@@@@@@@..@..@......@@@@@@@@@@@@@@@@@@@...@@@@@@@@
@@@@@@@@@@@@@@@@@@@@@@@......@.......@@@@@@@@@@@@@@@@@@.....@@@@@@
@@@@@@@@@@@@@@@@@@@@@@........@......@@@@@@@@@@@@@@@@......@@@@@@@
@@@@@@@@@@@@@@@@@@@@@@........@.....@@..@...@@@@@@@@@......@@@@@@@
@@@@@@@@@@@@@@@@@@@@@@.....................@@@..@@@..........@.@@@
@@@@@@@@@@@@@@@@@@@@@......................@@@@.............@....@
@@@@@@@@@@@@@@@@@@@@@@..............@.....@@@@@@..................
@@@@@@@@@@@@@@@@@@@@@@....@..@...........@@@.@@@.................@
@@@@@@@@@@@@@@@@@@@@@@@......@@@@.........@@..@..................@
@@@@@@@@@@@@@@@@@@@@........@@@@...........@.@@...@@....@........@
@@@@@@@@@@@@@@@@@@.........@.@@@@......@.......@@.@.....@.........
@@@@@@@@@@@@@@@@@@........@@..@@@@@@...@.........................@
@@@@@@@@@@@@@...@@........@@@..@@@............................@...
@@@@@@@@@@@..........@......@@.@@@@...............@...........@@@@
@@@....@.@@.....................................@....@....@...@@@@
.@@......@@................@.............@................@@@@@@@@
.@@.......@@.@.....................@..........@.............@@@@@@
..........@@.@................@@.......@@@....@............@@@@@@@
@..........@.....@...@.....................................@@@@@@@
@@.........@.....@.........................@...@..........@@@@@@@@
.@.............@.......@@........@..@@............@.....@..@@@@@@@
..........................@................@...............@@.....
..........@......@@...................@@..........................
@@..........@..@@@@.@.................@@..........@...............
@@@.......@.................@..@......@@@........@@@.........@@...
@@@@@....@@@.@.@............@@@@.......@@.......@..........@@@@@@@
@@@@@@...@@@@@@@..........@@@@@@@...........@........@....@@@@@@@@
@@@@......@@@@@@...@......@@@@@@..............@...........@@@@@@@@
@@@@@@..@.@@@@...............@@@@.......@.................@@@@@@@@
@@@@@.....@@@@................@.........@...............@@@@@@@@@@
@@@@@.....@@@...........@....@............................@@@@@@@@
@@@@.......................@@....................@........@@@@@@@@
@@@............@...........@@.............@...............@@@@@@@@
@@@.....@@@..............................................@@@@@@@@@
@@.....@@@@...@.............@@@@.....................@@..@@@@@@@@@
@@@..@.@@@@.........@.......@@@@@...@............@@.....@@@@@@@@@@
@@@@@@.@@@...@.............@@@@.....@.@@................@@@@@@@@@@
@@@@@@@......@@....@@@.....@@@@........................@@@@@@@@@@@
...@@@......@@@..@.@@@....................@@@..........@@@@@@@@@@@
@....@.......@...@.@......................@@@..........@@@@@@@@@@@
@...@@...@......@@@@.........@..........@.@@@.........@@@@@@@@@@@@
@....@............@@..........@@..@..@....@@........@.@@@@@@@@@@@@
........@@@.......@@@....@...@@...@@....@@@@@........@@..@@@@@@@@@
@..@...@@@@@.....@@@@@..@@..@@@....@.....@.@@.@.....@@@..@@@@@@@@@
..........@@@@@@@@@@@@.....@@@@.............@.@@.....@....@@@@@@@@
..........@@@@@@@@@@@@.....@@@@................@.....@.....@@@@@@@
@.......@@@@@@@@@@@@@@......@@.....@..............@........@@@@@@@
@@.@....@@@@@@@@@@@@@..@..@@@@.............................@@@@@@@
@@@@.....@@@@@@@@@@@@..@@@@@@@..@@..@.@...........@@...@.@...@@@@@
@@@@@@@@@@@@@@@@@@@@@..@@@@..@@.@@................@@.@...@.....@@@
@@@@@@@@@@@@@@@@@@@@@@@@@@@..@@....@................@@.......@@@@@
@@@@@@@@@@@@@@@@@@@@@@@@@@@........@................@@.@..@@@@@@@@
@@@@@@@@@@@@@@@@@@@@@@@@@@........@@@@@..........@@......@@@@@@@@@
@@@@@@@@@@@@@@@@@@@@@@@@@@@.........@@@.........@@.........@@@@@@@
@@@@@@@@@@@@@@@@@@@@@@@@@@....@...................@........@@@@@@@
@@@@@@@@@@@@@@@@@@@@@@@@@@.................@......@....@@@@@@@@@@@
@@@@@@@@@@@@@@@@@@@@@@@@@@@@@@@@@@@.............@@@@@..@@@@@@@@@@@
@@@@@@@@@@@@@@@@@@@@@@@@@@@@@@@@@@............@@@@@@@.@@@@@@@@@@@@
8
26 47 0
30 20 0
5 42 0
19 40 0
49 23 0
28 59 0
42 54 0
60 19 0

53 4 0
40 60 0
34 27 0
18 23 0
1 54 0
30 29 0
42 54 0
59 21 0
