width 66
height 66
@@@@@@@@@@@@@@@@@@@@.........@....@@@@@@@@.........@........@@@@@@
@@@@@@@@@@@@@@@@@@@@...............@@@@@@@....@....@........@@@@@@
@@@@@@@@@@@@@@@.@@......@...........@@@@@@.........@@.......@@...@
@@@@@@@@@@@@@@@.@@......@.....@@.@..@@@@@@.@.......@@.....@..@@...
@@@@@@@@@@@@@@................@@@@.@@@@@@..@.@.....@@.............
@@@@@@@@@@@@@@@...........@..@@@@@@@@@@......@@@...@@.....@......@
@@@@@@@@@@.......@...........@@@@@@@@@@..........@....@@....@....@
@@@@@@@@@@..................@@@@@@@@@@@.......@.......@@@...@...@@
@@@@@@@@@@@..@................@@@@@@@@@......@@......@@.@.@.....@@
@@@@@@@@@@@.....................@@@@@@@@.....@@@.....@..@......@@@
@@@@@@@.............@...........@..@...@......@@.....@.......@@@@.
@@@@@@@........@@.....@................@@@.@@@@@..............@@@.
@@@@@@@@.......@..........@..@@........@@@@@@@@@....@..@@@...@@@..
@@@@@@@..............................@.@@@@@@@@.........@.........
@@@@@............@...........@@....@...@@@@@@@.@........@........@
@@@@.................@@@@@@...........@@@.@@@@......@@@.@@........
@.@.....@.........@@@@@@@@@.....@..........@..........@.@@@......@
@....................@@@@..........@@..................@@@@@@.....
@.....................@@@.....@.........@..................@@@..@.
@.......@...@.........@.........@........@......@.................
@@..@@....@........................@@...........@...........@@@...
@@..@@......@@@.........@..@@.............................@.@@....
@@@@@@......@@.@..@..........................................@@...
@@@@@@......@..............................................@......
@@@@@@@.....@@.....@...........@.@..@@.........@@..........@......
@@@@@@.........@@..@...........@....@@@...@.......................
@@@@@..........@@@@@...........@@.................................
@@@@@@....@....@@@.@....@....@@@@.........................@....@@@
@@@@@@....@@....@@.@@@@@@.....@@@...........@...@...............@@
@@@................@@@@@@.................@.......@@...@@........@
@...........@......@@......@@..@..................@....@@......@..
@..........................@@@...@...................@..@..@@.....
......@@@....@.....................@.......@........@...@@.@@@....
......@@@....@...........@.........@...............@............@@
..................@@@.@@......................@..............@..@@
@.....@.....@.....@@@@@@@..................@..@.@.........@..@@@@@
......@...........@@@@@@..............@.......@@@....@@@.....@@@@@
..@...@........@..@@@@@@..............@.@.@@.......@@@@@.....@@@@@
@.....@@.@.......@@@@@@@..@......@....@....@.....@@@@@@.....@@@@@@
....@............@@@@@@..........@...............@@..@.....@@@@@@@
..@.@@...........@@@@@@.........................@@@..@.....@@@@@@@
..............@.@@@@@@..........................@@@.....@..@@@@@@@
...............@@@@@@@....@.@@@@..@....@@...........@@@....@@@@@@@
....@@....@...@@@@@@@@......@@@@......@@............@.....@@@@@@@@
...@@@....@....@@@@@@@@@....@@@.......@....................@@@@@@@
...@@@............@@@@@@.....@.....@..............@........@@@@@@@
...@@.....@@@@....@@@@@@@....................@@@.........@@@@@@@@@
...@@@@...@@@@......@@@..@@...........@....@..@@.........@@@@@@@@@
@@.@@@@....@@@.....@@@@@.@.@..........@....@@.@......@...@@@@@@@@@
@@@@@@@.....@@.....@@@@@...@@.......@.@@@@@@@........@@..@@@@@@@@@
@@@@@@@............@@@@@@.............@@@@@@@...@@.......@@@@@@@@@
@@@@@@@..@.........@@@@@@...........@@@@@@@@@@@@@@......@@@@@@@@@@
@@@@@@@@...@.@......@@@@@...........@@@@@@@@@@@.......@.@@@@@@@@@@
@@@@@@@@@..........@@@@@....@@@.@...@@@@@@@@@.......@..@@@@@@@@@@@
@@@@@@@@@@........@@@@@@@@...@@@@@@@@@@@@@@@...........@@@@@@@@@@@
@@@@@@@@@@....@...@@@@@@@@..@@@@@@....@@@@@@...........@@@@@@@@@@@
@@@@@@@@@@@@.....@@@@@@.@...@@@@@@.......@@@@@...@.....@@@@@@@@@@@
@@@@@@@@@@@@@@....@@@@@.................@@@@@@.@@@@@@@@@@@@@@@@@@@
@@@@@@@@@@@@@@@@@.@@@@@...........@......@@@@@.@@@@@@@@@@@@@@@@@@@
@@@@@@@@@@@@@@@@@@@@@@@...@@@@@@...........@@@@@@@@@@@@@@@@@@@@@@@
@@@@@@@@@@@@@@@@@@@@@@@@@@@@@@@@@@........@@...@@@@@@@@@@@@@@@@@@@
@@@@@@@@@@@@@@@@@@@@@@@@@@@@@@@@@@@...........@@@@@@@@@@@@@@@@@@@@
@@@@@@@@@@@@@@@@@@@@@@@@@@@@@@@@@@@...........@@@@@@@@@@@@@@@@@@@@
@@@@@@@@@@@@@@@@@@@@@@@@@@@@@@@@@@@..............@@@@@@@@@@@@@@@@@
@@@@@@@@@@@@@@@@@@@@@@@@@@@@@@@@@@@........@...@@@@@@@@@@@@@@@@@@@
@@@@@@@@@@@@@@@@@@@@@@@@@@@@@@@@@....@@....@@@@@@@@@@@@@@@@@@@@@@@
8
39 41 0
55 15 0
59 12 0
29 48 0
16 54 0
42 33 0
42 45 0
27 19 0

56 26 0
51 18 0
44 60 0
37 44 0
33 50 0
7 21 0
1 17 0
48 52 0
