width 66
height 66
@@@@@@@..@@@..........@@@@@@.@..@@@@@...@@@@@@.@......@...@@@@@@@@
@@@@@@@.................@@@.....@@@............@......@@..@@@@@@@@
@@@@@@@@@.................@....................@.........@@@.@@@@@
@@@@@@@.@..@.@........@...@...........@........@....@...@@@.......
@@@@@@@.....@........@@..................@..........@.@.......@@@@
@@@@@@@@....@@@@.....@................@..@.......@..@...@.@@....@@
@@@@@@....@@@@@@@..............@......@...................@@@..@@@
@@@@@@.@@@@@@@@.............................@.....@.......@@@...@@
@@@@@@@@@@@@@@@..........@@..........................@..........@@
@@@@@@@@@@@@@@@....@.....@@.........@@...........@................
.@@@@@@@@@@@@@@...@...@@@@@@.......@@....................@........
..@@@@@.@@.........@..@............................@...@@.........
.....@.....@..........@.....@.......@@@@................@.........
...@.@.....@@.......................@@@...@@...................@..
......@....@@......@@................@@...@@........@.........@@@@
..................@@@.....@........@..@@.....................@@@@@
...........@......@@@@................@@............@@......@@@@@@
@@.....@......@@@@@..............@.@...@.........@....@....@@@@@@@
.......@@.@@..@@@@........@........@..........@..@@............@@@
...@.........@@@@@....@@...@@......@.....@@@...@.@@......@@.....@@
...@@....@..@@@@...........@@.@@@..@@....@@@@....@@@...@@@@...@@@@
...@@.......@@@..........@.@@@@@@@@@.....@@@.............@@@@@@@@@
@...@@@.....@@@..........@..@@@@@@@....@@@................@@@@@@@@
@@@...................@.@@...@@@@@@@@@.@.@@.@@.........@..@@@@@@@@
@@...........@....@@.....@.....@@@@@@..@....@@@@..........@@@@@@@@
@@................@@.....@.......@@@@@.@.....@@@...........@@@@@@@
@@.@.....@......@.@@.....@......@@@@@@...@....@@...........@@@@@@@
...@@@............@@....@@......@@.@@@..............@......@@@@@@@
...@@.................@@@@...................@......@....@@@@@@@@@
@..@@@..............@....@@@@@.............@@.........@.@@@@@@@@@@
@@@@@@.................@@@@@@@........@@............@@@@@@@@@@@@@@
@@@@.........@@@@...@@@@@@@@@@@@.......@...........@@@@@@@@@@@@@@@
@@....................@@@@@@@@@@@...@.@.@@.........@@@@@@@.@@@@@@@
@@..................@@@@@@@@@@@@@@......@@@@...@@@@@@@@@@@.....@@@
@@.....@....@.........@@@@@@@@@@.........@@....@@@@@@@@@@.......@@
@@...................@@@@@@@@@@@.........@@@.@@@@@@@@@@@@@@.....@@
.......................@@@@@@@@@.........@@@@@@@@@@@@@@@@@@....@@@
@.......................@@@@@@@@.........@@@@@@@@@@@@@@@..@@...@@@
@@@.........@@..........@@@@@@@...@@.....@@@@@@@@@...........@@@@@
@@@.......@@@@............@@@@@@..@@.....@@@@@@@@@@..........@@@@@
@@@..............@........@@@@........@..@.@@@@@@@@..........@@@@@
@@@@@@.....................@@@........@.....@.@@@@@............@@@
@@@@@@....@.@@@...................@...@@......@@@@@..@...@......@.
@@@@@@@@..@@@@...............................@@@@@@..@............
@@@@@@@@@.@@@@................................@@@.................
@@@@@@@@@@@@@@...@......@...@@@...............@@@................@
@@@@@@@@@@@@.@......@@......@@@@@........@@.@@@@.................@
@@@@@@@@@@@@........@@......@@@@@.......@...@@@....@......@....@@@
@@@@@@@@@@@@........@@.@.....@@.........@............@@......@....
@@@@@@@@@@@@@@@@.......@@....@@.@@.....@@......@@@@.@@@@..........
@@@@@@@@@@@@@@@@@@..@@@@.@...@@........@@...@@@@...@@@@..........@
@@@@@@@@@@@@@@@@@@@@@@@@....@@@.......@@.....@@@.............@....
@@@@@@@@@@@@@@@@@@@@@@@@@...@@........@........@@..........@......
@@@@@@@@@@@@@@@@@@@@@@@@@.........................................
@@@@@@@@@@@@@@@@@@@@@@@@@.........................................
@@@@@@@@@@@@@@@@@@@@@@@@@....@@...............@..@...............@
@@@@@@@@@@@@@@@@@@@@@@@@@........................@@..............@
@@@@@@@@@@@@@@@@@@@@@@@@............@...@.........@..............@
@@@@@@@@@@@@@@@@@@@@@@@@...........@@@...........................@
@@@@@@@@@@@@@@@@@@@@@@@@@@.........@@@.........@@@......@....@....
@@@@@@@@@@@@@@@@@@@@@@@@@@@......@@@...........@@@@.....@....@@...
@@@@@@@@@@@@@@@@@@@@@@@@@@@@......@@@..........@@@@@@@....@..@...@
@@@@@@@@@@@@@@@@@@@@@@@@@@@@.@@@....@........@@@@@@@@@.........@.@
@@@@@@@@@@@@@@@@@@@@@@@@@@@@@@@@.............@@@@@@@@.......@@.@.@
@@@@@@@@@@@@@@@@@@@@@@@@@@@@@@@@..............@@@@@@@........@...@
@@@@@@@@@@@@@@@@@@@@@@@@@@@@@@@@..@@............@@@@@.@..........@
8
27 60 0
28 25 0
49 45 0
8 43 0
16 20 0
42 10 0
53 39 0
7 16 0

27 60 0
48 46 0
55 2 0
11 2 0
62 58 0
45 15 0
10 1 0
14 41 0
