width 39
height 39
@@......@......@...........@@@@@..@@@@@
@...@...............................@.@
@........................@........@...@
@..@...........@.......................
...@....@@@............................
...@...@@@.....................@.......
.@.....@@.........................@...@
......................................@
......@......@........................@
@@....@..@@.....@..@.......@...........
@@@@..@..@@@.......@@...............@..
@@...@@.........@@@@@@@.@...........@..
................@@@@@@@................
..@...@.........@@@@@@@@.......@....@@@
................@@@@..@@.......@....@@@
@.......@@......@@.......@..........@@@
@....@......@..@@@.......@..........@@@
@..............@@.....@............@@@@
@......@@.........@.......@....@....@@@
@@@@@.............@.@...............@@@
@@..................................@@@
@@.....@....@.......................@@@
@@@@@..@.................@@.........@@@
@@@@@.......@..@.@.......@@@...@.....@@
@@@@@@.....@.............@@..........@@
@@@..@.......@@@@.......@@@............
@@@....@..................@@.......@@..
.@@......@@......@.....@@........@.@@@@
.........@@...@@....@..@@@....@...@@@@@
.....@@..@.....@...@@.............@@@@@
......@............@..........@....@@@@
@@.................@........@.....@@@@@
@..@@..........................@..@@@@@
@.@@.......................@.......@@@@
@@@@.......@...............@.......@@@@
@@@@@.@.........@..............@@@@@@@@
@@@@@@@@@......@@@..@..........@@@@@@@@
@@@@@@@@@@.....@@@.............@@@@@@@@
@@@@@@@@@@@@..@@@@@.............@@@@@@@
8
18 7 0
13 0 0
2 8 0
37 5 0
9 23 0
27 21 0
24 36 0
37 2 0

1 28 0
6 12 0
5 18 0
8 1 0
18 25 0
27 21 0
24 16 0
33 2 0
