width 39
height 39
@@@@@@@@@@@@@....@@..........@@@@@...@.
@@@@@@@@@@@@@@...........@....@@@......
@@@@@@@@@@@@@......@...@@@..@..........
@@@@@@@@@@@@@...........@@@.@@@........
@@@@@@@@@..........@@@..@@@@@@@@.......
@@@@@@.....@.........@...@@@@@@@.......
@@@@@....................@@@.@@@.......
@@@@@....................@@............
@@@@@......@........@......@...........
@@@@@.....@@...............@@.......@..
@@@@@@.............................@...
@.@...............@........@...........
@.......................@@.....@@@.@..@
@......@.@.........................@...
@@.@...................................
@@.@@........@.........@.....@.........
@@@@........................@.......@@.
@@@@............@..@@..................
@@@...............@@@............@@@...
@@@................@@........@.@@@@@...
@@@@...........@@@.@@..........@@@.....
@@@@@@@.@@.@.....@@............@@....@@
@@@@@@@@@@........@......@......@...@@@
@@@@@@@@@......@.........@@@@........@@
@@@@@..@@.................@@@.........@
@@@..@.@..................@@@@@@.......
@@@.@@.@..................@@@@@@.......
@@@....@..................@@@@@@@@@@...
@@.........@........@.@...@@@@@@@@@@...
.................@@@......@.....@@@@...
..................@.............@@@@...
@.................@..........@..@@@....
@...........@.....@.............@....@.
...@................@@..........@....@@
..@@........@........@.@....@.........@
@..@...@...@@@@..@..@@............@.@@@
.........@@@@@@...................@.@@@
........@@@@@@@.......@@............@@@
@@@@..@.@@@@@@@@@......@........@@@.@@@
8
27 14 0
35 16 0
19 3 0
30 14 0
6 16 0
21 19 0
37 5 0
35 0 0

3 26 0
33 10 0
8 8 0
15 15 0
23 16 0
3 18 0
28 6 0
31 23 0
