width 39
height 39
@@@@@@@@@@@@@@@@@@@@@@@@@@@@@@@@@@@@@@@
@@@@@@@@@@@@@@@@@@@@@@@@@@@@@@@@@@@@@@@
@@@@@@@@@@@@@@@@@@@@@@@@@@@@@@@@@@@@@@@
@@@@@@@@@@@@@@@@@@@@@@@@@@@@@@@@@@@@@@@
@@@@@@@@@@@@@@@@@@@@@@@@@@@@@@@@@@@@@@@
@@@@@@@@@@@@@@@@@@@@@@@@@@@@@@@@@@@@@@@
@@@@@@@@@@@@@@@@@@@@@@@@@@@@@@@@@@@@@@@
@@@@@@@@@@@@@@@@@@@@@@@@@@@@@@@@@@@@@@@
@@@@@@@@@@@@@@@@@@@@@@.@@@..@@@@@@@@@@@
@@@@.@@@@@@@@@@@@@@....@@@..@@@@@@@@@@@
@@@@......@@@@@@@@@....@@....@@@@@@@@@@
@@@........@@@@@@@@@@...........@@@@@@@
@@.........@@@@@@@@@@@...........@@@@@@
@@@....@....@@@@@@@@@@.@.............@@
.............@@@@@@..............@.....
..........@..@@@@@@@...................
..............@@@@@@...........@......@
..............@@@@@.......@..@@@@.....@
...............@@@@.......@...@@@......
................................@......
...................................@..@
@........................@.....@@..@...
@...................@....@@....@.@@....
....@......@@...@....@...........@@@...
.@.........@@......@.@@...........@....
...............@...@............@@@....
.................@..............@@@@@..
..........@...................@@@@@@@..
.......@.@@@@@...@........@....@@@@@@.@
....@....@@@@@..........@@@@...@@......
.@.......@@.@.............@@@@.@@......
...........................@@..@@......
............@.............@.@...@......
.@.............................@@......
.........@......@..@...................
....@....@.@..@@@......................
@.......@@.@@@@@@@.................@@..
@@.......@@@@@@@@@@...........@....@...
@......@.@@@@@@@@@@@@..@@@.........@...
8
29 16 0
34 31 0
3 35 0
18 21 0
22 16 0
21 38 0
6 13 0
38 27 0

11 30 0
7 12 0
20 26 0
37 20 0
38 14 0
17 27 0
5 14 0
22 37 0
