width 39
height 39
@@@@...........@@...@@@@@@@@@@@@@@@@@@@
@@@@.................@@@@@@@@@@@@@@@@@@
@@@@.................@@@@@@@@@@@@@@@@@@
@@@..................@@@@@@@@@@@@@@@@@@
@@@...@.........@....@@@@@@@@@@@@@@@@@@
@@.................@@@@@@@@@@@@@@@@@@@@
@.................@@@..@@@@@@@@@@@@@@@@
.......................@@@@@@@@@@@@@@@@
....@..........@.@......@@@@@@@@@@@@@@@
.@@.....@...............@@@@@@@@@@@@@@@
@@@.............@.......@@@@@@@@@@@@@@@
@...@.............@@....@@@@@@@@@@@..@@
.................@......@@@@@@@......@@
.......................@@@@@@@@......@@
......@..................@@.@....@.....
...........@.............@@............
.......@@..............................
@.@....@..@.....................@......
.......@........................@......
...@........@...@.....................@
.............@@@@...............@@.....
.............@@.......@@@.......@......
.............@@.@.......@.............@
....@........@@..................@....@
..@@.........@@......@..@........@.....
...@.........@@@@@..........@....@@....
@..@........................@..........
.....................................@.
.@.......@............................@
@@...@@..@.............@.@......@.....@
@@@.@@@.@...@..........@@@..........@@@
@@@@@@.................@@@@@........@@@
@@@@@................@@@@@@@@......@@@@
@@@@@@............@..@@@@@@@@@..@.@@@@@
@@@@@@........@@.....@@@@@@@@@@@@@@@@@@
@@@@@.........@@.....@@@@@@@@@@@@@@@@@@
@@@@@@@....@.........@@@@@@@@@@@@@@@@@@
@@@@@@@@.@@@@.@.....@@@@@@@@@@@@@@@@@@@
@@@@@@@@@@@@@.......@@@@@@@@@@@@@@@@@@@
8
9 15 0
15 4 0
26 22 0
20 13 0
34 19 0
38 26 0
21 7 0
25 25 0

11 0 0
9 17 0
2 21 0
13 33 0
34 19 0
5 5 0
11 35 0
10 6 0
