width 96
height 96
@@@@@@@@@@@@@@@@@@@@@@@@...@.@@@.......@@@@@@@@@@@@@@@@@..@@@@@@@@@@@@@@@@@@@@@........@......@@
@@@@@@@@@@@@@@@...@@@@@@@....@@@.......@@@@@@@@@@@@@@@@....@@@@@@..@@@@@@@@@@@..................
@@@@@@@@@@@@@@@....@@@.......@.........@@@@@@@@@@@@@@@@@.....@@@...@@@@@@@@@@@@....@@...........
@@@@@@@@@@@@@@@.......@......@@...@...@@@@@@@@@@@@@@@@@@..@..@@@...@@@.@@@@@@@@...............@@
@@@@@@@@@@@@@@@@...........@..@@......@@@@@@@@@@@@@@@@@.....@@@@....@@..@@...@@.................
@@@@@@@@@@@@@@@@...........@..........@@@@@@@@@@@@@@@@@@@...@@@@........@...........@......@....
@@@@@@@@@@@@@@@..@...@@...............@@@@@@@@@@@@@@@@@@@@...@@@........@@.................@@@@@
@@@@@@@@@@@@@@@@@@....................@@@@@@@@@@@@@@@@@@@@@...............................@@@@.@
@@@@@@@@@@@@@@@@@@.................@@@@@.@@@@@@@@@@@@@@@@@@@......@@............@.........@@...@
@@@@@@@@@@@@@@@@..........@........@@......@@@@@@@@...@@.@@@.@....................@.............
@@@@@@@@@@@@@@@@@....@....@.@@................@@@.@......@@@@@@................................@
@@@@@@@@@@@@@@@@.....@...@@.@@@...............@..........@@@..........@@....@..................@
@@@@@@@@@@@@@@@@.......@@.@.@...........................@@@@.........@@@@.....@@..........@@@@..
@@@@@@@@@@@@@@@@.......@..@.@@.....@.........@@.........@@@@@....@...@@@...............@..@@@@..
@@@@@@@@@@@@@@@@...@...@...........@@@..@@@...@@@.......@.....@..@....@@@......@@@........@@@@@@
@@@@@@@@@@@@@@@@..............................@@@....@.................@@......@@@.........@@@@@
@@@@@@@@@@@@@@@@.......@.........@............@@@....@....................@....@@@............@@
@@@@@@@@@@@@@@@@............@...................@@...@...........................@............@@
@@@@@@@@@@@@@@@@............@........................@.....@@@@@...............@.@............@@
@@@@@@@@@@@@@@@@@.......@@@..........@@...................@@@@@@@@@..@...............@@.@......@
@@@@@@@@@@@@@@@@@@@..@@@@@@@@.@....@@@....................@@@@@.......@.......@.................
@@@@@@@@@@@@@@@@@@....@@@@@@@@@......@@@.....................@........@.........................
@@@@@@@@@@@@@@@@@@...@@@@@@@@@@@......@@................@.....................@...........@@.@@@
@@@@@@@@@@@@@@@@@@@@@@@@@@@@@@@@...............................................@...@.@.@..@@.@@@
@@@@@@@@@@@@@@@@@@@@@@@@@@@@@@@@.........@......@..@..........................@@.....@@@@@@@@@@@
@@@@@@@@@@@@@@@@@@@@@@@@@@@@@@@@......@@...........@.......@...........@......@......@@@@@@@@@@@
@@@@@@@@@@@@@@@@@@@@@@@@@@@@@@@@@@.@@@@@..@................@....@.....................@@@@@@@@@@
@@@@@@@@@@@@@@@@@@@@@@@@@@@@@@@@@@.@@@@@................@@@@@......@..................@@@@@@@@@@
@@@@@@@@@@@@@@@@@@@@@@@@@@@@@@@@@@@@@@@@.................@@@@...........................@@@@@@@@
@@@@@@@@@@@@@@@@@@@@@@@@@@@@@@@@@@@@@@@@@...............@@@@......@......................@@@@@.@
@@@@@@@@@@@@@@@@@@@@@@@@@@@@@@@@@@@@@..@@.........@......@@..@..@.@@@.....................@@....
@@@@@@@@@@@@@@@@@@@@@@@@@@@@@@@@@@@@@...@@..@.....@.................@@@.......@@................
@@@@@@@@@@@@@@@@@@@@@@@@@@@@@@@@@@@....@...........................@.............@..............
@@@@@@@@@@@@@@@@@@@@@@@@@@@@@@.@@@@....@@...@......................@...........................@
@@@@@@@@@@@@@@@@@@@@@@@@@@@@@....@...@..@....................@@........@.......................@
@@@@@@@@@@@@@@@@@@@@@@@@@@@@@........@..............@........@@@@@@@.............@.........@...@
@@@@@@@@@@@@@@@@@@@@@@@@@@@@@.............................@......@@@........@........@@........@
@@@@@@@@@@@@@@@@@@@@@@@@@@@@@@.......@.......@...................@@@@................@@.........
@@@@@@@@@@@@@@@@@@@@@@@@@@@@@@............@@@..@@@...............@@@@........@.@@....@..........
@@@@@@@@@@@@@@@@@@@@@@@@@@@@@@@@.....@..@@@@@..@@....@.....................@@@@@.....@@@@@@..@..
@@@@@@@@@@@@@@@@@@@@@@@@@@@@@@@@..........@@@.@@@@...@..@@@@@......@...@...@@@@@@@@@@@@@@@@@@@..
@@@@@@@@@@@@@@@@@@@@@@@@@@@@@@@................@@@......@@@@................@@@@@@@@@@@@@@@@@@@@
@@@@@@@@@@@@@@@@@@@@@@@@@@@@@@@@................@@@@@..@@@@.........@....@..@@@@@@@@@@@@@@@@@@@@
@@@@@@@@@@@@@@@@@@@@@@@@@@@@@@@@@...............@@@....@@@@@@@@............@@@@@@@@@@@@@@@@@@@@@
@@@@@@@@@@@@@@@@@@@@@@@@@@@@@@@@@........@.....@@@@.....@@@@@@@............@@@@@@@@@@@@@@@@@@@@@
@@@@@@@@@@@@@@@@@@@@@@@@...@@@@@@...@@@@@@.......@......@@@@@@.....@.......@@@@@@@@@@@@@@@@@@@@@
@@@@@@@@@@@@@@@@@@@@@@@@@@...@@@@...@@@@....@...@.......@....@...............@@@@@@@@@@@@@@@@@@@
@@@@@@@@@@@@@@@@@@@@@@@@@@@..@@@@@@@@@@@................@.......@.............@@@@@@@@@@@@@@@@@@
@@@@@@@@@@@@@@@@@@@@@@@@@@@..@@@@@@@@@@@.............@.@.......@@...@......@.@@@@@@@@@@@@@@@@@@@
@@@@@@@@@@@@@@@@@@@@@@@@@....@@@@@@@@................@.@.....@..@..........@@@@@@@@@@@@@@@@@@@@@
@@@@@@@@@@@@@@@@@@@@@@@@@.....@@@@@@@.............@......................@..@@@@@@@@@@@@@@@@@@@@
@@@@@@@@@@@@@@@@@@@@@@@@@...@.@....@.....@..@...............................@@@@@@@@@@@@@@@@@@@@
@@@@@@@@@@@@@@@@@@@@@@@@@@.........@..................@...............@....@@@@@@@@@@@@@@@@@@@@@
@@@@@@@@@@@@@@@@@@@@@@@@@@...................@..............................@@@@@@@@@@@@@@@@@@@@
@@@@@@@@@@@@@@@@@@@@@@@@@@.........@......@...................@...@....@@@@.@...@@@@@@@@@@@@@@@@
@@@@@@@@@@@@@@@@@@@@@@@@@...@@@@........@..............@@@...@@........@@@@@@..@@@@@@@@@@@@@@@@@
@@@@@@@@@@@@@@@@@@@@@@@@.....@@@@@.....................@@@....@........@@@..@...@@@@@@@@@@@@@@@@
@@@@@@@@@@@@@@@@@@....@@....@@@@@..............@.............@@............@@...@@@@@@@@@@@@@@@@
@@@@@@@@@@@@@@..@@.............@@@..@@@@@..................................@.....@@@@@@@@@@@@@@@
@@@@@@@@@@@@@@..@@..............@...@@@@@@@.....@.....@.@@....................@...@@@@@@@@@@@@@@
@@@@@@@@@@@@@@................@.....@@@@@@@.........@@...........................@@@@@@@@@@@@@@@
@@@@@@@@@@@@@@..@...................@@@@@@@@....@...............................@@@@@@@@@@@@@@@@
@@@@@@@@@@@@@.................@...@.@@@@@@@....@.....@.......@..........@@......@@@@@@@@@@@@@@@@
@@@@@@@@@@@@@@........@.............@@@@@@@..........@.......@..@................@@@@@@@@@@@@@@.
@@@@@@@@@@@@@@@...@@..@.............@@@@@@@.@@..@............@................@.@@@@@@@@@@@@@...
@@@@@@@@@@@@@@@@.@@@....@.......@..@@@@@@@...................@......@.@@@.......@@@@@@@@@@@@....
@@@@@@@@@@@@@@@@@@@@.................@@@@..................@.@......@@@@@..@.....@@@@@@@@@@@@...
@@@@@@@@@@@@@@@@@@@@.........@.....@..@@@@@..........@..@@@@@@......@@@@@........@@@@@@@@@@@@@@.
@@@@@@@@@@@@@@@@@@@@...................@@@@............@@@@@@@.......@@..........@@@@@@@@@@@@...
@@@@@@@@@@@@@@@@@@@@..............@@....@@@.....@...@..@@@..@@.........@.........@@..@@@@@@.....
@@@@@@@@@@@@@@@@@@@@...........@..@@....@@@........@...@@@..@@......@...........@......@@@@.....
@@@@@@@@@@@@@@@@@@@@@@@@@@.......@@.....@@@........@..@@@...........@...@.......@......@@@......
@@@@@@@@@@@@@@@@@@@@@@@@........@@......@.........................@@......@.....@...@..@@@......
@@@@@@@@@@@@@@@@@@@@@@@@@.......@@.........@..........................@@.........@.......@......
@@@@@@@@@@@@@@@@@@@@@@@@@..................@........................................@.......@@.@
@@@@@@@@@@@@@@@@@@@@@@@@@.@................@................@...............................@@@@
@@@@@@@@@@@@@@@@@@@@@@....@@..@@.................................@.........@........@@..@...@@@@
@@@@@@@@@@@@@@@@@@@@@@.......@@@@..........@.....@...............@@@..........@@@@...........@@@
@@@@@@@@@@@@@@@@@@@@@@@@@...@@@@@.@.@@@.........@...............@@@@..........................@@
@@@@@@@@@@@@@@@@@@@@@@@@@...@@@@@.@..@@@@....................................@..@..@..........@@
@@@@@@@@@@@@@@@@@@@@@@@@@@..@@@@@......@............@............@@....@.....@................@@
@@@@@@@@@@@@@@@@@@@@@@@@@@..@@@@@@@@@...................@..@@.....@@...@@.....................@@
@@@@@@@@@@@@@@@@@@@@@@@@@@@@@@@@.....................@.....@...@.......@..@...............@@.@@@
@@@@@@@@@@@@@@@@@@@@@@@@@@@@@@@.................@..........@...........@@....................@@@
@@@@@@@@@@@@@@@@@@@@@@@@@@@@@@....@....@......@@@@...........@......@@@@@@@....................@
@@@@@@@@@@@@@@@@@@@@@@@@@@@@@@.........@.@....@@@...........@@@......@@@@.......................
@@@@@@@@@@@@@@@@@@@@@@@@@@@@@@...........@................@.@@@@@....@@@@............@..........
@@@@@@@@@@@@@@@@@@@@@@@@@@@@@@........@..................@@....@@....@@.........@@....@.......@.
@@@@@@@@@@@@@@@@@@@@@@@@@@@@@@.....................@....@@............@..........@@@............
@@@@@@@@@@@@@@@@@@@@@@@@@@@@@......................@..@...............@..........@@..@..........
@@@@@@@@@@@@@@@@@@@@@@@@@@@@@@@....................@.............@@............@@@@.@@.....@....
@@@@@@@@@@@@@@@@@@@@@@@@@@@@@@@@@@.................@.............@@...........@@@@@@@.......@...
@@@@@@@@@@@@@@@@@@@@@@@@@@@@@@@@@@@................@@....@@......@........@@..@@@@@@@..........@
@@@@@@@@@@@@@@@@@@@@@@@@@@@@@@@@@@@.@....................@@@@............@@......@..............
@@@@@@@@@@@@@@@@@@@@@@@@@@@@@@@...@......@.@.@@........@@@@@@.....@.....@@@......@@.............
@@@@@@@@@@@@@@@@@@@@@@@@@@@@@@@@.........@@@@@@........@@@@@......@@@@..@@@@@.....@@@.@........@
8
22 10 0
57 51 0
51 52 0
62 64 0
60 63 0
55 38 0
60 39 0
17 11 0

67 7 0
19 10 0
16 2 0
93 2 0
74 28 0
39 9 0
59 34 0
41 18 0
