width 96
height 96
@@@@@@@@@@@@@@@@@@@@@@@@@@@@@@@@@@@@@@@@@@@@@@@@@@@@....@.....@@@@@@@@@@@@@@@@@@@@@@@@@@@@@@@@@@
@@@@@@@@@@@@@@@@@@@@@@@@@@@@@@@@@@@@@@@@@@@@@@@@@@@@........@.@@@@@@@@@@@@@@@@@@@@@@@@@@@@@@@@@@
@@@@@@@@@@@@@@@@@@@@@@@@@@@@@@@@@@@@@@@@@@@@@@@@@@@...........@@@@@@@@@@@@@@@@@@@@@@@@@@@@@@@@@@
@@@@@@@@@@@@@@@@@@@@@@@@@@@@@@@@@@@@@@@@@@@@@@@@@.......@......@@@@.@@@@@@@@@@@@@@@@@@@@@@@@@@@@
@@@@@@@@@@@@@@@@@@@@@@@@@@@@@@@@@@@@@@@@@@@@@@@@@.....@@.......@@@....@@@@@@@@@@@@@@@@@@@@@@@@@@
@@@@@@@@@@@@@@@@@@@@@@@@@@@@@@@@@@@@@@@@@@@@@.............@...@@@.......@@@@@@@@@@@@@@@@@@@@@@@@
@@@@@@@@@@@@@@@@@@@@@@@@@@@@@@@@@@@@@@@@@@@@@............@....@@@...@...@@@@@@@@@@@@@@@@@@@@@@@@
@@@@@@@@@@@@@@@@@@@@@@@@@@@@@@@@@@@@@@@@@@@@@@..@.............@@......@@@@@@@@@@@@@@@@@@@@@@@@@@
@@@@@@@@@@@@@@@@@@@@@@@@@@@@@@@@@@@@@@@@@@@@@@..@.........@...@@......@@@@@@@@@@@@@@@@@@@@@@@@@@
@@@@@@@@@@@@@@@@@@@@@@@@@@@@@@@@@@@@@@@.@@@@@@............@...........@..@@@@@@@@@@@@@@@@@@@@@@@
@@@@@@@@@@@@@@@@@@@@@@@@@@@@@@@@@@@@@.@..@@@@@...........@@..............@@@@@@@@@@@@@@@@@@@@@@@
@@@@@@@@@@@@@@@@@@@@@@@@@@@@@@@@@@@.........@.....@...........@@..........@@@@@@@@@@@@@@@@@@@@@@
@@@@@@@@@@@@@@@@@@@@@@@@@@@@@@@@@@@.@...................@@.....@.....@.....@@@@@@@@@@@@@@@@@@@@@
@@@@@@@@@@@@@@@@@@@@@@@@@@@@@@@@.@@.@..........................@@....@@@.@@@@@@@@@@@@@@@@@@@@@@@
@@@@@@@@@@@@@@@@@@@@@@@@@@@@@@@.........@..............@.............@@@..@@...@@@@@@@@@@@@@@@@@
@@@@@@@@@@@@@@@@@@@@@@@@@@@@@@@@@@......@@..@.............................@..@....@@@@@@@@@@@@@@
@@@@@@@@@@@@@@@@@@@@@@@@@@@@@@@@@@@@...@.............@...............@@...........@@@@@@@@@@@@@@
@@@@@@@@@@@@@@@@@@@@@@@@@@@@@@@@@@@..............@@@@@...............@@...........@@@@@@@@@@@@@@
@@@@@@@@@@@@@@@@@@@...@@@@.@@@@@@@@@..@.@@..@@...@@@@@@....@..........@.......@...@@@@@@@@@@@@@@
@@@@@@@@@@@@@@@@@@@....@...@@@@@@@@..@......@@..@@@@@@@............@............@..@@@@@@@.@@@@@
@@@@@@@@@@@@@@@@@@...........@@@@@.@@............@@@@@@.............@...........@..@@@@@@...@@@@
@@@@@@@@@@@@@@@@@.......@...@@@@@@..........@@@@@@@@@...........@...@@.................@.@..@@@@
@@@@@@@@@@@@@@@@.............@@@@@............@..@@@@........................@.............@@@@@
@@@@@@@@@@@@@@@@....@@........@@@...............@@@@@..@@@..@................@..........@@..@@@@
@@@@@@@@@@@@@@@@..............@@@.......................@@.................@......@@....@@..@@@@
@@@@@@@@@@@@@@@@..............@@@@..........@...@.......@.....................@..............@@@
@@@@@@@@@@@@@@@@.....@@.@.......................@.......@.@@............@..@........@@@.....@@@@
@@@@@@@@@@@@@@@@.....@......@.............................@...@...@.........@@.....@@.@.......@@
@@@@@@@@@@@@@@@@@....@..........@................@.................@.........@...@.@@.........@@
@@@@@@@@@@@@@@@......................@@@.......@@@.@...............@...............@@...........
@@@@@@@@@@@@@@@@@.....@................@.........@..........................@...@...............
@@@@@@@@@@@@@@@@@......................@........@@...........@@.....@...........@...............
@@@@@@@@@@@@@@@@......@..............@.@...............@......@@@...............................
@@@@@@@@@@@@@@.......@.........@.......@@....@@..@............@@@@....@.........................
@@@@@@@@@@@@@@..........................@@@@@@...........@....@@@@...@..........................
@@@@@@@@@@@@@...........................@...........@.......@@...............................@..
@@@@@@@@@@@@@@....@...............................@@@.......@...................................
@@@@@@@@@@@@@@............@@..............@@.....@@@............................@...............
@@@@@@@@@@@@@@@@..@@..@...@@@@.@.@..............................@.............@@@@@@............
@@@@@@@@@@@@@@@@@@@@@@@...@@@@@@.@....@.......@....@............@........@@@..@@@@@@@..@@@......
@@@@@@@@@@@@@@@@@@@@@@@@@@@@@@@@.......@.......................@@.............@@@@@@@.....@.....
@@@@@@@@@@@@@@@@@@@@@@@@@@@@@@@@............@@@...............@@@@@...........@@@...............
@@@@@@@@@@@@@@@@@@@@@@@@@@@@@@@@............@.@..............@@@@@@..........@@@...............@
@@@@@@@@@@@@@@@@@@@@@@@@@@@@@@@@@@@....................@........@@@@...........................@
@@@@@@@@@@@@@@@@@@@@@@@@@@@@@@@@@@@....................@....@...@@.............................@
@@@@@@@@@@@@@@@@@@@@@@@@@@@@@@@@@@@................@............@@.........@...................@
@@@@@@@@@....@@@@@@@@@@@@@@@...@@@@................@@.@............@@......@@..............@.@@@
@@@@@@@@@@...@@@@@@@@@@@@@...@@@@@@..................................@@@..@@@........@@@.....@@@
.@@@@@@@@.....@@@@@@@@@@@@@@.@@@@@@.........@@@@.....................@@@..@@@.......@@@@.@@....@
.@@@@@@@@.....@@@@@@@@@@@@@@...@@@....@.....@@.........................@...@@........@@..@@.@...
..@@@@@@......@@@@@@@@@@@@@@........@.......@............@...@..@@.........@.........@@.........
.....@@@.......@@@@@@@@@@@@..............@...................@.@@@....@.............@@@.........
....@@@@..............@@@@.....................@...............@@@.@.................@@.........
....@@.....@..@@.......@@@@............@@@@..............@.......@............@@@....@@........@
...@..........@..@....................@@@@@..................@....................@..@@@@......@
.................@......@................@................@@@@................@........@@.......
@.........@........@....@@..............@........@.......@.@@@@@.......@@@@@@..........@@@......
@......@....@.......@............................@@@.......@@........@@@@@@@@........@..........
....@@........@....@.....@@@.@.....@.............@@@@.................@@@@@@...@.........@......
..@.@.........@..............@.....@............@....................@@@@@@@..................@@
@...............@.............@...@@.@@...............................@@@@@@....@.............@@
@................@............@@..@@@@@......@.................@........@@@@@......@.@@.........
..............@@..@@.............@@@@@@@..........................@.......@@@...@..@@@@.........
@..............@..........@@@..@.@@@@@@@@.....................@...........@@@@@@@..@@@@@.....@..
.@.........................@@.....@@@@@@@.............@.......@..........@@@@@.....@@@@@@.......
............................@.....@@@@@@@........@.............@..........@@@@............@@@.@.
........@@....@.............@...@@@@@@@@@............@@........@@.........@@@@.....@@.....@..@@@
....@@..@@.............@......@@@@@@@@..................@.....@@...........@@@@@..............@@
.....@........@......@@........@@@@@@@.....................@.@@@@..........@@@@...............@@
@.............@@............@@@@@@@@@@.....................@@@@@.....@..................@......@
.....................@...@...@@@@@@@@@.@@..................@@@@@.....@.................@@.......
.....................@.....@@@@@@@@@@@@@@................@.@@@@@............................@@..
..@.@@@....@....@.........@@@@@@@@@@@@@@@.....@......@........@@..................@@.........@..
..........@@@@...@.@....@@@@@@@@@@@@@@@@@...........@.........@.....@.................@......@@@
..........@@@....@......@..@@@@@@@@@@@..............@...............@......@..................@@
........@@@@@@.......@.....@@@@@@@@@@......@@......@@...............@...@....................@@@
....@....@@@@@..............@@@@@@..........@.....@@@...................@...@..@........@....@@@
@@.......@@@@@.@........@.@.@@@@@@@.....@........@@@@..@@..@............................@.....@@
@@@@......@@@@@...........@@@@@@@@@................@@@.@@.@@.......@..........................@@
@@@@....@@@@@@@.@..........@.@@@@@....@...........@@@@....@@...@@@@@......................@..@@@
@@@@...@@@@@@@@...@..........@@@@@@@..@...........@@@.....@@....@@@@@.........@.....@.....@@..@@
@......@@.@@@@@@.@@@.......@@@@@@@@@......@@@..................@@@@@@@@@@@...@@..........@@@..@@
..........@@@@@@@@@........@@@@@@..@...@@@.....................@@@@@@@@@.....@...........@@@@@@@
@........@@@@@@@@@.......@.@.@@@@..@..@@@@.......@.............@@@@@@@@@............@@@...@@@@@@
@.......@@@@@@@@@@...........@@@@................@.............@@@@@@@@@.........@@@@@@@@@@@@@@@
@.......@@@@@@@.@............@@@.................@@...@@......@@@@@@@.......@....@@@@@@@@@@@@@@@
........@@@@@@................@@..........@...........@......@@@@@@@@...@.......@@@@@@@@@@@@@@@@
........@@@@@@.............@@....@@@............@@@.......@..@@@@@@@@@@@@@...@...@@@@@@@@@@@@@@@
.......@@@@@@.........@@....@@....@@............@@@....@..@..@@@@@@@@@@@@@........@@@@@@@@@@@@@@
..@@@..@@@@@@.........@@............@.@......................@@@@@@@@@@@@@.........@@@@@@@@@@@@@
.......@@@@@@.@@.....@@...............@.................@@@.@@@@@@@@@@@@@....@.....@@@@@@@@@@@@@
......@@@@@@...@........................@@@.......@.....@@@@@@@@@@@@@@@@@@...@....@@@@@@@@@@@@@@
......@@@@@@...@...................@...@@@@............@@@@@@@@@@@@@@@@@....@@....@@@@@@@@@@@@@@
.@@.@@@@@@.....@....@...@............@@@@@..........@@@@@@@@@@@@@@@@@@@@@....@....@@@@@@@@@@@@@@
@@@@@@@@@@@.....@.....@........@@@@@@@@@@@...@......@@@@@@@@@@@@@@@@@@@@@@@@@@@@@.@@@@@@@@@@@@@@
@@@@@@@@@@@........@@@@...@@@@@@@@@@@@@@@@@..@......@@@@@@@@@@@@@@@@@@@@@@@@@@@@@@@@@@@@@@@@@@@@
8
1 53 0
69 38 0
32 85 0
93 32 0
7 74 0
47 39 0
83 57 0
56 61 0

48 22 0
44 12 0
58 13 0
91 68 0
34 58 0
3 90 0
24 92 0
10 52 0
