width 96
height 96
@@@@@@@@@@@@@@@@@@......@@.......................@@@@@@@@@@@@@@@@@@@@@@@@@@@@@@@@@@@@@@@@@@@@@@@
@@@@@@@@@@@@@@@..........................@........@@@@@@@@@@@@@@@@@@@@@@@@@@@@@@@@@@@@@@@@@@@@@@
@@@@@@@@@@@@@@@.......@@.@@..@........@..@@......@@@@@@@@@@@@@@@@@@@@@@@@@@@@@@@@@@@@@@@@@@@@@@@
@@@@@@@@@@@@@@@........@..@..............@@.......@@@@@@@@@@@@@@@@@@@@@@@@@@@@@@@@@@@@@@@@@@@@@@
@@@@@@@@@@@@@@@...................................@@@@@@@@@@@@@@@@@@@@@@@@@@@@@@@@@@@@@@@@@@@@@@
@@@@@@@@@@@@@@@..............@.............@......@@@@@@@@@@@@@@@@@@@@@@@@@@@@@@@@@@@@@@@@@@@@@@
@@@@@@@@@@@@@@@........@@..........@...@..........@@@@@@@@@@@@@@@@@@@@@@@@@@@@@@@@@@@@@@@@@@@@@@
@@@@@@@@@@@@@@@...........@@@.@....@@@.@...........@.@.@@@@@@@@@@@@@@@@@@@@@@@@@@@@@@@@@@@@@@@@@
@@@@@@@@@@@@@@@...@@......@@..@.........................@@@@@@@@@@@@@@@@@@@@@@@@@@@@@@@@@@@@@@@@
@@@@@@@@@@@@@@@....@.....................................@@@@@@@@@@@@@@@@@@@@@@@@@@@@@@@@@@@@@@@
@@@@@@@@@@@@@@.....................@..@@.@...............@@@@@@@@@@@@@@@@@@@@@@@@@@@@@@@@@@@@@@@
@@@@@@@@@@@@@@.......@...................@...@.@.@....@@.@@@@@@@@@@@@@@@@@@@@@@@@@@@@@@@@@@@@@@@
@@@@@@@@@@@@@@@......@@...........@......@...............@@@@@@@@@@@@@@@@@@@@@@@@@@@@@@@@@@@@@@@
@@@@@@@@@@@@@@@......@@..@...............@@..@@....@....@@@@@@@@@@@@@@@@@@@@@@@@@@@@@@@@@@@@@@@@
@@@@@@@@@@@@@@@....@@@@............@.....@@..@@.........@@@@@@@@@@@@@@@@@@@@@@@@@@@@@@@@@@@@@@@@
@@@@@@@@@@@@..@....@@@@......@@..@......@@@@..@......@..@@@@@@@@@@@@@@@@@@@@@@@@@@@@@@@@@@@@@@@@
@@@@@@@@@@@@.@@.....@............@@...........@..........@@@@@@@@@@@@@@@@@@@@@@@@@@@@@@@@@@@@@@@
@@@@@@@@@@@@..............@......@........@...............@@@@@@@@@@@@@@@@@@@@@@@@@@@@@@@@@@@@@@
@@@@@@@@@@@@....................@@.........@...............@@@@@@@@@@@@@@@@.......@@@@@@@@@@@@@@
@@@@@@..@.................@.....@@...@@......@...@.@........@@@@@@@@@@@@@..........@@@@@@@@@@@@@
@@@@@@@.........................@@@.............@@@@.......@@.@@@@@@@@@@@...........@@@@@@@@@@@@
@@@@@@......@...........@.......@@@..@............@...........@.@@@@@@@@@...........@@@@@@@@@@@@
@.........@................@....@@@@@@............@@..............@@@@@@..........@@@@@@@@@@@@@@
................................@@@@@@............@@@...@@@......@@@@@@............@@@@@@@@@@@@@
.............................@..@@@@@@.......@....@......@@.@...@@@@@@@........@...@@@@@@@@@@@@@
@...............@..........@....@@..@@..........................@@@@@@@@........@@@@@@@@@@@@@@@@
@............@...@@....@................@.........................@@.........@..@@@@@@@@@@@@@@@@
@........@.......@@@...@.............@..@.@..@@......................@.@........@@@@@@@@@@@@@@@@
.......@@.........@@@.@@.....................@@@...........@...........@.....@.@@@@@@@@@@@@@@@@@
@..@@@@@@@.@.....@@@..........................@@..........@@.@........@@...@.@.@@@@@@@@@@@@@@@@@
@@@@@@@@@@......@@@@.....@@..................@@@@.........@............@.......@@@@@@@@@@@@@@@@@
@@@@@@@@@.....@.........@.@......@@@...@@@.@@@@@.............@.......@.........@@@@@@@@@@@@@@@@@
@@@@@@@........................@@@@@@@@@@@@@@@@@..@@..@.....@@@......@...........@@@@@@@@@@@@@@@
@@@@@@@............@............@@@@@@@@@@@@@@....@@@.............@@@@@@.........@@@@@@@@@@@@@@@
@@@@@@@@..@........@@...........@@@@@@@@@@@@@@@...@@@.............@@@@@@......@..@@@@@@@@@@@@@@@
@@@@@@@@@.........@@@@..........@@@@@@@@@@@@@@@@..@@@............@@@@............@@@@@@@@@@@@@@@
@@@@@@..@.........@@@@@........@@@@@@@@@@@@@@@@@..@@.....@.................@@@@......@@@@@@@@@@@
@@@@@@.......@@@..@@@@@@@@....@@@@@@@@@@@@@@@@@@@@@@....@@@@@@@..@@.....@..@@@@@@@@@.@@@@@@@@@@@
@@@@@@.............@@@@@@@@@.....@..@@@@@@@@@@@@@@@@@@@@@@@@@@......@.....@@@@@@@@@@@@@@@@@@@@@@
@@@@....@...........@@@@@@............@@@@@@@@@@@@@@@@@@@@@@@@.......@....@@@@@@@@@@@@@@@@@@@@@@
@@@@@@......@@@....@@@@@@..............@@@@@@@@@@@@@@@@@@@@@@.............@@@@@@@@@@@@@@@@@@@@@@
@@@@@@@@..@.@@@@..@@@@@@................@@@@@@@@@@@@@@@@@@@@@.............@@@@@@@@@@@@@@@@@@@@@@
@@@@@@@@@..@@@@@.@@.@@...@@@@...........@@@@@@@@@@@@@@@@@@@@@@@......@....@@@@@@@@@@@@@@@@@@@@@@
@@@@@@@@@@@@@@@@..........@...............@@@@@@@@@.@@@@@@@@@@@....@@@...@@@@@@@@@@@@@@@@@@@@@@@
@@@@@@@@@@@@@@@@......................@@..@@.@@@@@@...@@@@@@.............@@@@@@@@@@@@@@@@@@@@@@@
@@@@@@@@@@@@@@@@..........................@@....@@@...@@@@@@.............@@.@@@@@@@@@@@@@@@@@@@@
@@@@@@@@@@@@@@@@..........@..@........................@.....@..........@.....@@@@@@@@@@@@@@@@@@@
@@@@@@@@@..@@@@@@@@..........@@@..........................@@@..........@.....@@@@@@@@@@@@@@@@@@@
@@@@@@@@@..@@..@@@@@.....@........@......................@@@@...@...........@@@@@@@@@@@@@@@@@@@@
@@@@@@@@@@.@@..@@.............................@..........@@@@..@@.......@@..@@@@@@@@@@@@@@@@@@@@
@@@@@@@@@......@@@..@.............@......@@@@...@....@@@..@....@@@...@..@..@@@@.@@@@@@@@@@@@@@@@
@@@@@@@@@...@@.........@@..............@.@@@@.............@.....................@@@@@@@@@@@@@@@@
@@@@@..@@@.............@@@..@@............@@@@@......................@@..........@@@@@@@@@@@@@@@
@@@@@...................@...@@............@@@@@.........@..@.........@@@@........@@@@@@@@@@@@@@@
@@@@@..................@@@...@..........................@.............@@@@.......@@@@@@@@@@@@@@@
@@@@...................@@@@@.........@@@......@.....................@@@@..........@@@@@@@@@@@@@@
@@@@@......@............@.@@.........@@@...........@@.................@.@.....@...@.@@@@@@@@@@@@
@@@@@..................@@.............@@...@........@@..................@....@@.....@@@@@@@@@@@@
@@@@@@..................@..........@@.@..............@@..................@...@@@....@@@@@@@@@@@@
.@@@@.........@.....@@@.........@..@.........@@@.@...@@.......@..........@.....@@..@@@@@@@@@@@@@
.@.@@.................@..........@.@@........@.@...........................@@@.@@@@@@@@@@@@@@@@@
...@@.................@@........@.@@.......................................@@@@@@@@@@@@@@@@@@@@@
...@.............@....@@@.......@.@@...................@@@..........@....@@@@@@@@@@@@@@@@@@@@@@@
...@....@@@@........@@@@@@.........@..........................@@.........@@@@@@@@@@@@@@@@@@@@@@@
@.@.....@@.........@@@@@@@............@........................@.........@@@@@@@@@@@@@@@@@@@@@@@
@...................@@@@@@...................@...@...@.@@.....@@.........@@@@@@@@@@@@@@@@@@@@@@@
@..................@@@@@@@.....@.....@.......@................@.....@@@@@@@@@@@@@@@@@@@@@@@@@@@@
@............@@@.............@.@.............@..........@.@.........@@@@@@@@@@@@@@@@@@@@@@@@@@@@
.............@@@@.....@........@......@@............................@@@@@@@@@@@@@@@@@@@@@@@@@@@@
....@@@@.............@@@......@@@.....@@@@@@...................@.....@@@@@@@@@@@@@@@@@@@@@@@@@@@
....@@...........@....@@.............@@@@@@@...@.......................@@@@@@@@@@@@@@@@@@@@@@@@@
.....@...............@.@..@....................@....@..........@.......@@@@@@@@@@@@@@@@@@@@@@@@@
..................@..@..................................................@@@@@@@@@@@@@@@@@@@@@@@@
.............@......@@...........@.....@...............@@@................@.@@@@@@@@@@@@@@@@@@@@
@@..@@@................................................@@@.....@............@@@@@@@@@@@@@@@@@@@@
@@..@@@@@@................@@@.......@...................@@....@@@@@.........@@@@@@@@@@@@@@@@@@@@
@@..@@@@@@@......@.....@@@@@...@....@.....@.............@@....@@@@..........@@@@@@@@@@@@@@@@@@@@
@@@@@@@@@@@@@............@.....@@...@....@@....@...@.......@@..@@@@.........@@@@@@@@@@@@@@@@@@@@
@@@@@@@@@@.........................@....@@@....................@@@@@..........@@@@@@@@@@@@@@@@@@
@@@@@@@@@@..@@..........@@.........@....@@..@@@@.@@.........@@..@@@@@@@@@.......@@@@@@@@@@@@@@@@
@@@@@@@@@@..@.@......@..................@@@@@@@@..@................@@@@@@.......@@@@@@@@@@@@@@@@
@@@@@@@@@@..@........@...................@@@@@@@...................@@@@@@........@@@@@@@@@@@@@@@
@@@@@@@@@@...........@....................@@@@...................@..@@@@@.........@@@@@@@@@@@@@@
@@@@@@@@@@@@.@@....@.......@....@.......@@@@@@.........@.......@@@.@@@@@@.......@@@@@@@@@@@@@@@@
@@@@@@@@@@@@@@@................@......@@@@@@@@......@....@.@@..@@@....@@@@.......@@@@@@@@@@@@@@@
@@@@@@@@@@@@@@@@............@@....@.....@@@@@@@.......................@@.........@@@@@@@@@@@@@@@
@@@@@@@@@@@@@@@@..........@@@@@............@@@@...................@@.................@@@@@@@@@@@
@@@@@@@@@@@@@@@@@.....@..@@@@@@.......@....@@@@.......................@..@..........@@.@@@@@@@@@
@@@@@@@@@@@@@@@@........@@@@@@@......@@....@@@@@.........@...............@..............@@@@@@@@
@@@@@@@@@@@@@@@@@.......@.@@@@@..@...@.....@@@@@.@....@..@@@........@.....@..............@@@@@@@
@@@@@@@@@@@@@@@@@....@.....@.....@...@...@@@@@@@..............................@@@........@@@@@@@
@@@@@@@@@@@@@@@@....................@@@@@@@@@@@@@.............................@@@@@......@@@@@@@
@@@@@@@@@@@@@@@@...........@.@.......@@@@@@@@@@@@@.............................@@@@....@.@@@@@@@
@@@@@@@@@@@@@@@@...........@@........@@@@@@@@@@@@@@.............@@..............@@@@...@@@@@@@@@
@@@@@@@@@@@@@@.......................@@@@@@@@@@@@@@............@@@........@@.....@@@@.@@@@@@@@@@
@@@@@@@@@@@@@@..@.....@..............@@@@@@@@@@@@@..............@.....@@.@@@.@.@.@@@@@@@@@@@@@@@
8
16 77 0
25 94 0
83 21 0
45 54 0
34 73 0
40 67 0
2 70 0
35 74 0

19 71 0
51 26 0
20 81 0
16 38 0
47 2 0
79 27 0
51 67 0
20 78 0
