width 96
height 96
@@@@@@@@@@@@@@@@@@@@@@@@@@@@@@@@@@@@@@@@@@@@@@@@@@@@@@@@@@@@@@@@@@@@@@@@@@@@@@@@@@@@@@@@@@@@@@@@
@@@@@@@@@@@@@@@@@@@@@@@@@@@@@@@@@@@@@@@@@@@@@@@@@@@@@@@@@@@@@@@@@@@@@@@@@@@@@@@@@@@@@@@@@@@@@@@@
@@@@@@@@@@@@@@@@@@@@@@@@@@@@@@@@@@@@@@@@@@@@@@@@@@@@@@@@@@@@@@@@@@@@@@@@@@@@@@@@@@@@@@@@@@@@@@@@
@@@@@@@@@@@@@@@@@@@@@@@@@@@@@@@@@@@@@@@@@@@@@@@@@@@@@@@@@@@@@@@@@@@@@@@@@@@@@@@@@@@@@@@@@@@@@@@@
@@@@@@@@@@@@@@@@@@@@@@@@@@@@@@@@@@@@@@@@@@@@@@@@@@@@@@@@@@@@@@@@@@@@@@@@@@@@@@@@@@@@@@@@@@@@@@@@
@@@@@@@@@@@@@@@@@@@@@@@@@@@@@@@@@@@@@@@@@@@@@@@@@@@@@@@@@@@@@@@@@@@@@@@@@@@@@@@@@@@@@@@@@@@@@@@@
@@@@@@@@@@@@@@@@@@@@@@@@@@@@@@@@@@@@@@@@@@@@@@@@@@@@@@@@@@@@@@@@@@@@@@@@@@@@@@@@@@@@@@@@@@@@@@@@
@@@@@@@@@@@@@@@@@@@@@@@@@@@@@@@@@@@@@@@@@@@@@@@@@@@@@@@@@@@@@@@@@@@@@@@@@@@@@@@@@@@@@@@@@@@@@@@@
@@@@@@@@@@@@@@@@@@@@@@@@@@@@@@@@@@@@@@@@@@@@@@@@@@@@@@@@@@@@@@@@@@@@@@@@@@@@@@@@@@@@@@@@@@@@@@@@
@@@@@@@@@@@@@@@@@@@@@@@@@@@@@@@@@@@@@@@@@@@@@@@@@@@@@@@@@@@@@@@@@@@@@@@@@@@@@@@@@@@@@@@@@@@@@@@@
@@@@@@@@@@@@@@@@@@@@@@@@@@@@@@@@@@@@@@@@@@@@@@@@@@@@@@@@@@@@@@@@@@@@@@@@@@@@@@@@@@@@@@@@@@@@@@@@
@@@@@@@@@@@@@@@@@@@@@@@@@@@@@@@@@@@@@@@@@@@@@@@@@@@@@@@@@@@@@@@@@@@@@@@@@@@@@@@@@@@@@@@@@@@@@@@@
@@@@@@@@@@@@@@@@@@@@@@@@@@@@@@@@@@@@@@@@@@@@@@@@@@@@@@@@@@@@@@@@@@@@@@@@@@@@@@@@@@@@@@@@@@@@@@@@
@@@@@@@@@@@@@@@@@@@@@@@@@@@@@@@@@@@@@@@@@@@@@@@@@@@@@@@@@@@@@@@@@@@@@@@@@@@@@@@@@@@@@@@@@@@@@@@@
@@@@@@@@@@@@@@@@@@@@@@@@@@@@@@@@@@@@@@@@@@@@@@@@@@@@@@@@@@@@@@@@@@@@@@@@@@@@@@@@@@@@@@@@@@@@@@@@
@@@@@@@@@@@@@@@@@@@@@@@@@@@@@@@@@@@@@@@@@@@@@@@@@@@@@@@@@@@@@@@@@@@@@@@@@@@@@@@@@@@@@@@@@@@@@@@@
....@@@@@....@@@@@@@@@@@@@@@@@@@@@@@@@@@@@@@@@@@@@@@@@@@@@@@@@@@@@@@@@@@@@@@@@@@@@@@@@@@@@@@@@@@
........@....@@@@@@@@@@@@@@@@@@@@@@@@@@@@@@@@@@@@@@@@@@@@@@@@@@@@@@@@@@@@@@@@@@@@@@@@@@@@@@@@@@@
.............@@@@@@@@@@@@@@@@@@@@@@@@@@@@@@@@@@@@@@@@@@@@@@@@@@@@@@@@@@@@@@@@@@@@@@@@@@@@@@@@@@@
.......@.....@@@@@@@@@@@@@@@@@@@@@@@@@@@@@@@@@@@@@@@@@@@@@@@@@@@@@@@@@@@@@@@@@@@@@@@@@@@@@@@@@@@
@@..........@@@@@@@@@@@@@@@@@@@@@@@@@@@@@@@@@@@@@@@@@@@@@@@@@@@@@@@@@@@@@@@@@@@@@@@@@@@@@@@@@@@@
@...@.......@@@@@@@@@@@@@@@@@@@@@@@@@@@@@@@@@@@@@@@@@@@@@@@@@@@@@@@@@@@@@@....@@@@@@@@@@@@@@@@@@
............@@@@@@@@@@@@@@@@@@@@@@@@@@@@@@@@@@@@@@@@@@@@@@@@@@@@@@@@@@@@@@.@..@@@@@@@@@@@@.@@@@.
............@@@@@@@@@@@@@@@@@@@@@@@@@@@@@@@@@@@@@@@@@@@@@@@@@@@@@@@@@@@..........@@@@@@....@@@@.
...........@@@@@@@@@@@@@@@@@@@@@@@@@@@@@@@@@@@@@@@@@@@@@@@@@@@@@@@..........@....@@..@@.........
....@....@@@@@@@@@@@@@@@@@@@@@@@@@@@@@@@@@@@@@@@.@@@@@@@@@@@@@@@@....................@@......@..
....@@...@@@@@@@@@@@@@@@@@@@@@@@@@@@@@@@@@..@@@......@.@@@@@@@@@@.................@..@..........
.....@@@@@@@@@@@@@@@@@@@@@@@@@@@@@@@@@@@...............@@@@@@@@@@.@....@.......@................
.....@@@@@@@@@@@@@.....@@@@@@@@@@@@@@@@@.............@.@@@@@@.@@..@...@@.......................@
......@@@@@@@@@.@@......@@@@@@@@@@@@@@@@@.........................@...@@.....................@@@
.........@@@@@.......@..@@@@@@@@@@@@@@@@@@@......@.............@@@@...............@@............
...@......@..........@@@@@@@@@@@@@@@@@@@@@....@@............@.@@..@@.@@...........@@@@@@..@.....
...@................@@@@@@@@@...@@@@@@@@@@.....@@...........@......@@@@..@@.......@@@@@@@..@@...
..............@.....@@@.........@@@@@@@@@@.....@......@@..@.........@..............@@@.........@
..................@@@@.......................@.@......@@...........................@@@.........@
..@...@...........@.........................@@@...................@................@@...........
..@...@@@...........................@.......@......@@@..@.@......@@............................@
..@...@@@..........................................@......@......@@@.........................@@@
......@@@....@....................................@@....@........@@@.@.....@@@.....@.@..@@..@@@@
.....................................@@.......@...@@.......................@@@......@@..@@@.@@@.
.....@...................................@....@.........@...........@......@@@..........@@@.....
.........................@.......@...........................@.@@...@....@..............@@@@@.@@
...........................@..................@....@@........@.@@@.......................@@@@.@@
@..........................@.......@...............@@...@.@....@@@...@..................@@@@@@@@
.......@.....................................@.....@@...@@.....@@....@..........@.......@@@@@@@@
..@...@@..@..........@...@.......@.................@@..........@@.......................@@@@@@@@
......@@.....@...................@.........................@...@@.................@.....@@@@@@..
...@.................@.............@@..@..........@............@.............@@...........@@@@..
...@....@@..............@@.........@.......@@....................@..@.......@@@@................
.............@..........@@.........@@@.......................@@.@@.........@@@@@@...............
@........@@.............@@....@@...@@@.......................@@@@@.........@@@@@@@..............
........@@@.............@@@.....@.@@@@......................@@@@@@..........@@@@@@@.@...........
...@....................@@@.....@..@......@..........@......@@@@@............@@@.@@......@....@@
............@........@....@@.......@@@....................@.......................@.............
.......@.....@..............@.@@@@.@.@..................@.@.....................................
...............@@@.@........@@@@@@@@.......@...........@@@@.........@.........@.................
...............@@...........@@@@@@@@.@@........@.......@@@..........@...............@...........
.........................@@@@@@@@@@@..@@@...@.................@@.@..............@...@...........
...@..........@....@......@@@@@@@@@...@......................@@@.....@@@..@.....................
..@@@@...............@........@@@@..@.................................@@@..@.....@@........@....
@@@@@@..@...@@................@@......................................@@...@..........@...@.....
@@@@@@@@@.@@@@@.......@..@.....@...........................................@....................
@@@@@@@@@.@...........@@@@@....@@........@.....@.........@@@@...@........@@@...................@
@@@@@@@@@@.............@@@@...@@@..............@@@.......@@@...@..........@@......@@.........@@@
@@@@@@@@@..............@@@.....@@..@......@...@...........@@@@@@..@............@.....@.......@@@
@@@@@@@@...@@..................@.............................................@..@....@..........
......@@.............................@..@.....@...........................@........@@...........
@......@.....@...........@..@@....@..@...@.....................................@....@@....@.....
..@....@@..............................@.@..@..@........@..@..................@@....@@@.@@@....@
@.......@@....................@............................@..........@.......@.....@@@@..@@.@@@
@@@................@............@.........@@.@..........@.....@...@.................@@@...@@...@
@@@......@@.....@@.........@@...........@@@@@@.......@@...........@..@....................@@....
@........@@.....@...................@...@@@@@@........@...@.....................................
........@@@....@@............@@...........@@@@......@@@.........................................
.........@@....@@............@..@......@..@........@@@@..@....................@...............@.
..........@@..@@@.....@......@.........@.............@@...@@..................@........@......@@
@@....................@....@...........@................@.@@..................................@@
.@....................@....................................@@....@@......@@....@@@@@@@@........@
......@.......@...@.............@............@.......@...@@@.........@........@@@@@@@@@........@
..@..............@@........@...@.........................@@.................@.@@@@@@@@@@........
......................................@@..................................@...@@@@@@@@@@...@....
....@@@......@...........@............@@.............@......@@.@@@........@...@@@@@@@@@@@.......
..@@.@@@...................@@..........@..........................@............@@@@@@@@@@@......
@@@@.....@........@@@......@@@.......................@...................@....@@@@@@@@@@@@......
@@@@@...@@@@.........@@....@.@@@@@........@......@..........@...................@@@@@@@@@@@@@@@.
@@@@@..@@@@@.........@@.......@@@@.............@........@@@@@@..@....@.......@@@@@@@@@@@@@@@@@@@
@@@@@..@@@@@........@@@@@@@....@.......@.......@@@.....@@@@@@@...............@@@@@@@@@@@@@@@@@@@
@@@@@@@@@@.@........@@@.@@@..@.....@@..@@@.....@@@@@...@@@@@@@@@@........@...@@@@@@@@@@@@@@@@@@@
@@@@@@@@...@........@@@.@@@.@.......@..........@@@@@@.@@@@@@@@@@@...@@@@@@...@@@@@@@@@@@@@@@@@@@
@@@@@@@@..........@.@....@@.............@....@@@@@@@@@@@@@@@@@@@@@.@@@@@@@@@@@@@@@@@@@@@@@@@@@@@
@@@@@@@@.................@..@@@........@@.@@@@@@@@@@@@@@@@@@@@@@@@@@@@@@@@@@@@@@@@@@@@@@@@@@@@@@
@@@@@@@...........@...................@@@@@@@@@@@@@@@@@@@@@@@@@@@@@@@@@@@@@@@@@@@@@@@@@@@@@@@@@@
@@@@........@........@................@@@@@@@@@@@@@@@@@@@@@@@@@@@@@@@@@@@@@@@@@@@@@@@@@@@@@@@@@@
@@@..................@...............@@@@@@@@@@@@@@@@@@@@@@@@@@@@@@@@@@@@@@@@@@@@@@@@@@@@@@@@@@@
@@@@@..@............@.......@.......@@@@@@@@@@@@@@@@@@@@@@@@@@@@@@@@@@@@@@@@@@@@@@@@@@@@@@@@@@@@
@@@@@..@..@..@...@.........@@@..@@@@@@@@@@@@@@@@@@@@@@@@@@@@@@@@@@@@@@@@@@@@@@@@@@@@@@@@@@@@@@@@
8
20 67 0
87 28 0
85 35 0
22 37 0
35 84 0
37 90 0
71 78 0
37 77 0

66 58 0
72 67 0
19 76 0
75 79 0
4 22 0
91 35 0
0 30 0
3 34 0
