width 96
height 96
@..@..@@.........@@...........@....@....@@@......@..@....@@@...@@@.@@@@@@@@@@@@@@@@@@@@@@@@@@@@@
@............@............@@............@@....@..@........@....@@@.@@@@@@@@@@@@@@@@@@@@@@@@@@@@@
................@.......@@@@...@.....@......................@......@@@@@@@@@@@@@@@@@@@@@@@@@@@@@
..........@@...........@@@@@@@..........@..@......@......@@.........@@@@@@@@@@@@@@@@@@@@@@@@@@@@
.....@....@@@@@.........@@@@@@@.........@...........@@@..@@......@@....@@@@@@@@@@@@@@@@@@@@@@@@@
@....@....@@@@.........@@@@@@@@...@...@@.............@...@@@.........@@@@@@@@@@@@@@@@@@@@@@@@@@@
@...........@@........@@@@@@@@@.................@@..@@....................@@@@@@@@@@@@@@@@@@@@@@
@@@@@@...@............@@@@@@@.......@@....@.........@............@.......@@@@@@@@@@@@@@@@@@@@@@@
@@@@@@@............@..@@@@@@.....@..@@....@..@...............@@@....@@....@@@@@@@@@@@@@@@@@@@@@@
@@@@@@@...@...@........@@@@.....@@.@@@....@@@@...@.......@...@@@....@@@...@@@@@@@@@@@@@@@@@@@@@@
@@@@@@@@...@....@..@.@.....@.....@.@@@@.............@.@@@@@@.@@..........@@@@@@@@@@@@@@@@@@@@@@@
@@@@@@@............@@@.....@.......@@@@@............@@@@@@@..@........@.@.@@@@@@@@@@@@@@@@@@@@@@
@@@@@@@.@............@.............@@@.@@.................@...............@@@@@@@@@@@@@@@@@@@@@@
@@@@@@@.@@@........@......@.@..........@@@@............@......@.@..........@@@@..@..@@@@@@@@@@@@
...@@@@.@@@........@...................@@@@@..................@......@......@@@......@@@@@@@@@@@
..............@.....................@..@@@@@.................@@.......@......@@@@.@.@@@@@@@@@@@@
...........................................@.................@........@.........@...@@@@@@@@@@@@
............................................@..............@............@..@@@.@.....@@@@@@@@@@@
.....@........@@............@@@.............@@......................@.@....@@@......@@@@@@@@@@@@
.....@........@@@.@....@@.@@@@..............@@...........@......@......@...@@@.......@@@@@@@@@@@
.........@@....@..@....@@@@@@@.@............@@...........@@...............@@@@......@@@@@@@@@@@@
.........@@@............@@@@@@..........................@@@...@...........@@@....@..@@@@@@@@@@@@
..........@@..........@.@@@@@@@@..........@............@@@@.........@@....@@......@@@@@@@@@@@@@@
@@@@...............@....@@@@@@@@@.....................@@@@..........@@.....@@@....@@@@@@@@@@@@@@
@@@@....@@@.@@@.........@..@@@@@......................@........................@@.@@@@@@@@@@@@@@
@@@@....@@@..@...........@.@..............@..@@...................................@@@@@@@@@@@@@@
@.......@@@..@.......@@@.@.....@....@@@@@@@...@@@....@...........@@..............@@@@@@@@@@@@@@@
.....@...@@.....@..@@@@@...........@@@@@@@@.@@@@@.........@@...@@@@@.............@@@@@@@@@@@@@@@
....@@............@@..................@@@@@@@@@@..........@....@@@.....@..@.@..@@@@@@@@@@@@@@@@@
....@........@....@@...................@@@@@@@@...........@.....@...............@@@@@@@@@@@@@@@@
...@@.............@.....@..............@@@@@@@@.....@@@...........@@............@@@@@@@@@@@@@@@@
...@@...............@..@..............@@@@@..@..@...@@.............@..........@@@@@@@@@@@@@@@@@@
..@@@@@@@@.........@@@........@@..@@@@@@@@@......................@@......@...@@@@@@@@@@@@@@@@@@@
...@.@@@...........@@@@....@.@@@.@...@@..@@.........@@@......................@@@@@@@@@@@@@@@@@@@
.....@@@...........@@@.....@@@@@@...................@.......@................@@@@@@@@@@@@@@@@@@@
..........@@......@@@@.....@@@@.@.....@.........@@..................@.....@...@@@@@@@@@@@@@@@@@@
....@......@....@.@@@@.....@@@@................@@@@.....@...@@@.....@.....@@@@@@@@@@@@@@@@@@@@@@
@..@@...............@@......@@@................@.@..........@@........@....@@@@@@@@@@@@@@@@@@@@@
@...........................@@.......@...@....@.............@@............@@@@@@@@@@@@@@@@@@@@@@
@.@.@......@...@@@....@@@..@@.@...............@@............@@@....@.......@@@@@@@@@@@@@@@@@@@@@
@...@..@@@............@@@....................@@@@....@..@..........@@.......@@@@@@@@@@@@@@@@@@@@
@@@@...@@@.........@@@.@@........................@...@..@.........@@........@@@@@@@@@@@@@@@@@@@@
@@................................@.....@.....@...@@..................@..@@@@@@@@@@@@@@@@@@@@@@@
@@...................@@..@........@....@@@..@..........@........@.....@@@@@@@@@@@@@@@@@@@@@@@@@@
@@....@..@@............@...............@@@.............@................@@@@@@@@@@@@@@@@@@@@@@@@
@@....@................@...............@@@.............@.@@......@.@@@..@@@@@@@@@@@@@@@@@@@@@@@@
@@@....................@...............@@@...............@@......@@@@@..@@@@@@@@@@@@@@@@@@@@@@@@
@@.............@.........................@@........@@@..@@@@......@@@@@@@@@@@@@@@@@@@@@@@@@@@@@@
@@................@.@..................@@@@........@@@@@@@@....@@@@@@@@@@@@@@@@@@@@@@@@@@@@@@@@@
@............@@@@.@@..............@....@@@@@@@...@.@@@@@@@@@@..@@@.@@@@@@@@@@@@@@@@@@@@@@@@@@@@@
@............@.@@@@.......@.....@.......@@@@@....@@@@@@@@@@@@@@@@@.@@@@.@@@@@@@@@@@@@@@@@@@@@@@@
@..............@.........@................@@@.....@@@@@@@@@@@@@@......@.@@@@@@@@@@@@@@@@@@@@@@@@
..................@.@..@............................@@@@@@@@@@@@......@.@.@@@@@@@@@@@@@@@@@@@@@@
.........................................@..........@@@@@@@@@@@@..........@@@@@@@@@@@@@@@@@@@@@@
..@.....@......@@..@..@..........@...............@...@...@@@@@@@.....@....@@@@@@@@@@@@@@@@@@@@@@
.@.............@@...@.......@@............................@@@@@@..........@@@@...@@@@@@@@@@@@@@@
...............@....................@........@@@@........@@@@@@@.@..@.....@@@....@@@@@@@@@@@@@@@
....@....@....@@......@.........@...@.......@@@@@.@@......@@@@@@.@..@.....@@@....@@@@@@@@@@@@@@@
@@.@@@@......@@@@...................@........@@@@..@@....@@...............@....@..@@@@@@@@@@@@@@
@@@@@@@@.......@..............................@@...@@@.........................@@@..@@@@@@@@@@@@
@@@@@@@@.........@.....................@.......@.............................@@.......@@@@@@@@@@
@@@@@@@@..............@.....@..........@@@......@@@@.@........@...............@......@@@@@@@@@@@
@@@@@@@@.........@@....................@@@........@..@.............@..........@@.......@@@@@@@@@
@@@@@@@@...............................@@@................@........@@@@................@@@@@@@@@
@@@@@@@@@....@@@@.......@...............@..........................@@@@@.............@@@@@@@@@@@
@@@@@@@@@@....@@@......@.......@.@...............@.................@@@@@........@@@@@@@@@@@@@@@@
@@@@@@@@@@....@@@@.....@.@@@....@@@@..@@........@....@..........@...@@....@@...@@@@@@@@@@@@@@@@@
@@@@@@@@@@@...@@@@@...@@@@@@...........@..............@........................@@@@@@@@@@@@@@@@@
@@@@@@@@@@@@...@@@@...@@@@@.......@.....@................@@@...................@@@@@@@@@@@@@@@@@
@@@@@@@@@@@@@..@@@.....@@@.@..@@..@..........@...................@....@@.......@@@@@@@@@@@@@@@@@
@@@@@@@@@@@@@@@................................@..........................@..@@@@@@@@@@@@@@@@@@@
@@@@@@@@@@@@@@@@@...............@.............@...........................@@@@@@@@@@@@@@@@@@@@@@
@@@@@@@@@@@@@@@@@@............................@@@.@.......................@@@@@@@@@@@@@@@@@@@@@@
@@@@@@@@@@@@@@@@@............@.........@...@@............@@................@@@@@@@@@@@@@@@@@@@@@
@@@@@@@@@@@@@@@@@..@@@...@.@.@......@@.....@.........@@@@@@@............@..@@@@@@@@@@@@@@@@@@@@@
@@@@@@@@@@@@@@@@@@@@@@..@@@@@@..................@...@@@@@@@...........@@@..@@@@@@@@@@@@@@@@@@@@@
@@@@@@@@@@@@@@@@@@@@@@@@@@@@@@..@...............@.....@@@@............@@@....@@@@@@@@@@@@@@@@@@@
@@@@@@@@@@@@@@@@@@@@@@@@..............................@@......@@@@....@@@....@@@@@@@@@@@@@@@@@@@
@@@@@@@@@@@@@@@@@@@@@@@@..@.....@.............@.......@@.........@...@@@@...@@@@@@@@@@@@@@@@@@@@
@@@@@@@@@@@@@@@@@@@@@@@@.................................@@..........@@@...@@@@@@@@@@@@@@@@@@@@@
@@@@@@@@@@@@@@@@@@@@@@@@@@@@@@@@@..........@...@...@..............@@@@@@@@.@@@@@@@@@@@@@@@@@@@@@
@@@@@@@@@@@@@@@@@@@@@@@@@@@@@@@@@..........@.............@@......@@@@@@@@..@@@@@@@@@@@@@@@@@@@@@
@@@@@@@@@@@@@@@@@@@@@@@@@@@@@@@..........................@@.......@@@@@@@..@@@@@@@@@@@@@@@@@@@@@
@@@@@@@@@@@@@@@@@@@@@@@@@@@@@@@..@@@............@.........@....@.@@@@@@@....@@@@@@@@@@@@@@@@@@@@
@@@@@@@@@@@@@@@@@@@@@@@@@@@@@@@@@@@@@@.........@..........@...@@@@@@@@@@....@@@@@@@@@@@@@@@@@@@@
@@@@@@@@@@@@@@@@@@@@@@@@@@@@@@@@@@@@@@......................@@@@@@@@@@@@@.@@@@@@@@@@@@@@@@@@@@@@
@@@@@@@@@@@@@@@@@@@@@@@@@@@@@@@@@@@@@.@.......................@@@@@@@@@@@@@@@@@@@@@@@@@@@@@@@@@@
@@@@@@@@@@@@@@@@@@@@@@@@@@@@@@@@@@@@@.@..........@....@.......@@@@@@@@@@@@@@@@@@@@@@@@@@@@@@@@@@
@@@@@@@@@@@@@@@@@@@@@@@@@@@@@@@@@@@@....@.............@@@........@@@@@@@@@@@@@@@@@@@@@@@@@@@@@@@
@@@@@@@@@@@@@@@@@@@@@@@@@@@@@@@@@@@@@...........@..@..@@@@.......@@@@@@@@@@@@@@@@@@@@@@@@@@@@@@@
@@@@@@@@@@@@@@@@@@@@@@@@@@@@@@@@@@@@@@.............@.@@......@@@@@@@@@@@@@@@@@@@@@@@@@@@@@@@@@@@
@@@@@@@@@@@@@@@@@@@@@@@@@@@@@@@@@@@@@@.............@@@@........@@@@@@@@@@@@@@@@@@@@@@@@@@@@@@@@@
@@@@@@@@@@@@@@@@@@@@@@@@@@@@@@@@@@@@@@@..@@...@....@@@@.@@@@@..@@@@@@@@@@@@@@@@@@@@@@@@@@@@@@@@@
@@@@@@@@@@@@@@@@@@@@@@@@@@@@@@@@@@@@@@@@..@.......@@@@@@@@@@@@@@@@@@@@@@@@@@@@@@@@@@@@@@@@@@@@@@
@@@@@@@@@@@@@@@@@@@@@@@@@@@@@@@@@@@@@@@@@..........@@@@@@@@@@@@@@@@@@@@@@@@@@@@@@@@@@@@@@@@@@@@@
@@@@@@@@@@@@@@@@@@@@@@@@@@@@@@@@@@@@@@@@@..........@@@@@@@@@@@@@@@@@@@@@@@@@@@@@@@@@@@@@@@@@@@@@
8
52 40 0
21 6 0
40 17 0
21 29 0
69 19 0
15 21 0
62 6 0
52 14 0

54 38 0
43 89 0
3 53 0
48 45 0
35 26 0
64 15 0
47 20 0
73 58 0
