width 38
height 38
@.@........@..@@@@@@@.....@@@@@@@@@@@@
@.............@@@@@@@.....@@@@@@@@@@@@
@..@@@.@@.....@..@.@@@....@@..@@@@@@@@
@...@@.@@@....................@@@@@@@@
..@.@..@.@@..................@@@@@@@@@
..@@@...............@........@@@@@@@@@
..@@@.......@..........@.....@@@@@@@@@
..@@@..........@@......@.....@@@@@@@@@
..@@..@.@.............@@....@@@@@@@@@@
@..........................@@@@@@@@@@@
@@.........................@@@@@@@@@@@
@@....................@....@@@@.@@@@@@
@@@@..............@@@@@...........@@@@
@@@@.............@@@@..............@..
..@............@..@@@..............@@.
.....@.....@@@...@@@@@@@.@@...........
...@.@...........@@@@@@@...........@..
.@@..@@.........@@@@.........@@@......
@@@@@@@...........@@..@.............@@
@@@@@@........@....@.........@.@..@@@@
.@@@@@.............@.............@@@@@
.@...@...........@..........@@....@@@@
.@@.......@@.......@..............@...
..........@@..........................
...@.......@..@.......................
...@....@....@........................
@@................@.............@.....
@@.............@......@@.............@
@@.............@......................
@@....................................
@@@............@......................
@@.......@..@@@@....@@..............@@
@@@@@.........@....@......@..........@
@@@@@.........@...........@..........@
@@@.....@@@...@...@..................@
@@@@.....@@..@@@..@@@@@..............@
@@@@@.....@.@@@@@.@@@.................
@@@@..........@@@@@@@@.@@@@@.........@
8
29 24 0
25 7 0
17 4 0
29 28 0
12 4 0
19 31 0
16 16 0
27 4 0

6 3 0
6 5 0
29 37 0
31 26 0
28 22 0
24 16 0
9 19 0
13 2 0
