width 38
height 38
@@@@@@@@@@@@@@@@@@@@@@@@@@@@@@@@@@@@@@
@@@@@@@@@@@@@@@@@@@@@@@@@@@@@@.@@@@@@@
@@@@@@@@@@@@@@@@@@@@@@@@@@@@.....@@@@@
@@@@@@@@@@@@@@@@@@@@@@@@@@@@.....@@@@@
@@@@@@@@@@@@@@@@@@@@@@@@@@@@.....@@@@@
@@@@@@@@@@@@@@@@@@@@@@@@@@@@@@.......@
@@@@@@@@@@@@@@@@@@@@@@@@@@@@@@.......@
@@@@@@@@@@@@@@@@@@@@@@@@@@@@@.........
@@...@@@@@@@@@@@@@@@@@@@@@@@@@.....@..
..........@@@@@@@@@@@@@@@@.@......@..@
..@@....@.@@@@@@@@...@@@@@.........@..
.....@..@.@@@..@@@.....@..............
...........@...........@..@..........@
...@@@@..................@@.@.........
...@@@......................@.........
...@@...............@.................
.@@@@@................................
.@@..@......@@........................
@@@........@@............@....@.......
@@.........@@...................@.....
....@...........@......@@@............
......................@@@@....@......@
..........@.............@............@
.............................@......@@
....@............@.................@@@
.................@.............@@@@@@@
@@@.......@.........@@.........@@@@@@@
@@@@@..........@....@@....@..@@@@@@@@@
@@@@@.....................@@.@@@@@@@@@
@@@@...........@..........@@@@@@@@@@@@
@@@@.......................@@@@@@@@@@@
@@@..............@.........@@@@@@@@@@@
@@@.............@@.........@@@@@@@@@@@
@@@@@............@@.@.....@@@@@@@@@@@@
@@@@@...............@@@@@@@@@@@@@@@@@@
@@@@@........@.......@@@@@@@@@@@@@@@@@
@@@@@@..@@...........@@@@@@@@@@@@@@@@@
@@@@@@...@@....@@....@@@@@@@@@@@@@@@@@
8
8 25 0
37 20 0
9 10 0
20 22 0
30 4 0
21 18 0
12 12 0
26 30 0

8 25 0
37 20 0
30 10 0
31 6 0
19 29 0
10 25 0
13 30 0
10 35 0
