width 38
height 38
@.....@@@.@@@@@@@@@@@@......@@@@@@@@.@
@.....@@..@@@@@@@@@@@................@
@.....@...@@@@@@@@@...................
@...........@@@@@@@@.......@..........
.........@@.@@@@@@@@..................
.........@@@@.@@@@@@..................
.........@@@..........................
..@@...@..................@@.........@
..@@...............@@.................
..@......................@............
.........@@@@..........@@........@...@
..........@@@.........................
........@@@@@@.................@.@...@
....@...@@@@@@........@......@.......@
....@....@..@@......................@@
.......@....@.........@.......@..@..@@
.......@.....................@@@....@@
...........................@@@@@..@..@
................@.....@.....@@@@@@@@.@
......@......@@@......@@....@@@@@@@...
.............@.@............@@.@@@@@@@
..........@@@..................@@@@.@@
........@......................@@@@..@
...@....@............@..@............@
........@............@......@.........
.....................@@...............
.........@@..........................@
@@.@..@.............@@@@.@............
@@@@..@..@..@@....@...@@.........@.@..
@@@@@.@@@@@@@@@...@....@@........@....
@@@@@@@@@@@@@@@@..@@@@@@@....@@.......
@@@@@@@@@@@@@@@@@@@@@@@@@@.@@@@.......
@@@@@@@@@@@@@@@@@@@@@@@@@@.@@@@@@.....
@@@@@@@@@@@@@@@@@@@@@@@@@@@@@@@@@.....
@@@@@@@@@@@@@@@@@@@@@@@@@@@@@@@@@@@...
@@@@@@@@@@@@@@@@@@@@@@@@@@@@@@@@@@@..@
@@@@@@@@@@@@@@@@@@@@@@@@@@@@@@@@@@@.@@
@@@@@@@@@@@@@@@@@@@@@@@@@@@@@@@@@@@.@@
8
9 17 0
18 6 0
0 17 0
20 19 0
2 21 0
20 5 0
34 14 0
8 1 0

15 15 0
19 7 0
34 29 0
1 21 0
19 6 0
5 8 0
9 19 0
32 28 0
