width 38
height 38
@@@@@@@@@@@@@@@@@@@@@@@.@@@@@@@@@@@@@@
@@@@@@@@@@@@@@@@...@@@..@@@@@@@@@@@@@@
@@@@@@@@@@@@@@@@@....@.....@@@@@@@@@@@
@@@@@@@@@@@@@@@.........@..@@@@@@@@@@@
@@@@@@@@@@@@@@@.@.............@@@@@@@@
@@@@@@@@@@@@@@@....@@.........@@@@@@@@
@@@@@@@@@@@@@@@...........@...@@@@@@@@
@@@@@@@@@@@@@@@@..........@..@@@@@@@@@
@@@@@@@@@@@@@@@@.............@@@@@@@@@
@@@@@@@@@@@@@...............@@@@@@@@@@
@@@@@@@@@@@...................@@...@@@
@@@@@@@@@@@..................@@@..@@@@
@@@@@@@@@@@@@@...@...........@@@.@@@@@
@@@@@@@@@@@@@@.@.......@.........@.@@@
@@@@@@@@@@@@@@.........@...........@@@
@@@@@@@@@@@@@@....@@..@..@@.@@@@..@@@@
@@@@@@@@@@@@@@.@@@@.......@@@@@@..@@@@
@@@@@@@@@@@@@..@@.........@@@......@@@
@@@@@@@@@@@@@..........@@@@@@.........
@@@@@@@@@@@@@@@.........@@@@@.......@.
.@@@@@@@@@@@@@@........@@@@@.........@
..@@@@@@@@@@@@@@.....@...@@@.........@
...@@@@@@@@@.@......................@@
.........@@............@..............
.@............@...........@...........
...........................@..........
...............@....@@..@.............
....................@@................
..........@.........@.................
@@....@.....................@@@......@
...........@................@@@....@@@
@..................................@@@
@...........@......................@@@
...@.......@@......................@@@
.............................@@...@@@@
.....@@.................@....@@@@@@@@@
.....@@@..............@@@....@@@@@@@@@
.@....@@..@@...........@@@@..@@@@@@@@@
8
24 23 0
18 35 0
12 37 0
10 29 0
18 17 0
25 3 0
32 23 0
21 4 0

29 5 0
18 35 0
19 35 0
29 18 0
18 6 0
23 4 0
34 18 0
31 30 0
