width 38
height 38
@....@@@@@.....@.@@..@@@@@@.@@....@@@@
.@@...@@@@.....@.....@@@@@@.@.....@@@@
........@@@@...@@....@@..@@.......@.@@
.....@...............@@...@.........@@
......................@............@@@
.......@@@@...........@............@@@
.......@@.....@..............@@.......
.@.@.....@@................@..........
.@@@@............@.............@@.....
@@@@@@@@........................@.....
@@@@@@@@..............................
@@@@@@@@.@@.................@.........
@@@@@@@@.......................@.@....
@@@@@@@............@@...........@.....
@@@@@@@............@@.................
@@@@@@@.......@@@..@@@.........@@.....
@@@@@@@...@@...@.........@@@..@@@@@@@.
@@@@@@.@..........@.......@@...@@@@@..
@@@@@.............@......@@@....@@@@@.
@@@@.....................@@@....@@@@@.
@@@@.....................@@@@@@.@@@@..
@@@@......@.............@@@@@@@@@....@
@@@@.....................@@@@@.@@.....
@@@@@.........@@..........@@@@.@....@.
@@@...........@@...@.......@@@........
..............@.........@@@@@@@......@
.....@@..................@@@@@@@......
@..............@@@@@@@@.@@@@@@@@@.@@..
@@@............@@@@@@@@@@@@@@@@@@@@...
@@@@.@@@..@.@..@@@@@@@@@@@@@@@@@@@@.@@
@@@@@@@@@@@@@@@@@@@@@@@@@@@@@@@@@@@@@@
@@@@@@@@@@@@@@@@@@@@@@@@@@@@@@@@@@@@@@
@@@@@@@@@@@@@@@@@@@@@@@@@@@@@@@@@@@@@@
@@@@@@@@@@@@@@@@@@@@@@@@@@@@@@@@@@@@@@
@@@@@@@@@@@@@@@@@@@@@@@@@@@@@@@@@@@@@@
@@@@@@@@@@@@@@@@@@@@@@@@@@@@@@@@@@@@@@
@@@@@@@@@@@@@@@@@@@@@@@@@@@@@@@@@@@@@@
@@@@@@@@@@@@@@@@@@@@@@@@@@@@@@@@@@@@@@
8
19 6 0
17 11 0
16 1 0
32 10 0
8 12 0
21 6 0
16 9 0
20 25 0

0 26 0
37 18 0
14 2 0
20 5 0
16 14 0
14 12 0
2 3 0
16 19 0
