width 38
height 38
...@@@......@@@....@@....@@@@@@@@@@@@@
.....@.@@@..............@@@@@@@@@@@@@@
.....@.@@@...............@@@@@@@@@@@@@
.@.....@@@.......@....@...@@@@@@@@@@@@
........@@@......@.@......@@@@@@@@@@@@
..................@@...@..@@@@@@@@@@@@
............@.@.........@.@@.@@@@@@@@@
.........@@....@....@........@@@@@@@@@
.........@@....@@@@@@@........@@@@@@@@
.................@@@@@........@@@@@@@@
@@...@...........@@@@@....@...@@@@@@@@
.................@@.......@...@@@@@@@@
............@.@...@............@@@@@@@
.......@@.....@................@@@@@@@
@@@@....@@.........@@...@@.....@@@@@@@
@@@@....................@@@....@@@@@@@
@@@@.@................@@@@@@...@@@@@@@
@@......@.@@@........@@@@@@@..@@@@@@@@
@@@@@@..@@@@@..@..@.@@@@@@@@..@@@@@@@@
@@@@@@@@@@@@@@.@......@@@@.....@@@@@@@
@@@@@@@@@@@@@@....@.....@@......@@@@@@
@@@@@@@...@.......................@@@@
@@@@@@....@@...........@..........@@@@
@@@@@@.....@......................@@@@
@@@@....@.........................@@@@
@@@...@.@@..@@..........@..........@@@
@@@.........@..........@@..........@@@
@@@.......@.@......................@@@
@.......................@............@
.........@.................@.........@
.........@.........@@@@.@@@@@@@@@@...@
............@@.....@@@@.@@@@@@@@@@....
.@@@@.....................@@@@@@@@....
@@@@@....................@@@@@@@@@@@..
@@@@@.........@@......@..@@@@@@@@@@@..
@@@@@.........@@...@......@@@@@@@@@@..
@@@@@@@......@@@..........@@@@@@@@@@.@
@@@@@@@......@@@@.@@@......@@@@@@@@@@@
8
18 13 0
23 29 0
2 1 0
16 0 0
10 3 0
19 20 0
25 29 0
30 16 0

5 27 0
6 10 0
16 10 0
35 31 0
19 6 0
33 27 0
3 7 0
26 27 0
