width 38
height 38
......@......@@@@.......@@@@@@@.......
.@............@@@.......@@@@..........
..............@@.......@@@@@.@........
.............@@@........@@@@..........
.........@..@.@@......@.@@@@..@@......
...........@@...........@@@@@@........
........@.@@@..............@....@@@...
.@.........................@...@@@@...
.....@........................@@@@@@@@
..............................@@@@@@@@
.....................@@..@...@@@@@@@@@
......@@@...................@@@@@@@@@@
......@@@...................@@@@@@@@@@
.......@@..........@@@......@@@@@@@@@@
.................@@@@@@..@@@@@@@@@@@@@
.................@@@@@..@@@@@@@@@@@@@@
.................@@@@@@.@@@@@@@@@@@@@@
...............@@@@@@@@.@@@@@@@@@@@@@@
@....@......@...@@@@@@@.@@@@@@@@@@@@@@
.......@@........@@@@.@.@@@@@@@@@@@@@@
.......@@........@@@@...@@@@@@@@@@@@@@
............@...@@@@@@@@@@@@@@@@@@@@@@
................@@@@@@@@@@@@@@@@@@@@@@
@@...............@@@@@@@@@@@@@@@@@@@@@
@................@@@@@@@@@@@@@@@@@@@@@
..................@@@@@@@@@@@@@@@@@@@@
@............@....@@@@@@@@@@@@@@@@@@@@
@.......@....@.....@@@@@@@@@@@@@@@@@@@
........@......@@@@@@@@@@@@@@@@@@@@@@@
...............@@@@@@@@@@@@@@@@@@@@@@@
..............@@@@@@@@@@@@@@@@@@@@@@@@
.......@@..@......@@@@@@@@@@@@@@@@@@@@
..@@.@.@@@@........@@@@@@@@@@@@@@@@@@@
.......@@@@.......@@@@@@@@@@@@@@@@@@@@
@......@@@........@@@@@@@@@@@@@@@@@@@@
@@@...@@@.........@@@@@@@@@@@@@@@@@@@@
@@@.............@@@@@@@@@@@@@@@@@@@@@@
@@@@@@@@..@@@@@@@@@@@@@@@@@@@@@@@@@@@@
8
14 23 0
2 11 0
5 31 0
10 8 0
16 26 0
23 13 0
27 13 0
15 7 0

13 2 0
1 30 0
29 6 0
8 15 0
1 22 0
4 35 0
3 31 0
23 10 0
