width 38
height 38
@@@@@@@......@@@@@@..@@@.@............
@@@@@@........@@@@@@.........@.......@
@@.............@@@@@@.................
@@@....@@......@@@@@..................
@@....@@@.........@@..................
....@@@@@@.@...........@@@..@....@...@
....@@@@@@...@..........@...@........@
....@@@@@@..@....@.....@....@@.......@
....@.@@@...................@.......@@
......@@@...@..........@@..@@..@..@@@@
.......................@@@........@@@@
.........@......@..................@@@
.........@....@.@...@...@@.....@.....@
...@@@@@.....@@@@........@........@@.@
...@@@@@....@@@.@...........@.....@@.@
.....@@@@...@@..@.......@@.......@@...
......@................@@@@@.....@@@..
@.......................@@@......@@@..
......................@@@@@..@@..@@...
....................@@................
...................@@@@..@............
@@@...................@...............
.................@....@.@@....@.......
@..........@..........@@@@@@@.@@......
...@......@@.......@@@@@@@@@@@@@..@@..
@..@.....@@@........@@@@@@@@@@@@@.@@@@
.........@@..........@@@@@@@@@@@@@@@@@
.........@@...........@@@@@@@@@@@@@@@@
...................@.@@@@@@@@@@@@@@@@@
..................@@@@@@@@@@@@@@@@@@@@
@@.............@@@@@@@@@@@@@@@@@@@@@@@
...............@@@@@@@@@@@@@@@@@@@@@@@
.......@.......@@@@@@@@@@@@@@@@@@@@@@@
.....@.@..@....@@@@@@@@@@@@@@@@@@@@@@@
....@....@@.@@@@@@@@@@@@@@@@@@@@@@@@@@
@........@..@@@@@@@@@@@@@@@@@@@@@@@@@@
@@@@.....@.@@@@@@@@@@@@@@@@@@@@@@@@@@@
@@@........@@@@@@@@@@@@@@@@@@@@@@@@@@@
8
18 18 0
2 8 0
32 18 0
33 2 0
2 6 0
18 20 0
29 23 0
11 18 0

4 37 0
30 2 0
17 8 0
33 2 0
7 10 0
12 4 0
8 21 0
6 32 0
