width 38
height 38
@@@@@@@@@@@@@@@@@@@@@@@@@@@@@@@@@@@@@@
@@@@@@@@@@@@@@@@@@@@@@@@@@@@@@@@@@@@@@
@@@@@@@@@@@..@@@@@@@@@@@@@@@@@@@@@@@@@
@@@@@@@@@@...@@@@@@@@@@@@@@@@@@@@@@@@@
@@@@@@@@@@@@..@@@@@@@@@@@@@@@@@@@@@@@@
@@@@@@@@@@@.....@@@@@@@@@@@@@@@@@@@@@@
@@@@@@@@@@@.......@@@@@@@@@@@@@@@@@@@@
@@@@@@@@@@.......@@@@@@@@@@@@@@@@@@@@@
@@@@@@@@..........@@@@@@@@@@@@@@@@@@@@
@@@@@@@@..........@@@@@@@@@@@@@@@@@@@@
@@..@@@..@..@......@@@@@@@@@@@@@@@@@@@
@@......@@..@......@..@@@@@@@@@@@@@@@@
@@@@.................@@@@@@@@...@@@@@@
@@@@.......@@......@@@@@@@@@@......@@@
@@@@.......@@....@.@@@@@@@@@.........@
@@@@...............@@@@@.@@...........
@@@@........@@.....@@@@@....@.........
@@@.........@.......@@@@.....@.....@..
@@@....@@..@@.........@......@........
@@@......@.@@.......@.@...............
@...........@@........................
@............@................@@......
@@...........@.........@...........@@@
@@....@..............@....@........@@@
@.....@@.................@@......@@@@@
.......@@@...............@@.......@@@@
@.@@@.@.@@.......................@@@@@
.@@...@..@..........@@........@@@@@@@@
.............................@@@@@@@@@
....@.........@.........@@.@@@@@@@@@@@
.......@.@..........@..@@@@@@@@@@@@@@@
....................@...@@@@@@@@@@@@@@
..@....................@@@@@@@@@@@@@@@
..@..............@@.......@@@@@@@@@@@@
@@@...........@..@@.......@@@@@@@@@@@@
@@@...........@.....@@....@@@@@@@@@@@@
@@......@..........@@@...@@@@@@@@@@@@@
@@......@.@@.......@@@...@@@@@@@@@@@@@
8
15 7 0
9 16 0
12 34 0
12 23 0
16 25 0
2 23 0
13 25 0
25 16 0

25 16 0
7 27 0
21 30 0
34 14 0
30 18 0
12 9 0
15 36 0
25 17 0
