width 38
height 38
@@@@@@@@@@@........@..@@@@@@@@@@@@@@@@
@@@@@@@@@@............@@@@@@@@@@@@@@@@
@@@@@@@@@..............@@@@@@@@@@@@@@@
@@@@@@@@@...............@@@@@@@@@@@@@@
@@@@@@@@@..............@@@@@@@@@@@@@@@
@@@@@@@@@...............@..@@@@@@@@@@@
@@@@@@@@@......@@...........@@@@@@@@@@
@@@@@@@@@..........@......@...@@@@@@@@
@@@@@@@@@..........@...@@.....@@@@@@@@
@@@@@@@@@............@.@@@......@@@@@@
@@@@@@@@@@@...........@@........@@@@@@
@@@@@@@@@@@...........@.........@@@@@@
@@@@@@@@@@............@.........@@@@@@
@@@@@@@@@@....................@@@@@@@@
@@@@@@@@@.....................@@@@@@@@
@@@@@@@@.....................@@@@@@@@@
@@@@@@@@.......@...........@.@@@@@@@@@
@@@@@@@@.....@@............@@@@@@@@@@@
@@@@@@@...................@@@@@@@@@@@@
@@@@@@....................@@@@@@@@@@@@
@@@............@...........@@@@@@@@@@@
@.........@.@...@..........@@@@@@@@@@@
................@......@...@@@@@@@@@@@
..............@.....@......@@@@@@@@@@@
................@...@......@@@@@@@@@@@
................@@........@@@@@@@@@@@@
..@@..@@@..................@@@@@@@@@@@
@....@@@@...................@@@@@@@@@@
@@......@.....@@.@...........@@@@@....
.................@@@..@....@@@@@.@....
....@...........@@.............@......
@....@................................
...@........@............@............
...........@@...@...@@................
..................@@@@......@@@......@
@.....@........@@@@@@@@@...@@@@@.....@
@@@@..........@@@@@@@@@@..@@@@@@@@..@@
@@@@@..@..@@@@@@@@@@@@@@@@@@@@@@@@..@@
8
22 31 0
15 0 0
10 7 0
12 31 0
32 33 0
28 8 0
18 32 0
5 25 0

23 31 0
9 36 0
32 29 0
36 28 0
20 11 0
34 34 0
3 20 0
24 30 0
