width 38
height 38
@@@@@@@@@@@@@...........@@@@@@@@@@@@@@
@@@@@@@@@@@@@...........@@@@@@@@@@@@@@
@@@@@@@@@@@@@@.......@@..@@@@@@@@@@@@@
@@@@@@@@@@@@@@@@..........@@@@@@@@@@@@
@@@@@@@@@@@@@@@@...........@@@@@@@@@@@
@@@@@@@@@@@@@@@....@.@@.@..@@@@@@@@@@@
@@@@@@@@@@...@@............@@@@@@@@@@@
@@@@@@@@.....@@..........@@@@@@@@@@@@@
@@@@@@@@.....@........@@@@@@@@@@@@@@@@
@@....@@.@.......@.....@.@@@@@@@@@@@@@
@@.......@@...@...........@@@@@@@@@@@@
@@...........................@@@@@@@@@
@@@@..............@..........@@@@@@@@@
@@@@@.........@................@@@@@@@
@@@@...........@@...........@..@@@@@@@
@@@@...........@@...@..........@@@@@@@
@@@@...........@@..@..........@@@@@@@@
@@@@@................@.......@@@@@@@@@
@@@@....@@@@..@@..............@@@@@@@@
@@@@.@...@.@@@@@@..........@@@@@@@@@@@
@@@@.......@@@@@@....@....@@@@@@@@@@@@
@@@.........@@@@.....@@...@@@@@@@@@@@@
@@@.....@.@@..@@......@....@@@@@@@@@@@
@@@@.......@............@@.@@@@@@@@@@@
@@@@.........@@........@@..@@@@@@@@@@@
@@@@...................@......@@@@@@@@
@@@@..............@...........@@@@@@@@
@@.@.....@@....@...@...........@@@@@@@
.........@@@@.@..........@@...@@@@@@@@
....@@@....@@@@...........@....@.@@...
.@@@@@@...@@@@@..............@@.......
@@@@@@@..@@@@@@@......................
@@@@@@@@.@@@@@@@@.....................
@@@@@@@@..@@@@@@@.....................
@@@@@@@....@@.@.......................
@@@@@@@@..............................
@@@@@@@@.......@...........@.@@@@.....
@@@@@@@@@....@@@.....@@....@@@@@......
8
21 24 0
30 29 0
15 34 0
23 21 0
33 35 0
23 27 0
0 28 0
16 0 0

34 31 0
16 0 0
20 19 0
9 34 0
4 18 0
7 31 0
35 30 0
17 19 0
