width 30
height 30
.......@@@...@..@@@@@@@@@@@@@@
........@.........@@@@@@@@@@@@
........@.......@@@@@@@@@@@@@@
................@@@@@@@@@@@@@@
....@.........@@@@@@@@@@@@@@@@
.....@.......@@@@@@@@@@@@@@@@@
.............@@@@@@@@@@@@@@@@@
....@....@....@@@@@@@@@@@@@@@@
...............@@@@@@@@@@@@@@@
...@........@@@@@@@@@@@@@@@@@@
.........@@@@@@@@@@@@@@@@@@@@@
.........@@@@@@@@@@@@@@@@@@@@@
..........@@@@@@@@@@@@@@@@.@@@
..........@@@@@@@@@@@@@@@..@@@
...........@@@@@@@@@@@@@@....@
...........@@@@@@.....@@@....@
..........@@@.........@@.....@
..........@@@.................
.....@@...@@@................@
......@.....@@.....@@@......@@
....................@@@..@@@@@
...........@.........@@..@@@@@
....................@@@@@@@@@@
.................@@@@@@@@@@@@@
..@...........@..@@@@@@@@@@@@@
..@..............@@@@@@@@@@@@@
..................@@@@@@@@@@@@
@@@@@@.............@@@@@@@@@@@
@@@@@@.........@...@@@@@@@@@@@
@@@@@@.@............@@@@@@@@@@
8
6 15 0
3 7 0
10 15 0
0 12 0
10 2 0
3 4 0
11 26 0
7 5 0

2 9 0
25 18 0
1 2 0
12 26 0
5 19 0
12 3 0
4 21 0
6 11 0
