width 30
height 30
@@@@@@@@@@....................
@@@@@@@@@@.............@......
@@@@@@@@@@....................
@@@@@@@@......................
@@..@@...@......@.............
@........@......@....@@.@@@...
........................@@@...
.....................@@@@@@...
@...................@@@@@@@..@
@..........@.....@..@@...@@.@@
.................@.....@.@@@@@
@......@............@.@@.@@@@@
@@.....@............@@@@......
@..............@..............
@.............@...............
@......@@.....@...........@@@.
...........@.....@........@@@.
........@@................@@@@
@@@@@@@@@@....................
@@@@@@@@@....@.......@.@@.....
@@@@@@@@.........@............
@@@@..@@.....@....@...........
@@@@.........@...@@...@@......
.@....................@@......
......................@@......
@.............................
@.............................
@...@..............@.........@
@@...................@...@@@.@
@@......@................@@@@@
8
27 20 0
4 17 0
7 24 0
11 19 0
8 16 0
26 18 0
1 26 0
5 28 0

14 23 0
26 0 0
17 27 0
22 9 0
29 0 0
0 10 0
12 25 0
28 13 0
