width 30
height 30
........@@@@@.@.....@@@@@@@@@@
.........@@@..@....@@@@@@@@@@@
.....@...@@.....@..@@@@@@@@@@@
@@@@..................@@@@@@@@
@@@@@@.......@.........@@@@@@@
@@@@@@@@.@.............@@@@@@@
@@@@@@@@@......@...@....@@@@@@
@@@@@@@@...@.@..........@@@@@@
@@@@@@@@...@@........@..@@@@@@
@@@..@@..@@..........@.@@@@@@@
@@@....................@@@@@..
@....@.................@@@@@..
@@@@....................@@@..@
@@@@....@.........@.....@@@...
@@@@..................@.@.....
@@@@@.........@@.............@
.@@@@...@......@.............@
...@.....@....................
........@@..........@.........
.........@....................
........@@.........@.......@..
..@.....@@.................@..
.....@@@@@...@......@@.@.@.@@@
....@@@@...........@@@.@...@@@
.....@@............@@@@@.@@@@@
.....@@............@@@@@@@@@@@
.@...@@...........@@@@@@@@@@@@
@@.@.@@@@@@@@@@@@..@@@@@@@@@@@
@@@@@@@@@@@@@@@@@...@@@@@@@@@@
@@@@@@@@@@@@@@@@@...@@@@@@@@@@
8
15 8 0
19 11 0
10 7 0
11 23 0
6 4 0
29 17 0
1 2 0
6 16 0

3 25 0
11 10 0
19 29 0
19 5 0
12 1 0
14 16 0
26 22 0
17 26 0
