width 30
height 30
@....@@@@@@@@@...@@@@@@@..@@..
......@@@@@@@@....@@@@@.......
....@.@@@@@@@.....@@@@@@......
.......@@@@....@..@@@@@@......
........@@.......@@@@@@@......
...........@.....@..........@@
.............@.........@@...@@
....@........@.........@@@@@@@
....@@.......@.........@@@@@@@
.@@........@.@@@@......@@@@@@@
.@@..............@..@@@@@@@@@@
..@.....@@.......@@.@..@@@@@@@
..@........@.............@@@@@
............@...........@@@@@@
@.....@................@@@@@@@
...........................@@@
......@@.....................@
@...@@@@......................
....@@@.......................
.....@@......................@
............................@@
..............................
@..@@.@.......................
@..@@@@....@@..@@@@@@@@@@@...@
@@.@@.......@..@@@@@@@@@@@@.@@
@@@@@@......@.@@@@@@@@@@@@@.@@
@@@@@@.@...@@@@@@@@@@@@@@@@@@@
@@@@@@.......@@@@@@@@@@@@@@@@@
@@@@@@......@@@@@@@@@@@@@@@@@@
@@@@@@@.....@@@@@@@@@@@@@@@@@@
8
11 10 0
8 16 0
19 16 0
25 19 0
9 25 0
28 16 0
4 21 0
6 15 0

26 1 0
1 15 0
4 4 0
22 13 0
6 4 0
13 10 0
26 5 0
22 8 0
