width 30
height 30
...@..@..@........@@@@@@@@@@..
..................@@@@@@@@@...
@................@@@@@@@@...@@
@.........@......@@@@@@@@....@
..@.............@@@@@@@@@.....
...................@@@@@@.....
.....@..@@......@@@@@@@@@.....
................@@@@@@@....@.@
.@.......@.@...@..@@..........
@@.@.....@...............@@@@@
@@.@.....@@.....@.....@..@@@@@
@@@@............@@@...@..@@@@@
@@@@...........@@@@...@@@@@@@@
@@@@.......@..@@@@@@@@@@@@@@@@
@.@.......@@.....@...@@@@@@@@@
@..@......@@..@@....@@@@@@@@@@
...@......@@@@@@...@@@@@@.@@@@
...@@.....@@@.@...@@@@@@@.....
@@...@....@@@...@.@@@@.@@@...@
@@@......@@@@...@..@@........@
@@........@@@@..@..@@.........
@@@..........................@
@@.........@......@........@@@
...........@@.....@........@@@
.........@@@@.....@......@..@@
........@@@@@...............@@
@@@@....@@@@@@@@@@@.......@.@@
@@@.....@@@@@@@@...........@@@
@@@.....@@@@@@@@.@@.......@@@@
@@@..@@@@@@@@@@@.........@@@@@
8
29 17 0
14 14 0
19 27 0
27 21 0
9 23 0
7 13 0
12 22 0
15 24 0

27 1 0
14 11 0
8 2 0
13 18 0
26 17 0
27 26 0
4 9 0
5 0 0
