width 30
height 30
@@@@@@@@@@@@@@@@.....@@@@@@@@@
@@@@@@@@@@@@@@@......@@@@@@@@@
@@@@@@@@@@@@@@....@...@@@@@@@@
@@@@@@@@@@@@@@..........@@@@@@
@@@@@@@@@@@@@...........@@@@@@
@@@@@@@@@@@.........@...@@@@@@
@@@@@@@@@.........@....@@@@@@@
@@@@@@@@......@@@.......@@@@@@
@@@@@@@@.....@@@@.......@@@@@@
@@@@@@.@@@.....@@.......@@@@@@
@@@@@@.........@........@@@@@@
@@@@........@............@@@@@
..........................@@@@
..............@...........@@@@
...........@..@@...@@.....@@@@
..............@@....@.........
.............@@@.............@
.............@@@....@.........
@@@................@@@........
@@.................@..........
@@...@.........@@@@@@.........
@@............@@@@@@@@........
@@@..........@@@@@@@@@........
@@@@....@...@@@@@@@@@@....@...
@@@@....@...@@@@@@@@@@.....@..
@@@@....@@..@@@@@@@@@@........
@@@@..@@@@@@@@@@@@@@@@.....@.@
@@@@@@@@@@@@@@@@@@@@@@........
@@@@@@@@@@@@@@@@@@@@@@.@......
@@@@@@@@@@@@@@@@@@@@@@..@....@
8
17 11 0
9 20 0
25 23 0
7 11 0
9 13 0
10 25 0
13 11 0
9 16 0

14 11 0
4 12 0
17 9 0
6 11 0
29 23 0
7 23 0
17 12 0
8 12 0
