width 82
height 82
@@@@@..@@@@.....@@@..........@@.@..@@@@@@@@@@@@@@@@@@@@@@@@@@@@@@@.......@..@@@@@@
@@.....@@@@@.....@@@........@@@....@@@@@@@@@@@@@@@@@@@@@@@@@@@@@@@.......@...@@@@@
@@.....@@.........@@..@....@@@@....@@@@@@@@@@@@@@@@@@@@@@@@@@@@...............@@@@
@@@...............@...@@....@@@...@@@@@@@@@@@@@@@@@@@@@@@@@@..@......@.........@@@
@@@...........@...................@@@@@@@@@@@@@@@@@@@@@@@@@@...................@@@
@@@...............@......@.......@@@@@@@@@@@@@@@@@@@@@@@@@@@.....................@
@@@...............................@@@@@@@@@@@@@@@@@@@@@@@@@.....................@@
@@................@.......@@.....@@@@@@@@@@@@@@@@@@@@@@.........@..........@...@@@
@.......@@................@....@@@@@@@@@@@@@@@@@@@@@@@@.........@............@@@@@
..@@....@@@...................@@@@@@@@@@@@@@@@@@@@@@@@@.........@............@@@@@
@..@@...@@@@@.................@@@@@@@@@@@@@@@@@@@@@@@@..................@........@
...........@....@..........@....@@@@@@@@..@@@@@@@@@@@............................@
................................@@@@@@@@..@@@@@@@@@@@.....@........@............@@
@@...................@@@@......@@@@@@@@...@@@@@@@@@@@@@......................@@.@@
....@................@@@.........@@.@....@@@@@@@@@@@@@@......................@@@@@
.....@..............@@@@..........@.....@@@@@@@@@@@@@@@...@..................@@@@@
@....@@...............@@..................@@@@@@@@@@@@@@.@@...................@@@@
..........................@..............@@@@@@@@@@@@@@@@@@@@.................@@@@
..................@......................@@@@@@@@@@@@@@@@@@@@@@...............@@@@
.@.@...@@....@......@........@..........@@@@@@@@@@@@@@@@@@@@@.................@@@@
@@@.........@@@@@.....@.........@.......@@@@@@@@@@@@@@@@@@@@......@......@@...@@@@
@............@@@@@...@@@...............@@@@@@@@@@@@@@@@@@@@@@@@...@@.@@..@@...@@@@
@.............@@@@@@@@@@@.............@.@@@@@@@@@@@@@@@@@@@@@.....@@.@@.....@@@@@@
@.@@..........@@@@@@@@@@@@@...........@.@@@@@@@@@@@@@@@@..@.......@@.@@.....@@@@@@
@@@@.@@....@@.@@@@@@@@@@@@@@..............@@@@@@@@@@@@....@@.@....@@.........@@@@@
@@@@@@@@@@@@@@@@@@@@@@@@@@@@..@..@@@...@..@@@@@@@@@@@@....@@............@@...@@@@@
@@@@@@@@@@@@@@@@@@@@@@@@@@@@......@@@..@..@@@@@@@@@@@@@....@....@.......@@......@@
@@@@@@@@@@@@@@@@@@@@@@@@@@@@.......@@@@@...@@@@@@@@@@...............@@..@@.......@
@@@@@@@@@@@@@@@@@@@@@@@..........@....@@...@@@@@@.@@................@@@..........@
@@@@@@@@@@@@@@@@@@@@@@........@............@@@@@..................@..@@@.........@
@@@@@@@@@@@@@@@@@@@@@@@....................@@@@@.@...................@@.....@..@@@
@@@@@@@@@@@@@@@@@@@@@@@..............@......................@@@.........@......@@@
@@@@@@@@@@@@@@@@@@@@@@@@..........@@........................@@.....@.............@
@@@@@@@@@@@@@@@@@@@@@@@@..@@@........................@......@@.....@............@@
@@@@@@@@@@@@@@@@@@@@@@@@@@@@@........................@...........@@@...........@@@
@@@@@@@@@@@@@@@@@@@@@@@@@@@....@@..............@..............@@@@@@@...........@@
@@@@@@@@@@@@@@@@@@@@@@@@@@@....@........@....................@@@@@@@@@@....@....@@
@@@@@@@@@@@@@@@@@@@@@...@@@@..@......................@@.....@@@@@@@@@@@....@.....@
@@@@@@@@@@@@@@@@@@@@@.....@@................................@@@@@@@@@@@....@......
@@@@@@@@@@@@@@@@@@@@@..........@.....................@......@@@@@@@@@@@....@......
@@@@@@@@@@@@@@@@@@@@@............@@....@...................@@@@@@@@@@@@..@.@......
@@@@@@@@@@@@@@@@@@@@@.@...@@@@@@@@@......................@@@@@@@@@@@@@@..@........
@@@@@@@@@@@@@@@@@@@@@......@@@..........@@................@@@@@@@@@@@@............
@@@@@@@@@@@@@@@@@@.........@@@............................@@@@@@@@@@@.............
@@@@@@@@@@@@@@@@@@......@.@@@@.................@..........@@@@@@@@@@@.............
@@@@@@@@@@@@@@@@@@@...@.@.@..@.......@..@@..........@......@@@@@@@@@@.............
@@@@@@..@@@@@@@@@@@...............@....@@@..................@@@@@@@@...@........@.
@@@@@@..@@@@@@@@@@@@............@..@...@@@@.@@.....@..............................
@@@@@....@@@@@...@@...........@.........@@.........................@@...@.....@...
@@@@.....@@@@...........@.....@.........@@.@........@..............@@@..@@...@@@@@
@@@@........................@@....................................@@@@..@@.@@@@@@@
@@@@@............................@@..............................@@@..........@@@@
@@@@@........@......................@...@..........@@@.............@..@..@...@@@@@
@@@@@..............................@@..............@@@@......................@@@@@
@@@@@@@...@...............@........@@....@.........@@@@@@@..................@@@@@@
@@@@@@@.@@@@......................@@@..............@@@@@@...@..@.............@@@@@
@@@@@@@@@@@...@.......@@...@......@@..@.@@.....@...@@@@@.......@.@...........@@@@@
@@@@@@@@@.............@@..........@@@.@@@@.............@...................@@@@@@@
@@@@@@@@..............@@........@@@...@@@@@.......................@..@.....@@@@@@@
@@@@@@@@@........@@...@@........@@@@@.@@@...@@.............@.@..@@@........@@@@@@@
@@@@@@@@@.@......@....@......@.@@@@@@@@@@.....@.........@@@@..........@.....@@@@@@
@@@@@@.@@@.@@...........@@.....@@@@@@@@@@.@@.......@....@@@@..........@.....@@@@@@
@@@@@@..........@........@.....@@@@@@...................@@@@.....@@@........@@@@@@
@@@@..........@@@........@.....@@@@@@.................@.@@@@@...............@@@@@@
@@@..@@@@....@@@@...............@@@....@................@@@@@@..............@@@@@@
@@@@.@@@@@..@@@@................@.......................@@@........@.......@@@@@@@
@@@@..@@@@..@@@@@........................................@@...............@@@@@@@@
@@@@@@@@@@@@@@@@@..............@@@@......@...............@@@............@@@@@@@@@@
@@@@@@@@@@@@@@@@@...........@...........@@.....@.....@....@@........@@@.@@@@@@@@@@
@@@@@@@@@@@@@@@@@.................................@@@@@........@......@@@..@@@@@..
@@@@@@@@@@@@@@@@@@............@........................@.......@@@.@........@.@@..
@@@@@@@@@@@.@@@@...................@@...........@@...........@@@@@..@.............
@@@@@@@..@@.@.........@......@.....@.........................@@@.@.............@@@
@@@@@@@..@@.@.........@..@.........@....@..........@..@...@..@@@...@............@@
@@@@@@@.......@........................@@@@......@@.........@@@@@@@@@@@...@....@@@
@@@@@@@.................@@@...........@@@.@.....@@@@@@...@@@@@@@@@@@@@@@@@@@...@@@
@@@@@@@.@..@..........@@...@.........@..@.@.....@@@@@@...@@@@@@@@@@@@@@@@@@@..@@@@
@@@@@@@....@...............@..@...........@..@@.@@@@@@...@@@@@@@@@@@@@@@@@@@@@@@@@
@@@@@@@@.....@..........@..................@@@@@@@@@@@....@@@@@@@@@@@@@@@@@@@@@@@@
@@@@@@@@.....@.................@.......@@..@.@@@@@@@@.....@@@@@@@@@@@@@@@@@@@@@@@@
@@@@@@@.....@@@@@....@.................@@@...@@@@@@@@@@@..@@@@@@@@@@@@@@@@@@@@@@@@
@@@@@@@....@@@@@@@@........@.......@@..@@@..@@@@@@@@@@@@.@@@@@@@@@@@@@@@@@@@@@@@@@
8
27 23 0
12 22 0
72 57 0
27 9 0
67 2 0
64 50 0
62 11 0
53 73 0

67 59 0
66 68 0
68 34 0
68 72 0
77 27 0
62 68 0
63 33 0
50 43 0
