width 82
height 82
@@@@@@@@@@@@@@@@@@@@@@@@@@@@@@@@@@@@@@@@@@@@@@@@@@@@@@.@@@@@@@..@@@@@@@@@@@@@@@@@@
@@@@@@@@@@@@@@@@@@@@@@@@@@@@@@@@@@@@@@@@@@@@@@@@@@@@@@.@@@@@.....@@@@@@@@@@@@@@@@@
@@@@@@@@@@@@@@@@@@@@@@@@@@@@@@@@@@@@@@@@@@@@@@@@@@@@@..@@@@@.....@@@@@@@@@@@@@@@@@
@@@@@@@@@@@@@@@@@@@@@@@@@@@@@@@@@@@@@@@@@@@@@@@@@@@@@..@@@......@@@@@@@@@@@@@@@@@@
@@@@@@@@@@@@@@@@@@@@@@@@@@@@@@@@@@@@@@@@@@@@@@@@@@@@@@.@@......@@@@@@@@@@@@@@@@@@@
@@@@@@@@@@@@@@@@@@@@@@@@@@@@@@@@@@@@@@@@@@@@@@@@@@@.......@@@@..@@@@@@@@.@@@@@@@@@
@@@..@@@@@@@@@@@@@@@@@@@@@@@@@@@@@@@@@@@@@@@@@@@@@@.......@@@@..@.@.@@@..@@.@@@@@@
@@....@@@@@@@@@@@@@@@@@@@@@@@@@@@@@@@@@@@@@@@@@@@@@@......@@@@......@.@..@@..@@@@@
.......@@@@@@@@@@@@@@@@@@@@@@@@@@@@@@@@@@@@@@@@@@@@...@@....@@........@...@..@@@@@
.......@@@@@@@@@@@@@@@@@@@@@@@@@@@@@@@@@@@@@@@@@@.....@@@@@........@........@@@@@@
.....@@@@@@@@@@@@@@@@@@@@@@@@@@@@@@@@@@@@@@@@@@@@....@@@@@............@@@@@@@@@@@@
@...@@@@@@@@@@@@@@@@@@@@@@@@@@@@@@@@@@@@@@@@@@@@@......@.........@...@@@@@@@@@@@@@
@...@@@@@@@@@@@@@@@@@@@@@@@@@@@@@@@@@@@@@@@@@@@@@@...@....@@.......@@@@@@@@@@@@@@@
...@@@@@@@@@@@@@@@@@@@@@@@@@@@@@@@@@@@@@@@@@@@@@@@@..@@@...........@@@@@@@@@@@@@@@
..@@@@@@@@@@@@@@@@@@@@@@@@@@@@@@@@@@@@@@@@@@@@@@@@@....@........@..@@@@@@@@@@@@@@@
...@@@@@@@@@@@@@@@@@@@@@@@@@@@@@@@@@@@@@@@@@@@@@@@@............@@...@@@@@@@@@@@@@@
....@@@@@@@@@@@@@@@@@@@@@@@@@@@@@@@@@@@@@@@@@@@@@@........@.........@@@@@@@@@@@@@@
....@@@@@@@@@@@@@@@@@@@@@@@@@@@@@@@@@@@@@@@@@@@@....................@@@@@@@@@@@@@@
....@@@@@@@@@@@@@@@@@@@@@@@@@@@@@@@@@@@@@@@@@@@@@................@.@@@@@@@@@@@@@@@
.......@@.@@@@@@@@@@@@@@@@@@@@@@@@@@@@@@@@@@@@@@@..................@@@@@@@@@@@@@@@
....@.....@@@.@@@@@@@@@@@@@@@@@@@@@@@@@@@@@@@@@..............@@....@@@@@@@@@@@@@@@
..........@@..@..@@@@@@@.@.@@@@@@@@@@@@@@@@@@@@@@..........@..@@.....@@@@@@@@@@@@@
........@.@@@.@..@@@@@@@...@@@@@@@@@@@@@@@@@@@@.@.....@..............@@@@@@@@@@@@@
.@@..............@@@@@@@@...@@@@@@@@@@@@@@@@@@@...............@..@...@@@@@@@@@@@@@
@@.......@.......@@@@@@@@...@@@@@@@@@@@@@@@@@@@......@@.@...@@@@@@.....@@@@@@@@@@@
@@.......@.......@@@@@@@@@@...@@@@@@@@@@....@@@................@@......@@@@@@@@@@@
@@.............@@@@@@@@@@@....@@@@@@@......@@@.....................@....@@@@@@@@@@
@@.............@@.@@@@@@@.....@..............@.................@...@.....@@@@@@@@@
@@@@.................@........@.........................@...................@@@@@@
@@@@..............@..@......@@@.........................@.....................@@@@
@@@..................@.............@......@.........@..............@...@......@@@@
@@@...........@..@@.................@@@...@@@@.......................@@.....@.@.@@
@@@@......................................@@@@@@.........@........@..@@@@@......@@
@@@@..............@.....@.@@...@..@@......@@@@............@@@.....@..@@@@@......@@
@@@@..............@.......................@@@@...@.....@.......@.....@.....@@...@@
@@@@@@................@@..........@..............@.@@@.......@..@....@.....@@@@@@@
@@@@@@.@............@...@.........@.......@@@........@@........@@@..@@@....@@@@@@@
@@@@@@...........................@@@.......@@...@@..@..........@@@.........@@@@@@@
@@@@..............................@.........@@...................@......@..@@@@@@@
@@@@@...@...........................@.....@@@@...............@...@.........@@@@@@@
@@@@@@......................@.............@@@@......@@@..@.@.....@..........@@@@@@
@@@@.............@......@@..@..........@@@@@@..@@@....@..@@@@...............@@@@@@
@......@..@....@@@.............@@@@@...@@@@@..@@@@...@@@..@@@.@@...........@@.@@@@
..........@..@....@...@@...@..@@@.@....@@@@@@...@@@..@@...@....@..............@@@@
.....@@.............@@@...@@@.........@@....@....@...@@........@.@............@@@@
.....@@...@.@.......@@......@@.......................@@.@........@@.........@.@@@@
............@@......@..............@@@...................@..................@.@@@@
..........@.........@@..............@@.@.........@....................@@....@@@@@@
..........@.........@@..............@@@@.....@........................@@@.@@@@@@@@
@.@...@@.......@..@@@.................@@.@.@..@.....@.................@@@.@@@@@@@@
@@@...@@@................@.................@.......@......@.....@@@...@@.....@@@@@
..........@................................@............@@@..@..@@.......@...@@@@@
..............@...........@.........................@...@@@.....@@...........@@@@@
....................@@.................................@@@@@@..@@@.........@@@@@@@
@@@................@@@@......@...........................@..@..@@@..@......@@@@@@@
@@@@@@.....@.......@@@@....@.@..........@..............@....@...............@@@@@@
@@@@@@@....@.....@@@@@@@.....@..............@..@@@..........@@..............@@@@@@
@@@@@...........@@@@@@@.............@.@@............@.....@.@...............@@@@@@
@@@@@...........@@@@@@@................................@........@...@..........@@@
@@@@@..........@@@@@@@..@.............@...................@@....@.@.@@...@@@...@@@
@@@@@@............@@@...@............@@.................@...........@.........@@@@
@@.@@@.......@@....@....@@@@.......@@@.........@......................@@@.....@@@@
....@........@@.@@.@@@@..@@......@@@@@@@@.@@..@@....@@...............@@@.....@@@@@
.............@@@@@..@@...@@......@@@@@@@@.@@.....@@@@@............@@...@@..@@@@@@@
.@...........@@@@@@@@@@.....@...@@@@@@@@......@..@@@@..............@@@@@@@@@@@@@@@
...@..@@@....@@@@@@@@@@@@...@@.....@@@@@......@..@@@...............@@@@@@@@@@@@@@@
............@..@@@@@@@@@@...@@@@....@@@@@...@.....................@@@@@@@@@@@@@@@@
.....@......@@...@@@@@........@@@.....@....@@@...........@@.......@@@@@@@@@@@@@@@@
..@.@...@@.@@@@...@...........@@@@.....@....@@@..........@........@@@@@@@@@@@@@@@@
.........@...@@........@..............@@@...@@@@..................@@@@@@@@@@@@@@@@
@@@......@@..@.............@..........@.....@@...............@....@@@@@@@@@@@@@@@@
@@@.............................@@@.@.......@...............@....@@@@@@@@@@@@@@@@@
@@@........@.@@........@..........@@@@.....@@....@@....@.@@.......@.@@@@@@@@@@@@@@
@@@@.........@@...................@@@@......@@....@....@.............@@@@@@@@@@@@@
@@@@@@@....@@@@@@@@@@@@.@..........@@@.................@.............@@@@@@@@@@@@@
@@@@@@@....@@@@@@@@@@@@@@@.........@@@................@....@@........@@@@@@@@@@@@@
@@@@@@@....@@@@@@@@@@@@@@@.....@.@....@...@@......@..........@........@@@@@@@@@@@@
@@@@@@@....@@@@@@@@@@@@@@@..@@@@@@........@.......@.@.................@@@@@@@@@@@@
@@@@@@@@...@@@@@@@@@@@@@@@@@@@@@@@@@@@...........@...........@........@@@@@@@@@@@@
@@@@@@@@@..@@@@@@@@@@@@@@@@@@@@@@@@@@@.......@.....@@..@.....@@@@@@..@@@@@@@@@@@@@
@@@@@@@@@@@@@@@@@@@@@@@@@@@@@@@@@@@@@@@.............@.......@@.@@@@@@@@@@@@@@@@@@@
@@@@@@@@@@@@@@@@@@@@@@@@@@@@@@@@@@@@@@@@.......................@@@@@@@@@@@@@@@@@@@
8
58 78 0
12 42 0
6 22 0
2 45 0
62 7 0
31 49 0
24 55 0
56 26 0

29 70 0
63 7 0
66 76 0
76 52 0
67 28 0
31 51 0
67 59 0
0 69 0
