width 85
height 85
@@@@@@@@@@@@@@@@@@@@@@@@@@@@@@@@@@@@@@@@@@@@@@@@@@@@@@@@@@@@@@@@@@@@@@@@@@@@@@@@@@@@@
@@@@@@@@@@@@@@@@@@@@@@@@@@@@@@@@@@@@@@@@@@@@@@@@@@@@@@@@@@@@@@@@@@@@@@@@@@@@@@@@@@@@@
@@@@@@@@@@@@@@@@@@@@@@@@@@@@@@@@@@@@@@@@@@@@@@@@@@@@@@@@@@@@@@@@@@@@@@@@@@@@@@@@@@@@@
@@@@@@@@@@@@@@@@@@@@@@@@@@@@@@@@@@@@@@@@@@@@@@@@@@@@@@@@@@@@@@@@@@@@@@@@@@@@@@@@@@@@@
@@@@@@@@@@@@@@@@@@@@@@@@@@@@@@@@@@@@@@@@@@@@@@@@@@@@@@@@@@@@@@@@@@@@@@@@@@@@@@@@@@@@@
@@@@@@@@@@@@@@@@@@@@@@@@@@@@@@@@@@@@@@@@@@@@@@@@@@@@@@@@@@@@@@@@@@@@@@@@@@@@@@@@@@@@@
@@@@@@@@@@@@..@@@@@@@@@@@@@@@@@@@@@@@@@@@@@@@@@@@@@@@@@@@@@@@@@@@@@@@@....@@@@@@@@@@@
@@@@@@@@@@@@..@@@@@@@@@@@@@@@@@@@@@@@@@@@@@@@@@@@@@@@@@@@@@@@@@@@@@@.@....@@@@@@@@@@@
@@@@@@@@@@@@..@@@@@@@@@@@@@@@@@@@@@@@@@@@@@@@@@@@@@@@@@@@@@@@@@@@@@@........@@@@@@@@@
@@@@@@........@@@@@@@@@@@@@@@@@@@@@@@@@@@@@@@@@@@@@@@....@@@@@@@@@@..........@@@@@@@@
@@@@@@@.........@@@@@@@@@@@@@@.@@@@@@@@@@@@@@@@@@@@@@........@@@@@@....@......@@@@.@@
@@@@@@@........@@@@@@@@@@@@@@..@@@@@@@@@@@@@@@@@@@@@@@.......@@@@.@................@@
@@@@@...@.....@@@@@@@@@@@@@@@..@@@@@@@@@@@@@@@@@@@@@@@........@.................@...@
@@@@@..........@@@@@@@@@@@@@@..@@@@@@@@@@@@@@@@@@.@@@@.......@......................@
@@@@@...........@@@@@@....@.@..@@@@@@@@@@@@@@@@@@..................................@@
@@@@@..........@@@@@@@.......@.@@@@@@@@@@@@@@@@@@@.@...............................@@
@@@@@.....@....@@@@@@@.........@@@@@@@@@@@@@@@@@@@...........@.............@......@@@
@@@@@@.............@@@.........@@@@@@@@@@@@@@@@@@@......@...@@......@...@..@......@@@
@@@@@@@........................@@@@@@@@@@@@@@@@@@@...@..@@...@.........@...@.....@@@@
@@@@@@@........................@@@@@@@@@@@@@@@@@@@@......@@............@.........@@@@
@@@@@@@..@@@...................@@.@@@@@@@@@@@@@@@@@.......................@....@@@@@@
@@@@@@@..............@.........@..@@@@@@@@@@@@@@@@@...................@........@@@@@@
@@@@@@...............@@...........@@@@@@@@@@@@@@@@@@@........@@.....@.......@..@@@@@@
@@@@@................@@............@@@@@@@@@@@@..@@@@......................@.@@@@@@@@
@@@@@@.............@.@@......@.@...@@@@@@@@@@@@..@@@..@...............@@@@.@.....@@@@
@@@@.@......@@.......@@@..........@@@@@@@@@@@@@..@....@..@..@.........@@@@@......@@@@
@@@@..................@@.........@@@@@@@@@@@@.........@@.@..@@.@@...@@@@@@@@......@@@
@@@@.................@@@.....@@.@@@@@@@@@@@@@.........@@@@.....@@.@@@@@@@@@@@@@...@@@
@@@@@................@@@.....@@@@@@@@@@@@@@@@..@..@..@@@........@@@@@@@@@@@@@@@...@@@
@@@@@..................@........@@@@@@@@@@@@.@.@@@@@@@...@......@@@@@@@@@@@@@@@.....@
@@@@@@.........@................@@@@@@@@@@.....@@.@@@...........@.@..@@@@@@@@@@@.....
@@@@@@...............@@..........@@@@@@@@@........@@@@@.....@@....@..@@@@@.@@@@@.....
@@@@@@@@@@.....@.....@@@.........@@@@@@@@@@..@.....@@@@........@.................@...
@@@@@@@@@@@.............@.....@@.@..@@................................@......@.......
@@@@@@@@@@@.@@......................@@.@.............@.......................@.......
@@@@@@@@@@...@.......................@.@@@@..........................................
@@@@@@@@@@@@.@@.....@.............@.....@@@...........@.................@....@.......
@@@@@@@@@@@@.@....@.@..............@..........................@.........@....@.......
@@@@@@@@@@@......@@......@.@........@@..................@.....@@@...........@@.......
@@@@@@@@@@........@......@@@@@........@.....@.............@...@@@..................@@
@@@@@@@@@@........@@@....@@@@@.............@@........@@.......@@@..@.....@......@@...
@@@@@@@@@@........@@@.....@@@@@.@..@.........@......@@@.......@...............@......
@@@@@@@@@.........@@........@@.......@......@@@.......@....@.........................
@@@@@@@@@.........@....@@@@.................@@@..........@...............@@..........
@@@@@@@@........@.......@@@...................@...@......................@@.....@@...
@@@@@@......@...........@@@.............................................@@@......@.@.
@@@@@@........@...........@@@.....@..........@@......................@.@@@@@@...@..@@
@@@@@@........@@.......@..@@@@...@@..@@...@...@..................@@....@@@@@@@@....@@
@@@@@@@......@..@@...........@@@@@@.........@@..@..............@@@@@@@@@@@@@@@@....@@
@@@@@@@@@@..@...@@............@............@@.......@.........@@@@@@@@@@@@@@@@@..@@@@
@@@@@@@@@@@.@...@@...@...@..........@....@@@........@@.......@@@@@@@@@@@@@@@@@@@@@@@@
@@@@@@@@@.@...@@@@@@..@.............@......@@@@@@@@@@........@@@@@@@@@@@@@@@@@@@@@@@@
@@@@@@............@@.......@........@@.....@@@...@@@..@.....@@@@@@@@@@@.@@@@@@@@@@@@@
@@@@@......@@..............@.........@@@@......@@@@@........@@@@@@@@@@....@@@@.@@@@@@
@@@@@.................@.................................@@@@@@@@@@@@@....@@@...@@@@@@
@@@@@..........................@............@...........@@@@@@@..@@......@@@@....@@@@
@@@@@.....................@....@@....@@.............@...@@@@@@@...........@@......@@@
@@@@@.....................@.........@@@.............@@@@@@@@@@@...................@@@
@@@@......@@@.............@...............................@..............@.........@.
@@@@.......@@.............@@...............@@.@...........................@..........
@@@...@.........@.@...@@@.@@@@....@.....@@@@@@@..@@............@............@.....@@@
@@@...@................@@@@@@.....@@@@...@@@@@@....................................@@
@@@.......@...@.......@@@@@@@@@...@@@@...@@@@@....@.................................@
@@.......@....@@...@@@@@@@@@@@@@@@@@@@@@@@@@@.............................@@...@....@
@@...........@@@....@@@@@@@@@@@@@@@@@@@@@@@@@@@........@@....@..@@..................@
@@@@@@...............@@@@@@@@@@@@@@@@@@@@@@@@@@@.....@@@@....@@......................
@@@@@................@@@@@@@@@@@@@@@@@@@@@@@@@@@.....@@@@@..................@@@@@....
@@@@@...............@@@@@@@@@@@@@@@@@@@@@@@@@@@@@.@@@@@@@@.@@...............@@@......
@@@@@...............@@@@@@@@@@@@@@@@@@@@@@@@@@@@@..@@@@@@@@@@.........@.........@....
@@@@@@...@.........@@@@@@@@@@@@@@@@@@@@@@@@@@@.....@.@@@...........@.................
@@@@@@@@@@@........@@@@@@@@@@@@@@@@@@@@@@@@@.........................@...............
@@@@@@@@@@@@.......@@@@@@@@@@@@@@@@@@@@@@@@@@...................@@.@.......@.........
@@@@@@@@@@@@@@.@.....@@@@@@@@@@@@@@@@@@@@@@@@...........@......@@@@..................
@@@@@@@@@@@@.........@@@@@@@@@@@@@@@@@@@@@@@..................@......................
@@@@@@@@@@@..........@@@@@@@@@@@@@@@@@@@@@...@@..........@..@............@........@..
@@@@@@@@@@@@.........@@@@@@@@@@@@@@@@@@@@@....@......@..................@..@@.....@..
@@@@@@@@@@@@..........@@@@@@@@@@@@@@@@@@@@@.@.....................................@@.
@@@@@@@@@@@@@.........@@@@@@@@@@@@@@@@@@@@@@@..@..@@...@..@@......................@@@
@@@@@@@@@@@@@@@....@@@@@@@@@@@@@@@@@@@@@@@@@@.....@........@@@@.......@@.....@.....@@
@@@@@@@@@@@@@@@@...@@@@@@@@@@@@@@@@@@@@@@@@@@...@@..........@@@.....................@
@@@@@@@@@@@@@@@@@@@@@@@@@@@@@@@@@@@@@@@@@@@@@...@@................@....@............@
@@@@@@@@@@@@@@@@@@@@@@@@@@@@@@@@@@@@@@@@@@@..........................@...@...........
@@@@@@@@@@@@@@@@@@@@@@@@@@@@@@@@@@@@@@@@@...........@..............@.......@......@@@
@@@@@@@@@@@@@@@@@@@@@@@@@@@@@@@@@@@@@@@@@@......@.................@@..............@@@
@@@@@@@@@@@@@@@@@@@@@@@@@@@@@@@@@@@@@@@@@@....@.......@@...@@..@@@@@@@...........@@@@
8
59 83 0
53 15 0
48 34 0
47 62 0
61 69 0
45 78 0
48 52 0
67 43 0

54 79 0
12 41 0
57 53 0
75 68 0
77 84 0
53 62 0
32 53 0
80 42 0
