width 85
height 85
@@@@@@......@@@....@@.@@..............@@....@.@@...........@@............@......@@@@@
@@@@@.......@@@.....@....................@...........@......@.........@..@.........@@
@@@@@@@@@........@...........................................................@@@.@.@@
@@@@@@@@@@...........@@@.........@.......@........@....................@@...........@
@@@@@@@@@@...........@@@.......@@@@......@.@..@@...............@@......@@...........@
@@@@@@@@@@@@.........@@@.......@@@@............@..................@@.................
@@@@@@@@@@@@...@.....@@@.......@@@@@..............@.........@.....@..................
@@@@@@@@@@@@.................@..@............@....@....................@.............
@@@@@@@@@@@@............@..............................................@@............
@@@@@@@@@@@......................@.........@@@@.....@@.@.@@..................@.......
@@@@@@@@@@@.........@...@...@@.@@@@..@@@..@@@@..........@.@.@......................@.
@@@@@@@@@@@@...........@@..@@@@@@@@@.......@.@...@............@......@.@@@......@....
@@@@@@@@@@@@.......@....@@@@@@@@@@@@.......@.......@.@..@............@@@@......@@....
@@@@@@@@@@...............@@@@@@@@@@@.....@......@....................@.......@.....@@
@@@@@@@@@..................@@@@@@@@@..@@@..................@.......@................@
@@@@@@@@@@@@.@.............@@@@@@@@@@@@@@@.........................@..@.........@...@
@@@@@@@@@@@@.................@@@@@@..@@@@@......@.@@@.....@..........................
@@@@@@@@@@@@@.@..............@........@@.....@...@@@@@.......................@.......
@@@@@@@@@@@@.....@.@...................@.....@......@@@@...........@@........@.......
@@@@@@@@@@@......@@@..................................@@......@..@@@@........@@@....@
@@@@@@@@@@@......@@@.............................@@..............@@@@@@@@@@..@@@....@
@@@@@@@@@@@@@@@@@@.@.......@@....................@@@.......@.....@@@@@@@@@@...@@@....
@@@@@@@@@@@@@@@@.@........@......................@@@.............@@@@@@@@@@@..@......
@@@@@@@@@@@.........@...@@............@@..........@@.............@@@@@@@@@@....@@@...
@@@@@@@@@@@...@.........@.............@.................@.@@@@@@.@@@@@@@@@@....@@....
@@@@@@@@@......................@@.....@.......@.........@@@@@@@@@@@@@@@@@@@@@......@.
@@@@@@@@@@.......@...@......@@.@@@@.@.@.....@....@@@....@@@@@@@@@@@@@@@@@@@@@......@.
@@@@@@@@@@............@.....@..@@@@...@..................@@@@@@@@@@@@@@@@@@@@....@...
@@@@@@@@@@@@.................@.@..@.......@@..@.....@....@@@@@@@@@@@@@@@@@@@@@..@....
@@@@@@@@@@@@@@............................@............@@@@@@@@@@@@@@@@@@@@@@........
@@@@@@@@@@@@@@@............@@.........@................@@@@@@@@@@@@@@@@@@@@@@@@......
@@@@@@@@@@@@@@@.............@.....@@@@@........@........@@@@@@@@@@@@@@@@@@@@@......@.
@@@@@@@@@@@@@.@..................@@.....................@@@@@@@@@@@@@@@@@@@@@.....@@@
@@@@@@@@@@@@@........@@.............................@....@@@@@@@@@@@@@@@@@@@@.....@@@
@@@@@@@@@.......@@@..@@@............................@...@@@@@@@@@@@@@@@@@@@@......@@@
@@@@@@@@@......@@@@...@@.................@............@....@@@@@@@@@@@@@@@@@@........
@@@@@@@@@......@@@@@@@@@........@@......@@@@...............@@@@@@@@@@@@@@@@..........
@.@@@@@@@......@@@@@@@@@@@......@....@..@@@.............@@.....@@@@@@@@@@............
@.@@@@@@@@.....@@@@@@@@@@@.@....@@.@...@@@...@@.........@......@@@@@@@@@@.....@.@@...
.....@@@@@....@@@@@@@@@@@@.......@@@....@....@@............@.......@@@@@@....@.......
......@@.@.@..@@@@@@@@@@@@.......@@.......@....................@.....@@@@............
......@..@@...@@@@@..@@@@.....@..@@.......@.......@@..................@@.......@.....
@............@@@@@@...@@.........@@@@..@.@......@.@@..................@@.......@.....
@..............@@@@........@...@@......@@@.@..........................@@...........@.
@@.......@@.......@..........@@@@@.....@@@@@@@...@.................@..@@@..........@@
................@..............@@@@....@@@@@..............@@.......@..@@@....@.....@@
..@@@@@.............@.......@..............@..............@@.......................@@
.....@@...@.......@..@...........@.........@.....@..................................@
..........@.........@@...............@@@................@..@.........................
..........@........@...@............@@@@...@...............@.............@@@.........
.....@.@@@@@....@................@...@@....@......@@@.......@.......@....@@..........
.....@@@@@@@.@...................@@..@.@.........@........@@@@@..........@@.....@@...
.....@@@@@@@.....................................@@.......@@@.....@............@.....
..@@@@@@@@@@................@...........@........@@.......@@@....@@.....@......@.....
..@@@@@@@@@@@..........................@.....@..@@.........@@...............@.....@@@
.@@@@@@@@@@@@..@.....@...............@.......@.............@.....@..........@......@@
@@@@@@@@@@@@@........@......................@@........@....@@...................@@..@
@@@@@@@@@@@@@...@@@.@@.......................@........@@.........@...........@.@....@
@@@@@@@@@@@@@@.@@@@@@@@.............@...................@...............@@.....@...@@
@@@@@@@@....@@..@@@@@@@...............@@........................@...............@@..@
@@@@@@@@....@@@.@@@..@@...............@@.......@...@@.........@..................@...
@@@@@@@@@....@@......@@...............@@@..@@......@@@..@.......@.@..................
@@@@@@@@@....@............@........@..@@...@@.....@@@..........@@@@.@........@.......
@@@@@@@@.@@..@@.......................@@..........@@@.@.........@@@..........@....@@@
@@@@@@@@.....@..@......................@@....@.............@@....@@@........@@.@..@@@
@@@@@@@...............................@@@.................@@@@@@@@@..........@@@..@@@
@@@@@@@...@...........................@@@@@@.@.....@......@@@@@@@@@.........@@@@@@@@@
@@@@.................@................@@@..@.....@@@......@@@@@@@@@.@@......@@@@@@@@@
@@@@.@.@......@...............@@.........................@@@@@@@@@@.@@.@....@@@@@@@@@
@@@@@@@@.....@@..@@............@........................@@@@@@@@@@@@@@......@@@@@@@@@
@@@@@@@@...@@@@..@...........@@.........................@@@@@@@@@@@@@@.......@@@@@@@@
@@@@@.@...............@......@..........@....@@@@.......@@@@@@@@@@@@@@@@...@@@@@@@@@@
@@@@@.....................@@....@@............@....@@@@....@@@@@@@@@@@@@@@@@@@@@@@@@@
@@..............@@..@...........@@@@.........@@...@@@@@@...@@@@@@@@@@@@@@@@@@@@@@@@@@
@................@@@...@...........@@........@.....@@@@@@.@@@@@@@@@@@@@@@@@@@@@@@@@@@
@.............@@@@@@@.@...........@@@.......@.........@@@@@@@@@@@@@@@@@@@@@@@@@@@@@@@
@.............@@@@@@@@@.....@@@..@@@@@@.@@@@@@@@@@@@@@@@@@@@@@@@@@@@@@@@@@@@@@@@@@@@@
@.............@@@@@@@@@@....@@@@..@@@@@@@@@@@@@@@@@@@@@@@@@@@@@@@@@@@@@@@@@@@@@@@@@@@
@@............@@@@@@@@@@@..@@@@@...@@@@@@@@@@@@@@@@@@@@@@@@@@@@@@@@@@@@@@@@@@@@@@@@@@
@@.......@..@.@@@@@@@@@@@@@@@@@@...@@@@@@@@@@@@@@@@@@@@@@@@@@@@@@@@@@@@@@@@@@@@@@@@@@
@@..........@@@@@@@@@@@@@@@@@@@@...@@@@@@@@@@@@@@@@@@@@@@@@@@@@@@@@@@@@@@@@@@@@@@@@@@
@@..........@@@@@@@@@@@@@@@@@@@@@@@@@@@@@@@@@@@@@@@@@@@@@@@@@@@@@@@@@@@@@@@@@@@@@@@@@
............@@@@@@@@@@@@@@@@@@@@@@@@@@@@@@@@@@@@@@@@@@@@@@@@@@@@@@@@@@@@@@@@@@@@@@@@@
...@...@@@@@@@@@@@@@@@@@@@@@@@@@@@@@@@@@@@@@@@@@@@@@@@@@@@@@@@@@@@@@@@@@@@@@@@@@@@@@@
...@..@@@@@@@@@@@@@@@@@@@@@@@@@@@@@@@@@@@@@@@@@@@@@@@@@@@@@@@@@@@@@@@@@@@@@@@@@@@@@@@
8
12 35 0
27 0 0
67 53 0
49 41 0
53 46 0
27 61 0
36 3 0
41 28 0

15 33 0
41 69 0
63 16 0
16 69 0
2 82 0
78 7 0
37 39 0
2 83 0
