width 85
height 85
@@@@@@@@@@@@@@@@@@@@@@@@@@@@@@@@@@@@@@@@@@@@@@@@@@@@@@@@@@@@@@@@@@@@@@@@@@@@@@@@@@@@@
@@@@@@@@@@@@@@@@@@@@@@@@@@@@@@@@@@@@@@@@@@@@@@@@@@@@@@@@@@@@@@@@@@@@@@@@@@@@@@@@@@@@@
@@@@@@@@@@@@@@@@@@@@@@@@@@@@@@@@@@@@@@@@@@@@@@@@@@@@@@@@@@@@@@@@@@@@@@@@@@@@@@@@@@@@@
@@@@@@@@@@@@@@@@@@@@@@@@@@@@@@@@@@@@@@@@@@@@@@@@@@@@@@@@@@@@@@@@@@@@@@@@@@@@@@@@@@@@@
@@@@@@@@@@@@@@@@@@@@@@@@@@@@@@@@@@@@@@@@@@@@@@@@@@@@@@@@@@@@@@@@@@@@@@@@@@@@@@@@@@@@@
@@@@@@@@@@@@@@@@@@@@@..@@@@@@@@@@@@@@@@@@@@@@@@@@@@@@@@@@@@@@@@@@@@@@@@@@@@@@@@@@@@@@
@@@@@@@@@@@@@@@@@@@@@...@@@@.@@@@@@@@@@@@@@@@@@@@@@@@@@@@@@@@@@@@@@@@@@@@@@@@@@@@@@@@
@@@@@@@@@@@@@@@@@@@....@@@@....@@@@@@@@@@.@@@@@@@@@@@@@@@@@@@@@@@@@@@@@@@@@@@@@@@@@@@
@@@@@@@@@@@@@@.@@.....@@@@@...........@@...@.@.@@@@@@@@@@@@@@@@@@@@@@....@@@@@@@@@@..
@@@@@@@@@@@@@@..@.......@.....@.........@.......@@@..@@@@@@@@@@@@@@.....@@@@@@@@@@@..
@@@@@@@@@@@@@.............@@.....................@..@@@@@@@@@@@@@@.@....@@@@@@@@.@@..
@@@.....@@@@@....@...............@@......@@@@....@..@@@@@@@@@@@@.@......@@@@@@...@@..
@@.......@@@.@.........@@..............@..............@@@@@@@@@..........@@@@@.......
@@.....@..@@.......................@.........@...@....@@.@@..............@@@@@@@.....
@@@@.@@@.................@....@....@@....................@@.............@@@@@@@@.....
@@@@.@@@..@@.............@....@...........................@@..........@@@@@@@@@.....@
@@@@@@.........@.....@@..@....................@...........@@.@@@......@@@@@@@@@..@..@
@@@@@....@............@@......................@...........@@...........@@@@@@@@..@..@
@@@@@....@............@............@........@....@.......@@@............@@@@@@.......
@@@@@....@.@@@@@......................@.......@.@..........@...........@@@@@@@.......
@@@...@........................................@........................@@@@@@......@
@@@@@...............@.........................@..........................@@@@@@@....@
@@@@@@.............@....@@@.................................@@............@@@@@@....@
@@@@@@@@...............@@@@@...............@..@.......@@....@@...........@@@@@@@@@..@
@@@@@@@@.........@@....@@@@@@....@@@..........@.........................@@@@@@@@@@..@
@@@@@@@@@@@.....@@...@.@@@..@..@.@@...........................@@@......@@@@@@@@@@@..@
@@@@@@@@@@@..@......@@...................@@.........@..@.@@@..@@@...........@...@@...
@@@@@@@@@@@@...@....................@...............@@.......@@@..@.................@
@@@@@@@@@@@@..................@@....@...@@@@.................@@@........@@..........@
@@@@@@@@@@@..............@@@@@@@........@@@@@......@@@........@@........@@..........@
@@@@@@@@@@@.............@@@@@@@..........@@@@..@@...@.................@.........@@@@@
@@@@@@@@@@@@@....@....@@@@@@@@@..@.@...........@..............@.......@......@@@@@@@@
@@@@@@@@@@@@@.........@@@@@@@@@................@................@@...........@@@@@@@@
@@@@@@@@@@@@.@....@...@@@@@@@...............................@...@@.......@...@@@@@@@@
@@@@@@@@@@@@.......@@@@@@@@@@...@@....@.......@.................@...@@..@@.@.@@@@@@@@
@@@@@@@@@@@.......@@@@@@@@@@@............@@...@.................@..@@@@@@@@@@@@@@@@@@
@@@@@@@@@@@.....@@@@@@@@@@@@@.....@.............................@@@@@@@@@@@@@@@@@@@@@
@@@@@@@@@@@....@..@@@@.@@@@@@.....@..@..................@.......@@@@@@@@@@@@@@@@@@@@@
@@@@@@@@@@@@......@@.....@@@....@@@.@@...@....@.................@@@@@@@@@@@@@@@@@@@@@
@@@@@@@@@@@@.............@.@....@@.......@......................@@@@@@@@@@@@@@@@@@@@@
@@@@.@@.@@@@..........@@........@..........@................@...@@@@@@@@@@@@@@@@@@@@@
@@@@.@..@@.........@...@...@....@.........@@............@......@@@@@@@@@@@@@@@@@@@@@@
@@@@...@@@@@.......@...@..........@.....................@....@@@@@@@@@@@@@@@@@@@@@@@@
@@@@..@@@......@...@...@...@..............@......@.....@@@....@@.....@@@@@@@@@@@@@@@@
@@@@.......@...........@..@@@@...................@......@...@........@@@@@@@@@@@@@@@@
@@@...........@...........@@@@@..........@..............@..@@........@@@@@@@.@@@@@@@@
@@@..........@@@.........@@@@@@...@.............@.....................@@@@...@..@@@@@
@@@...@....@.@@@.........@@@@@@...............@.@..............................@@@@@@
@..........@..@..@....@..@@@@@........@@@....@@...............................@@@.@@@
@......@...@..@......@@....@..........@@@@...........@......@@......@..@.@@...@@@..@@
@@.........@.........@@@..@.........@................@@.....@@.@@......@..@@@.@....@@
@@@............@......@@.@@............@@...@..@..........@....@@..........@@@@..@...
@....@@............@@@@@@@..........@.@@@@@@@..................@...........@@@...@...
.....@@...@....@..@@@@@@@@........@@@@@@@@@@@@@............@@....@............@......
.....@.........@..@.@@@@@@.....@@..@@@@@@@@@@@....@........@@@@..@.......@@@@.@.@...@
......@.....@@@.....@@@@@@.....@@..@@@@@@@@@@@......@.....@@@@@..@........@@@.@......
............@@@.....@@@@@@...........@@@@@@@.@@@...@.....@@@@....@........@@@.@......
...........@@@@......@@@.............@@@@@..............@@@@.....@@.......@@@.@......
...........@@@@.......@@...@......@...@.................@@@@@.......@.@...@@..@..@..@
@........@..@@...@@........@....@@@......@............@@@@.....@@.....@@..@........@@
@................................@@....@.@......@.....@@@.................@..........
......................................@@@@....@.....@..@@........@.....@@@@..........
........................@.............@@@..............@@....@............@@@@@@.....
@..............@........@..............@@@..@@@@.@@..@@@@@.....@@.........@@@@@@.....
@@.......@.....@...@@..................@@@@@@@@@.@..@@@@@@.....@......@@....@@@...@@.
@@@...@@.@@@..@@....@....@@..............@@@@@.....@@@@@@@@@@@.........@.............
@@@.....@@@@@@@@@.@.@....@................@@@@.....@@@@@@@@@@@@@@.......@@@..........
@@@......@..@@@@..@.......@@@.@...............@......@@@@@@@@@@@@.........@.....@.@..
@@@@@..................@@..........@...................@@@@@@@@@@.................@@.
@@@@@@@@.........@......@........@@@@......@..........@@@@@@@.......................@
@@@@@@@@.............@..@.....@..@@@.................@...@@@.........................
@@@@@@.................@.........@@.................@@@..................@.@.........
@@@@@@..........@...@.....@.................@@...............@.......................
@@@@@@...................@@................@@....@@...@.....@@...@...................
@@@@@@..................@.................@.....@....................................
@@@@@@............@.@@@@@.......................@..........@@...............@........
@@@@@@@@...............@.......@@@@........................@..@...............@@....@
@@@@@@@@..@@...................@@@..........@@.....................@@........@@@....@
@@@@@@@@@.@@@.......@..........................................@@@.@@...@.....@@..@@@
@@@@@@@@@@@@@.......@.....@........@.......................................@@@@@..@@@
@@@@@@@@@@@@@.........@@@@@@@@....@....................@@@@@......@......@@@@@@@..@@@
@@@@@@@@@@@@@.@.......@@@@@.......@.....@@@@.....@@@@@@@@@@@...@@@@....@.@@@@@@@.@@@@
@@@@@@@@@@@@@.....@@@@@@@@@@...@@@@....@@@@@@@@..@@@@@@@@@@@@@@@@@@@@@@@@@@@@@@@@@@@@
@@@@@@@@@@@@@.......@@@@@@@...@@@@@@....@@@@@@@@.@@@@@@@@@@@@@@@@@@@@@@@@@@@@@@@@@@@@
@@@@@@@@@@@@@@......@@@@@@@.@@@@@@@@..@.@@@@@@@@@@@@@@@@@@@@@@@@@@@@@@@@@@@@@@@@@@@@@
8
51 39 0
55 42 0
54 56 0
33 27 0
45 16 0
51 40 0
28 16 0
82 55 0

31 52 0
9 55 0
16 12 0
32 8 0
61 15 0
17 74 0
63 75 0
8 13 0
