width 85
height 85
@@@@@@@...@@@......@@@@@@@@@@@@@@@@@.........@@@@@@@@@@@@@@@@@@@@@@@@@@@@@@@@@@@@@@@@
@@@@@@@@.......@....@@@@@@@@@@@@@@@@.........@@@@.@@@@@@@@@@@@@@@@@@@@@@@@@@@@@@@@@@@
@@@@@@@@...@@.......@@@@@@@@@@@@@@@...............@@@@@@@@@@@@@@@@@@@@@@@@@@@@@@@@@@@
@@@@@@@@@............@@@@@@@@@@@@@@......@...........@@@@@@@@@@@@@@@@@@@@@@@@@@@@@@@@
@@@@@..@.............@@@@@@@@@@@..@@.....@........@..@@@@@@@@@@@@@@@@@@@@@@@@@@@@@@@@
.@..............@@......@@@@@@@...@..@...@@............@@@@@@@@@@@@@@@@@@@@@@@@@@@@@@
.@..............@@......@@@@@@@......@@..@..........@@@@@@@@@@@@@@@@@@@@@@@@@@@@@@@@@
...@.............@......@@@@@..@@..................@@@@@@@@@@@@@@@@@@@@@@@@@@@@@@@@@@
@......................@@@@@...@..................@@..@@@@@@@@@@@@@@@@@@@@@@@@@@@@@@@
............@.........@@@@@@......................@...@@@@@@@@@@@@@@@@@@@@@@@@@@@@@@@
...............@......@@@@@@...........@....@@....@...@@@@@@@@@@@@@@@@@@@@@@@@@@@@@@@
@@...........@@@......@@@@@..................@........@@@@@@@@@@@@@@@@@@@@@@@@@@@@@@@
@@@@..@..@@...@@.....@@@@@@@@........@......@@...@@...@@@@@@@@@@@@@@@@@@@@@@@@@@@@@@@
@@@@.....@@...@@@....@@@@@@..........................@@@@@@@@@@@@@@@@@@@@@@@@@@@@@@@@
@@@@..........@@..@@......@@.........@@..............@@@@@@@@@@@@@@@@@@@@@@@@@@@@@@@@
@@@@....@...@.@@..........@@@........@...@@..........@@@@@@@@@@@@@@@@@@@@@@@@@@@@@@@@
@@.........@@@@@............@........@................@@@@@@@@@@@@@@@@@@@@@@@@@@@@@@@
@@@.@.......@@@@@.............................@........@@@@@@@@@@@@@@@@@@@@@@@@@@@@@@
@@@.@........@...........@@@..@.........@................@@@@@@@@@@@@@@@@@@@@@@@@@@@@
@@@......@.................@........@@............@.....@@@@@@@@@@@@@@@@@@@@@@@@@@@@@
....@...@@.......@.....@@..........@@@@........@@@@....@@@@@@@@@@@@@@@@@@@@@@@@@@@@@@
.......................@@..........@@@@@@....@.@@@@@@@..@@@@@@@@@@@@@@@@@@@@@@@@@@@@@
........@.@............@@.....@@.@@@@@@@@.......@@@@@@@@@@@@@@@@@@@@@@@@@@@@@@@@@@@@@
@@....@@@.@...........@....@@@......@@@@@........@@@@@@@@@@@@@@@@@@@@@@@@@@@@@@@@@@@@
......@@@@.................@@@...@..@@@@.........@@@@@@@@@@@@@@@@@@@@@@@@@@@@@@@@@@@@
.......@@@.................@@@@@......@@..........@@@@@@@@@@@@@@@@@@@@@@@@@@@@@@@@@@@
.@.....@@@...................@...................@@@@@@@@@@@@@@@@@@@@@@@@@@@@@@@@@@@@
@@@@@...@@@@.........@..@.@.....@@@...@@..@@.......@@@@@@@@@@@@@@@@@@@@@@@@@@@@@@@@@@
@@@@@@@..@@.........@.............@....@@........@..@@@@@@@@@@@@@@@@@@@@@@@@@@@@@@@@@
@@@@@@..............@...........@.@@.@@..........@.@@@@@@@@@@@@@@@@@@@@@@@@@@@@@@@@..
@@@@@........@..........@....@.......@@@@.......@@@@@@@@@@@@@@@@@@@@@..@@@@@@@@..@@.@
@@.@.................@@........................@@@@@@@@@@@@@@@@@@@@@@...@@@@@@@@....@
@@......................@@@....................@@@@@@@@@@@@@@@@@@@@@@......@@@@@.....
@.....@..@@............@..@@@....@@@..........@@@@@@@@@@@@@@@@@@@@@@.....@....@......
........@@.@.....@@@......@@@......@.........@@@@@@@@@@@@@@@@@@@@@@..................
.........@......@.@.......@..@@@...@........@@@@@@@@@@@@@@@@@@@@@@@..................
.....@.................................@@...@@@@@@@@@@@@@@@@@@@@@@..........@........
.....@........................................@@@@@@@@@@@@@@@@@@@....................
..@.......................@..@................@@@@@@@@@@@@...@@@@@......@.........@..
.......................@...@@....@...........@@@@@@@@@@@@@...@.@@@...@..@@.....@.....
..........@.@@.@.@@@@..@....@..................@@@@@@@@@........@@...@..@@....@@@....
....@@............@@.................@..........@@.@@@@@........@@@........@@@@@@....
.....@.........@.................@.................@@@@.....@...@@.......@....@@.....
..........@..............................................................@@.@..@.....
...........................@@@.@........@..................@.........@@..@@@@@@@@@...
..................@@.........@@.................@...@....................@@@@@@@@@@@@
..@......@.@............................@.........@.@....................@@@@@@@@@@@@
...........@...@..........@.............@@............@.@..@@.........@.@@@@@@@@@@@@@
..........@@@@........................@.@@.....@@.@.......@@@........@@@@@@@@@@@@@@@@
.....@@@@.@@@@@.......................@.....@.............@@@@@......@@@@@@@@@@@@@@@@
...@@@@@@@@@@@@...........@@................@..........@@@@@@@@@.@...@@@@@@@@@@@@@@@@
...@@@@@@@@@....................@...@........@.........@@@@@@@......@@@@@@@@@@@@@@@@@
...@@@@@@@@....................@@.@@@.............@....@@@..@@......@@@@@@@@@@@@@@@@@
...@@@@@@@@@...................@@.@@@@........@...@...@@@@@.......@@@@@@@@@@@@@@@@@@@
...@@@@@@......................@........@.@@..@........@@@@........@@@@@@@@@@@@@@@@@@
..@@@@@@.....@............@............@@@@@............@@..............@@@@@@.@@@@@@
..@@@@.....@.@.........................@...@.........@@...@@............@@@@@@..@@@@@
....@@@@@@.@@..........................@.....@.......@@.................@@@@@..@@@@@@
....@@@@.@.......@@@@@.....@.....@@..................@@...@.............@@@@.....@@@@
...@.............@@@@@.....@@.@....@........@@.........@@..@.........@...@@@......@@@
............@....@@@@@@.......@.......@.....@@@@@......@@@@@.............@..........@
....@@...............@@@......@..............@@@@.....@@@@@@@............@..........@
.....@...............@@@......................@@@....@@@@@@@@........@.@.@.........@@
.@........@@@@.....@.@@@...................@..@@@....@@@@@@@@............@@..........
.......................@.............................@@@@@@@@@@@@@@..................
................................@@....@............@@@@@@@@@@@@@@@@@.@@..............
....................@...........@@@..@@@............@@@@@@@@@@@@@@@@......@..........
....................@...@@@......@@@@@@....@........@@@@@@@@@@@@@@@.............@@...
...............@@......@@@@.......@@@@@.............@@@@@@@@@@@@@@@@@.@..............
@..................@..@...@...@....@@@.........@@....@@@@@@@@@@@@@@@@@@@.......@.....
....@..@@@............@.........@..@@.........................@@@@@@@@@.......@@.....
.@@@@@@@@@...............@@........@......@........@...........@@@@@@.......@@@@.....
@@@@@@@@@@@...@@@@@................@...@....@................@@@@@@@@.......@@@@.....
@@@@@@@@@@@.....@@@@...................@..@...@..@@@@@@@........@@@@@@......@@@@...@@
@@@@@@@@@@@@.@@@@@@@.................@.@.....@@@@@@@@@@..........@@@@@@.....@@@@....@
@@@@@@@@@@@@.@@@@@@@..........@......@......@@@@@@@@@@@..........@@@@.......@@@.....@
@@@@@@@@@@@@...@@@.@................@@@....@@@@@@@@@@.............@@@.......@@...@..@
@@@@@@@@@@@@...@@@..........@.@.....@@@@.....@@@@@@@..............@..............@@@@
@@@@@@@@@............@@.......@@.....@@...@.@@@@@@@@.@@............@@............@@@@
@@@@@@@@@@@.........@@........@@..............@@@@@@@@...........@....@...........@@@
@@@@@@@@@@@...................................@@@@@@@@@@@@@@..................@@@@@@@
@@@@@@@@@@@@.......@.........................@@@@@@@@@@@@@@@@@@...............@@@@@@@
@@@@@@@@@@@@............@..@......@..........@@@@@@@@@@@@@@@@@@@..@@..........@@@@@@@
@@@@@@@@@@...@@........@@@.@@@@..............@@@@@@@@@@@@@@@@@@@@@@..........@@@@@@@@
@@@@@@@@@...@@@@.....@@@@@@@@@@@....@..@....@@@@@@@@@@@@@@@@@@@@@@.......@@..@@@@@@@@
8
6 19 0
40 33 0
67 50 0
35 6 0
80 61 0
49 43 0
32 50 0
74 78 0

4 19 0
55 47 0
0 7 0
76 83 0
13 4 0
10 7 0
7 44 0
62 57 0
