width 85
height 85
...@.@@@@@@............@..@@@@@@@@@@@@@@@@@.@.......@.@.@@@...@@@@@@@@@@@@@@@@@@@@@@@
.....@@@@@@.@.............@@@@@@@@@@@@@@@@@.....................@@@@@@@@@@@@@@@@@@@@@
.....@@.......@..........@@@@@@@@@@@@@@@@@......................@@@@@@@@@@@@@@@@@@@@@
@.....@......@.........@.@@@@@@@@..@@@@..@@@@......@@.........@@@@@@@@@@@@@@@@@@@@@@@
@.......................@@@@@@@@@..@@@@..@@@.@.....@@.........@@@@@@@@@@@@@@@@@@@@@@@
.....@..............@@@.@@@@@@@@...........@.......@@.......@@@@@@@@@@@@@@@@@@@@@@@@@
.................@@.@@...@@.@@@......@@@@..................@@@@@@@@@@@@@@@@@@@@@@@@@@
.....@...@...........@...@@..........@@@@@@.............@...@@@@@@@@@@@@@@@@@@@@@@@@@
......@...................@...........@@@@@@@@....@........@@@@@@@@@@@@@@@@@@@@@@@@@@
..................@......@............@@@@@@..........@@..@@@@@@@@@@@@@@@@@@@@@@@@@@@
@@@@...........@.............@..........@@@............@..@@@@@@@@@@@@@@@@@@@@@@@@@@@
@@@@@..........@@@...........@....@.....................@@@@@@@@@@@@@@@@@@@@@@@@@@@@@
@@@@@@@@......@@@@..........@@@@....@.................@@@@@@@@@@@@@@@@@@@@@@@@@@@@@@@
@@@@@@@@......@@@@@......@....@.....@.............@@@@@@@@@@@@@@@@@@@@@@@@@@@@@@@@@@@
@@@@..........@@.@@@................@@...@@........@@@@@@@@@@@@@@@@@@@@@@@@@@@@@@@@@@
@@@@..........@..@@@@@@@......@@....@@..@@@.....@@@@@@@@@@@@@@@@@@@@@@@@@@@@@@@@@@@@@
@@@@.............@@@@@@.......@@....@@...@........@@@@@@@@@@@@@@@@@@@@@@@@@@@@@@@@@@@
@@@@....@........@@@@@@@............@.............@...@@@@@@@@@@@@@@@@@@@@@@@@@@@@@@@
@@..@....@.@......@@@@@................................@@@@@@@@@@@@@@@@@@@@@@@@@@@@@@
@@.................@@@@.........@@@@.....@.@......@...@@@@@@@@@@@@@@@@@@@@@@@@@@@@@@@
@.......@..........@@............@@@...................@@@@@@@@@@@@@@@@@@@@@@@@@@@@@@
.......@@.......@@..........@..@@@@@@@@@................@@@@@@@@@@@@@@@@@@@@@@@@@@@@@
@@.............@...@...@.......@@@@@@@@.@@...............@@@@@@@@@@@@@@@@@@@@@@@@@@@@
@..............@@..............@@...@@@..........@........@@@@@@@@@@@@@@@@@@@@@@@@@@@
@@.@@.................................@.................@@@@@@@@@@@@@@@@@@@@@@@@@@@@@
@.........................@.........@@@..@......@.......@@@@@@@@@@@@@@@@@@@@@@@@@@@@@
@.........................@.........@@@...............@@@@@@@@@@@@@@@@@@@@@@@@@@@@@@@
...........................@@........@@@@@@......@..@..@@@@@@@@@@@@@@@@@@@@@@@@@@@@@@
.....................@@@....@...........@@@.........@@@@@@@@@@@@@@@@@@@@@@@@@@@@@@@@@
@@..........@@@@@@...@@@@............@...@@..........@@@@@@@@@@@@@@@@@@@@.@@@@@@@@@@@
@..................@.@@@@............@.@.............@@@@@@@@@@@@@@@@@@@@.@@@@@@@@@@@
@@@@...@@@@..@........@@@@................@.........@@@@@@@@@@@@@@@@@@@....@@@@@@@@@@
@@@@...@@@@...........@@@@.................@.......@@@@@@@@@@@@@@@@@@@......@@@@@@@@@
@@@@...@..@.@@@....................................@@@@@@@@@@.......@@.....@@@@@@@@@@
@@@..........@@@@.....@......@@....................@@@@@@@@@@...............@@@@@@@@@
@@@..@@........@@..@...@....@@@..@@@@@@...@....@...@@@@@@@@@@..........@..........@@@
@@@@@@@.........@.@............@@@@@@@@........@...@@@@@@@..@......................@@
@@@@@@@.............@...........@@@@@@@@.....@@@@@@@@@@@@@.........................@@
@@@@@@@.....@...................@@@@@@@@..@.@@@@@@@@@@@@@@......................@..@@
@@@@@@@@@.@@@...............@....@@@@@........@@@@@@@@@@@@@................@.......@@
@@@@@@@@@@@@@.....@.........@.......@@........@@@@@@@@@......@.......@@@@@.@.......@@
@@...@@@@...@.......................@@.........@@@@@@@@......@@@..@@.@@@@@@@.@@@.....
@.....@@@......................@.....@..@@....@@@@@@@@@.....@@@@.@@@@@@@@@@@.......@.
......@@@..........@.................@@..@....@@@@@@@@.....@@@@@.@@@@@@@@@@@@........
@.....@...........@@@@@@.......................@@@@@@..@..@@@@@@@@@@@@@@@@@@@..@@@...
..................@@@@@@@@...................@@@@@@@@..@..@@@@@@@@@@@@@@@.......@@...
...................@@@@@@@@............@@....@@@@@@@@@@@....@@@@@@@@@@@@@........@@..
....................@@@@@@.............@@....@@@@@@@@@@@...@@@@@@@@@@@@@.........@@..
...................@@@@@@@..@..........@@.......@@@@@@.......@@@@@@@@.@@....@@....@@@
........@....@.....@@@@@@@.......@.....@@@@.....@@@@@..........@@@@@...@....@@....@@@
...................@@@@@@@..@@...........@@@.....@@@@.........@@@@@@@..@.........@@@@
..................@..@@@@@@@@@...........@@@@....@@@@..........@.@@...@@..........@@@
@..........@..............@@@@@@@@@.@....@@@@@....@.........@....@....@@......@...@@@
@................@........@@@@@@@@@.@.....@@...................@....@.@....@......@@@
@@...............@@.......@@@@@@@@..@........@...........@............@..@@@@@@.@@@@@
......................@....@@@@@.............@@@@...........@.............@@@@@@@@@@@
@..........................@@@.@............@..................@...........@@@@@@@@@@
@@@@...................@..@@@@.......@.................@............@@.....@@@@@@@@@@
@@@@@@.................@@.@@@@.........................@@@.........@.@@.....@@@@@@@@@
@@@@@@.............@...@@@@@@@.........@........@.....................@@@...@@@@@@@@@
@@@@@@@...@@....@..@...@@...@@....................@.....@@.@@@@.......@@@...@@@@@@@@@
@@@@@@@...@@@@@@@.................................@..........@@@@.....@@....@@@@@@@@@
@@@@@@@..@@@@@@@.....@........@..........@........@.......@@...@@............@@@@@@@@
@@@@@@@@@@@@@@@..........................@@@............@@@@...@@............@@@@@.@@
@@@@@@@@@@@@@@.....@...........@...@......@@.............@..........@@.......@@@@....
@.@@@.@@@@@@@@.....@@@@..@@................@@@.....................@@........@@@@...@
@......@@@@@@@......@@@..@@@@........................@..........@@.@@.......@@@...@@@
.......@@................@@@.....@@..@.........@@..@.@......@@@@@@@@@........@.......
........................@@......@@@.@@..@.......@@....@@..@@@@@@@@@@@@...............
......@................@@@.....@@@@.@@@.@..@....@@.......@@@@@@@@@@@@@....@@.........
@.....@..............@@@@@@.....@@@...@.......@...........@@@...@@@@@@....@@.........
@.....@@@............@@@@@@.....@....@@....................@@.............@..........
@@@.....@............@@@@@..........@@@@...@@..@......@....@...@..................@..
@@@..................@@@@@.........@@@@@@..@@.........@...........................@..
@@..................@@@@@..........@@@@....@@.........@@..@@.........@@.@...@.......@
@@...........................@.....@@@@@@..@@.............@@@@.......@......@.......@
@@@@...............................@@@@@@@@@........@....@@@@@..@@...@..............@
@@@@@@@@@....@........@.....@......@@@@@.@@@........@@...@@@@@..@@..........@.....@@.
@@@@@@@@.......@............@......@@@@@...........@@@...@@@.........@@.@@.@@........
@@@@@@@@@@........................@@@@@@@................@@@@.@@@.....@.@..@@........
@@@@@@@@@@................@@@@@..@@@@@@@@..@..@@...@......@@@@@................@@....
@@@@@@@@@@................@@@@@...@@@@@@@..@..@@...@@.....@@@@@................@@@...
@@@@@@@@@@....@@..........@@@@.....@@@@@@@@@@.@@@@@@@@....@@@@@@.............@.@@@@@@
@@@@@@@@@@@@..@@@....@@@@@@@@@@@@...@@@@@@@@@@@@@@@@@@...@@@@@@@@...@.......@@.@@@@@@
@@@@@@@@@@@...@@@....@@@@@@@@@@@@@.@@@@@@@@@@@@@@@@@@@....@@@@@@@@..@@......@@@@@@@@@
8
14 49 0
39 51 0
13 22 0
40 14 0
31 37 0
48 21 0
46 76 0
47 2 0

57 61 0
75 38 0
54 57 0
47 22 0
22 27 0
61 79 0
14 3 0
68 55 0
