width 25
height 25
@@...@@@.@@@...........@@
.........................
@.......@................
.......@.@............@.@
@@@..@....@.@.........@@@
@@@@@@.@..............@@@
@@@@@@................@@@
@@@@@.......@@@@@@....@@@
@@@@@@.........@.@@@@@@@@
@@@@@@............@@@@@@@
@@@@@@@.@........@@@@@@@@
@@@@@.....@........@@@@@@
@@@@@..........@....@@@@@
@@@@..............@@@@@@@
...................@@@@@@
....@..............@@..@.
@@.......................
@@......@.@......@.......
@..@@...@.@@@....@@@.....
@..................@.....
@@..............@.......@
@@@@.........@@@@@.......
@@@@@.......@@@@@@.......
@@@@@@@@@..@@@@@@@.......
@@@@@@@@@.@@@@@@@@@@..@@.
8
18 12 0
18 19 0
6 9 0
6 12 0
21 17 0
24 18 0
8 21 0
7 9 0

12 2 0
22 21 0
16 18 0
8 12 0
8 16 0
10 13 0
10 19 0
22 23 0
