width 25
height 25
.@@@@@@@@....@.....@@@...
...@@@@@@....@....@@@...@
....@@@....@......@@@..@.
..................@@@....
.......@.....@@@.........
......@..................
.....@...................
....@@...................
@@...@..@@...............
@@...@..@@.....@...@.....
........@@.........@.@..@
@..@....@@.........@....@
@........@........@@....@
...........@............@
..................@....@@
......@@@....@.......@@@@
.......................@@
.........@@@..@@.......@@
.......@...@..@........@@
..............@...@.@.@@@
..............@@@@@@@@@@@
.............@@@@@@@@@@@@
.............@@@@@@@@@@@@
.........@@....@@@@@@@@@@
@........@@@..@@@@@@@@@@@
8
9 1 0
1 16 0
10 22 0
4 5 0
1 10 0
24 8 0
18 4 0
24 0 0

21 16 0
1 10 0
8 18 0
0 21 0
24 4 0
17 19 0
20 7 0
21 5 0
