width 25
height 25
......@@@......@@@...@.@@
................@@...@...
...............@@........
....@....................
....@....................
@@@@@.................@@@
@@@@@......@@........@@@@
@@@@.......@.........@@@@
@@@...............@..@@@@
@@@@.............@@@@@@@@
@@@@.....@@@..@..@@@@@@@@
.............@@@@@@@@@@@@
..............@@@@@@@@@@@
...........@.@@@@@@@@@@@@
....@......@@@@@@@@@@@@@@
....@......@@@@@@@@@@@@@@
@..........@@@@@@@@@@@@@@
@@..........@@@@@@@@@@@@@
@@@@@.@.....@@@@@@@@@@@@@
@@@@........@@@@@@@@@@@@@
@@.@.......@@@@@@@@@@@@@@
@........@@@@@@@@@@@@@@@@
@@.....@.@@@@@@@@@@@@@@@@
@@.@@....@@@@@@@@@@@@@@@@
@@.......@@@@@@@@@@@@@@@@
8
2 20 0
5 6 0
17 7 0
10 9 0
24 1 0
8 1 0
5 17 0
6 7 0

19 8 0
19 0 0
6 23 0
7 23 0
0 13 0
4 19 0
20 0 0
20 4 0
