width 25
height 25
@......@@@@@@@@@@@@@@@@@@
@.........@.@@@@@@@@@@@@@
............@@@@@@@@@@@@@
......@........@@@@@@@@@@
..............@@@@@@@@@@@
..............@@@@@@@@@@@
...........@..@@@@@@@@@@@
@@@...........@@@@@@@@@@@
@@@...........@@@@@@@@@@@
@@..@..........@@@@@@@@@@
@@....@.........@@@@@@@@@
......@.........@@@@@@@@@
....@........@..@@..@@@@@
........@...........@@@@@
..@@@..@@...........@@@@@
.@@@@..........@@..@@@@@@
@@@@@@.........@@...@@@@@
@@@@@@............@@@@@@@
@@@@@@.............@@@@@@
@@@@@@.............@@@@@@
@@@@@@..........@@.@@..@.
@@@@@@@@.................
@@@@@@@@.....@........@..
@@@@@@@@....@............
@@@@@@@@.@.........@..@@@
8
9 21 0
12 3 0
7 16 0
6 17 0
9 20 0
10 22 0
17 24 0
14 10 0

11 2 0
14 24 0
15 19 0
7 18 0
3 7 0
4 5 0
9 2 0
11 23 0
