width 25
height 25
@@@@@@....@@.........@@@@
@@.........@.........@..@
@@.........@............@
@@@@........@..@@........
@@@@@.........@@@.......@
@@@@@.@......@...........
@@......................@
@@@@..@@@................
@@@@...@@................
@@@@@.@@@@............@..
@@@@@@@@@.....@......@@..
@@@@@..........@@@@@@@@..
@@@@@.....@@...@@@.......
@@@@@..@@.........@......
@@@@@.................@..
@@@@@....@..@............
@@@@@.....@...........@@@
@@@@@@@...@@@............
@@@@@.....@@@............
@@@....@@@@@@@.@.........
@@@@@@@@@@@@@@@@......@@@
@@@@@@@@@@@@@@@.........@
@@@@@@@@@@@@@@@.........@
@@@@@@@@@@@@@@@@@@@.....@
@@@@@@@@@@@@@@@@@@......@
8
2 6 0
17 19 0
15 8 0
14 6 0
13 7 0
22 12 0
12 2 0
11 3 0

15 13 0
20 15 0
18 19 0
7 14 0
17 6 0
15 9 0
15 16 0
20 21 0
