width 25
height 25
@@@@@@......@@.......@@@@
@@@@....@..@.........@@@@
@@@@.......@..........@@@
@@@.....@..@..........@..
@.@......................
.......@...............@@
....@.@@@..@...........@@
......@@@...............@
........................@
...@.......@............@
.....@..........@.......@
..................@.....@
....@...................@
..............@..........
.........@......@........
.....@.@.@.......@.......
.@.@...........@@@......@
.@..............@@....@@@
.@@......@...........@@@@
.........@...........@@@@
@@..................@@@@@
@@.........@@@.......@@@@
@@@@@@.....@@@.......@@@@
@@@@@@@......@..@....@@@@
@@@@@@@@........@...@@@@@
8
6 9 0
7 8 0
2 5 0
19 22 0
8 24 0
20 17 0
23 13 0
22 16 0

18 22 0
20 0 0
2 6 0
19 19 0
23 3 0
6 5 0
21 17 0
14 3 0
