width 25
height 25
@@@@@@@@@@@@@..@@@.....@@
@@@@@@@@@@@@...@@.......@
@@@@@@....@@...........@@
@@@@.................@.@@
@@@@@.......@............
@@@@@@.....@@.......@....
....@......@.............
.........................
...................@@@...
...............@.....@...
...............@.........
..@......................
....@@...........@.......
.@.@@@....@...@@@......@.
...@@@....@...@@@........
....@@@@@@@@....@@.......
@...@@@@@@@@@...@@.......
@..@@@@@@@@@@@@@@........
@@@@@@@@@@@@@@@@@@@.....@
@@@@@@@@@@@@@@@@@@@..@@.@
@@@@@@@@@@@@@@@@@@@...@.@
@@@@@@@@@@@@@@@@@.......@
@@@@@@@@@@@@@@@@@@@@@...@
@@@@@@@@@@@@@@@@@@@@@...@
@@@@@@@@@@@@@@@@@@@@@@@@@
8
20 14 0
22 3 0
11 9 0
22 15 0
13 2 0
6 9 0
2 14 0
16 11 0

19 6 0
2 14 0
8 7 0
11 13 0
19 20 0
14 16 0
22 17 0
4 3 0
