width 65
height 65
@@@@@@@@@@@@@@@@@@@@@@@@@@@@@@@@@@@@@@@@@@@@@@@@@@@@@@@@@@@@@@@@@
@@@@@@@@@@@@@@@@@@@@@@@@@@@@@@@@@@@@@@@@@@@@@@@@@@@@@@@@@@@@@@@@@
@@@@@@@@@@@@@@@@@@@@@@@@@@@@@@@@@@@@@@@@@@@@@@@@@@@@@@@@@@@@@@@@@
@@@@@@@@@@@@@@@@@@@@@@@@@@@@@@@@@@@@@@@@@@@@@@@@@@@@@@@@@@@@@@@@@
@@@@@@@@@@@@@@@@@@@@@@@@@@@@@@@@@@...@@@@@@@@@@@@@@@@@@@@@@@@@@@@
@@@@@@@@@@@@@@@@@@@@@@@@@@@@@@@@@@...@@@@@@@@@@@@@@@@@@@@@@@@@@@@
@@@@@@@@@@@@@@@@@@@@@@@@@@@@@@@@@......@@@@@@@@@@@@@@@@@@@@@@@@@@
@@@@@@@@@@@@@@@@@@@@@@@@@@@@@@@@.......@@@@....@@@@@@@@@@@@@@@@@@
@@@@@@@@@@@@@@@@@@@@@@@@@@@@@@@@@.................@@@@@..@@@@@@@@
@@@@@@@@@@@@@@@@@@@@@@@@@@@@@@..@.@..........@.......@@..@@@@@@@@
@@@@@@@@@@@@@@@@@@@@@@@@@@@@.@........................@.....@@@@@
@@@@@@@@@@@@@@@@@@@@@@@@@@@........@........................@@@@@
@@@@@@@@@@@@@@@@@@@@@@@@@@.......@........@@...@@...........@@@@@
@@@@..@@@@@@@@@@@@@@@@@@@@................@@.................@@@@
@@.....@@@@@@@@@@@@@@@@@@@@......@.....................@...@@@@@@
@@@..@@@@@@@@@@@@@@@@@@@@@..............@...@@.............@@@@@@
@@@@...@@@@....@@@@@@@.@@@............@....................@@@@@@
@@@....@@@@....@@@@@@...@@.......................@..........@@@@@
@@@.@...@@......@.@@....@....@....@.@.....@@@....@.........@@@@@@
.......@@.........@@....@....@............................@@@@@@@
........................................@.............@@...@@@@@@
...........................@....@......................@@@@@@@@@@
..............@.............@...........@..............@@@@@@@@@@
@.@@..@.@.....@@........@................................@@@@@@@@
..@@....................@.......@........................@@@@@@@@
...@@...................@.......@@..................@@@@@@@@@@@@@
...........@...@@.............@@.....................@@@@@@@@@@@@
@................@....@@@@@...................@....@@@@@@@@@@@@@@
............@..............................@.......@.@@@@@@@@@@@@
..............@......@...@...........................@@@@@@@@@@@@
..............@.........@@......@....................@@@@@@@@@@@@
..................................@..................@@@@@@@@@@@@
...........@@@.......@.........@..@.....@.........@...@@.@@@@@@@@
..................@......@.@@.........@@.............@.....@@@@@@
................................@.....@@............@@....@@@@@@@
........@@..@....@..............@.@@.........@@@@...@......@@@@@@
.................@..@@........@@......@......@@@@...@....@@@@@@@@
.......@............................@.........@.@@..........@@@@@
@..............@@@@.........@...........................@...@@@@@
@..............@@@@.......@.@.........@..@...@........@...@@@@@@@
@@...............@@.....................@@.......@........@@@@@@@
@@....@@.@@.@@@@@@@.......@..................@...@.....@.@@@@@@@@
.........@...@@@@@@...........@..........................@@@@@@@@
.............@@@@@@@..........@.....................@....@@@@@@@@
.....@.......@@@@@@@..........@@@........@@@.............@@@@@@@@
@...........@@@@@@.@....@.....@@...........@...@.........@@@@@@@@
.......@....@@@@@@......................................@@@@@@@@@
.......@@@@.@@@@@@@...................................@.@@@@@@@@@
..@..@@@@@@@@@@@@@@@..............@.......@................@@@@@@
.....@@@@@@@@@@@@@@@@@...................@@.@...@..........@@@@@@
...@@@@@@@@@@@@@@@@@@@....@@@..@@@@.........@...............@@@@@
..@@@@@@@@@@@@@@@@@@@@......@...@@@........................@@@@@@
@.@@@@@@@@@@@@@@@@@@@@@@@.@.....@@@.....@@.................@..@@@
@@@@@@@@@@@@@@@@@@@@@@@@@@@.....@@@@....@@..............@.....@@@
@@@@@@@@@@@@@@@@@@@@@@@@@.........@....@.@..........@...@......@@
@@@@@@@@@@@@@@@@@@@@@@...................@@@@..@...............@@
@@@@@@@@@@@@@@@@@@@@@.......@..........@.@@@..................@@@
@@@@@@@@@@@@@@@@@@@@@....................@................@@@@@@@
@@@@@@@@@@@@@@@@@@@@@@.......@........@..........@.........@@@@@@
@@@@@@@@@@@@@@@@@@@@.........@@...............@..@........@@@@@@@
@@@@@@@@@@@@@@@@@@@@.........@@@@@@...@...................@@@@@@@
@@@@@@@@@@@@@@@@@@..........@@@@@@.........................@@@@@@
@@@@@@@@@@@@@@@@@@..@.........@@@@@@.....@@................@@@@@@
@@@@@@@@@@@@@@@@@@.........@@@@@@@@@@@......@@@@@........@@@@@@@@
@@@@@@@@@@@@@@@@@@.........@@@@@@@@@@....@@@@@@@@..@...@..@@@@@@@
8
36 31 0
40 39 0
5 16 0
33 59 0
32 31 0
24 57 0
31 48 0
38 57 0

54 61 0
40 27 0
19 37 0
45 16 0
21 22 0
36 15 0
41 43 0
45 47 0
