width 65
height 65
@.....@.@@............@@..@@@.@@@@@@.@@.....@@@.................@
@@..........................@.@@@@...@@.......@@@..........@....@
@@..............................@@....@.@.......@.....@..@.@.....
...@..................@.@@@@.....@..........@@..@...@............
..........@.............@@@@................@@........@@.....@...
.........................@@@..............@@..........@@.........
@..........................@.....................................
..........@..@.......................@...........................
...@....@...@@@.......@............@@@..@@.......................
...@........@@@...........@.........@................@..@.......@
.........@..@@@........@@....@@.............@.....@............@@
..@...........@.....@........@...........@@.......@@........@..@@
..@@..........@.......@......@............@...@@..@@........@@.@@
..@@@.................@...............@...@@@@@@@@@@.............
@..@@......................@@...............@..@@@@..@@.....@....
...@@...................@..@@@..................@@@@.......@@....
...@@......................@@@@......@@...@....@@@@@.......@@....
@@@@@.........@............@.@@@.........@@@.@@@@@@@@......@@@@.@
@@@@@........................@@@@..........@..@@@@...........@@@@
@@@.......................@...@@@........@....@@@............@@@@
@@@@......@@....@..............@.........@@....@@............@@@@
@@@@......@@..@.@..@@@........@@...........@....@............@@@@
@@@@......@.....@..@@...@.....@@@@@...@....@..@..............@@@@
@@@@............@...@.........@@@@@...........@.....@@........@@@
@.@................@@@.......@@.......@......@@.....@@........@@@
@..............@..............@@@.@...@......@@..............@@@@
.......@...................@...@@............@@........@@....@@@@
.......@.......................@@...@....@........@@@...@.....@@@
...................@..@@............@.........@@....@@@.@.....@@@
...............@...@..@...@@@@.....@@..........@@..@@.@........@@
........@.....@......@....@.@@..@........@.....@....@............
..@....@@@@...@..........................@...................@...
@@@...@@@@....@..@.......................@.......................
@@...@@@@@..............................@.....@@.@@....@.........
@@@..@@@@@...........@...........@............@@.@@@........@....
@@@@@@.@...................@..................@@@@@..............
@@@@...@@.....@............@@..............@@.@@@@@..............
@...............@..@.......@@..@@@..........@@@@@@@@@....@@......
@................@@@..................@.....@@@@@@@@@....@@......
@..........@@@...@@@@@.......@........@....@@@@@@@@@@............
...........@@@...@@@@@......@...............@@@@@@@@@..@........@
....@..@@..@@@@..@@@@@..@.........@.........@@@@@@@@@......@.....
............@@@@@@@@@@@...........@..........@@@@@@@@@@.@.....@..
@...........@@@@@@@@@@@.........@@.........@@..@@@@@@@@@@........
@@...........@@@@@@@.....@......@@.............@@@@@@@@@@..@@....
@@@..........@@@@@@..........................@@@@@@@@@@@@...@....
@@@@@@@@@@@@@@@@@@@........................@@@@@@@@@@@@@@@@@@@.@.
@@@@@@@@@@@@@@@@@@.................@@@...@@@@@@@@@@@@@@@@@@@@@@@.
@@@@@@@@@@@@@@@@@@................@@@@..@@@@@@@@@@@@@@@@@@@@@@@@@
@@@@@@@@@@@@@@@@@@.........@......@.....@@@@@@@@@@@@@@@@@@@@@@@@@
@@@@@@@@@@@@@@@@@@........@@@@..@........@@@@@@@@@@@@@@@@@@@@@@@@
@@@@@@@@@@@@@@@@@@@......@@@@@...........@@@@@@@@@@@@@@@@@@@@@@@@
@@@@@@@@@@@@@@@@@@......@@@@.............@@@@@@@@@@@@@@@@@@@@@@@@
@@@@@@@@@@@@@@@@.....@@@@@................@@@@@@@@@@@@@@@@@@@@@@@
@@@@@@@@@@@@@@........@...................@@@@@@@@@@@@@@@@@@@@@@@
@@@@@@@@@@@@@@@..@....@..........@@@@.....@@@@@@@@@@@@@@@@@@@@@@@
@@@@@@@@@@@@@@@..@@......@....@...@.......@@@@@@.@@@@@@@@@@@@@@@@
@@@@@@@@@@@@@@...@@.........@.@@............@@@...@@@@@@@@@@@@@@@
@@@@@@@@@@@@@@@..@.@.......@@@@.....................@@@@@@@@@@@@@
@@@@@@@@@@@@@@@.@@........@@@@........@@.......@@@@@@@@@@@@@@@@@@
@@@@@@@@@@@@@@@@@@........@..........@@@.......@@@@@@@@@@@@@@@@@@
@@@@@@@@@@@@@@@@@@@...@...@......@@@@@@@........@@@@@@@@@@@@@@@@@
@@@@@@@@@@@@@@@@@@@@@@@..........@@@@@@@@.......@@@@@@@@@@@@@@@@@
@@@@@@@@@@@@@@@@@@@@@@@@@.........@@@@@@@@......@@.@@@@@@@@@@@@@@
@@@@@@@@@@@@@@@@@@@@@@@@@@@@@..@@.@@@@@@@@@.@@.....@@@@@@@@@@@@@@
8
9 27 0
62 6 0
12 18 0
62 46 0
57 16 0
55 0 0
55 38 0
30 30 0

59 39 0
33 38 0
37 53 0
36 10 0
55 36 0
40 30 0
64 6 0
35 13 0
