width 65
height 65
@@@@@@@@@@@@@@@@@@@@@@@......@@@@@@@@@@@@@@@@@@@@@@@@@@@@@@@@@@@@
@@@@@@@@@@@@@@@@@@@@@@@@@.....@@@@@@@@@@@@@@@@@@@@@@@@@@@@@@@@@@@
@@@@@@@@@@@@@@@@@@@@@@@@@.....@@@@@@@@@@@@@@@@@@@@@@@@@@@@@@@@@@@
@@@@@@@@@@@@@@@@@@@@@@@.......@@@@@@@@@@@@@@@@@@@@@@@@@@@@@@@@@@@
@@@@@@@@@@@@@@@@@@@@@@@@........@@@@@@@@@@@@@@@@@@@@@@@@@@@@@@@@@
@@@@@@@@@@@@@@@@@@@@@@@@@@.....@@@@@@@@@@@@@@@@@@@@@@@@@@@@@@@@@@
..@@@@@@@@@@@@@@@@@.@.@@@@.....@@@@@@@@@@@@@@@@@@@@@@@@@@@@@@@@@@
....@@@@@@@@@@@@@......@@..........@@@@@@@@@@@@@@@@@@@@@@@@@@@@@@
.........@@@@@@@@.....................@@@@@@@@@@@@@@@@@@@@@@@@@@@
..........@@@@@@@@....................@@@@@@@@@@@@@@@@@@@@@@@@@@@
..........@@@@@@@@@...................@@@@@@@@@@@@@@@@@@@@@@@@@@@
.........@@@@@@@@............@..@@...@@@@@@@@@@@@@@@@@@@@@@@@@@@@
.@.@........@@@@@...................@@@@@@@@@@@@@@@@@@@@@@@@@@@@@
...@......@@@@@@....................@@@@@@@@@@@@@@@@@@@@@@@@@@@@@
.........................@..........@@@@@@@@@@@@@@@@@@@@@@@@@@@@@
.............@...............@......@.@@@@@@@@@@@@@@@@@@@@@@@@@@@
....@@.....@@........@.................@@@@@@@@@@@@@@@@@@@@@@@@@@
....@@@............@.....@.............@@@@@@@@@@@@@@@@@@@@@@@@@@
@...@@@.................................@.@@@@@@@@@@@@@@@@@@@@@@@
..@.@@@.......@@....@.............@@.......@@@@@@@@@@@@@@@@@@@@@@
...............@@@@@..............@@@........@@@@@@@@@@@@@@@@@@@@
@.......@...@@..@@@@..............@@@.......@@@@@@@@@@@@@@@@@@@@@
@@@.....@@.....@@@@@..............@@@@......@@@@@@@@@@@@@@@@@@@@@
@@......@..@@....@.................@@@.....@@@@@@@@@@@@@@...@@@@@
@@@.....@.......@@..................@.@....@....@@@@@@@@@@..@@@@@
@@@@@..@.................@........................@@@@@@@...@@..@
@@@@@................@..@@........................@@@@@.@.......@
@@@@.......@.........@@@....................@.....@@@..........@@
@.................@..@...............@@@.....................@@@@
@....@..@.....@.@.......@..........@.........................@@@@
@@..@@........@.....@........@.......@@@.....@.@............@@@@@
@@@.@@@..@...................@.@.@...........................@@@@
@@@.@@................@.....@@...............................@@@@
@@@@@.....................@@@@@....................@@.......@@@@@
@@@@@@.....@........@.....@@.@..................@@.@@@@..@..@@@@@
@@@@@.....................@@...................@@@@@@@...@@@@@@@@
@@@@@@.@@@@......@@..............................@@@@@....@@@@@@@
@@@@@@@@@@@....@.@............@...................@@......@@@@@@@
@@@@@@@@@@.....@..................................@@@......@@@@@@
@@@@@@@@@..........@..............................@@@@.....@@@@@@
@@@@@@@@@....................@@@..................@@@@.@...@@@@@@
@@@@@@@@@@......@...@.@@...@@@@...@@......@@......@@@@@@.....@@@@
@@@@@@@@@@.............@....@.....@...............@@@@@..@...@@@@
@@@@@@@@@@@.....................@..................@@@......@@@@@
......@@@@@@@........................................@....@@@@@@@
.......@@@@@....................@...@.................@@.@@@@@@@@
........@@@@@@...............@........................@@@@@@@@@@@
.......@@@@@@................@.@......@@..............@@@@@@@@@@@
@@.....@@@@@@...@................@.............@@......@@@@@@@@@@
@@@......@.............@...............................@@@@@@@@@@
.............................................@@..@@....@@@@@@@@@@
...........@..@....................@@@...@..@.....@@@@@@@@@@@@@@@
...........................@......@@@................@@@@@@@@@@@@
............@....@...........@@.....@@.....@......@..@@@@@@@@@@@@
@@.@.......@@..........@.............@...@@@..@@@@@....@@@@@@@@@@
....................@....................@@..........@@@@@@@@@@@@
.............@...@............@..........@@@...@......@@@@@@@@@@@
............@@................@...............@.......@@@@@@@@@@@
...@...................@...@...........@.............@@@@@@@@@@@@
....@................@...@@@.................@@.....@@@@@@@@@@@@@
....@.@@..........@......@@@@.......@@@@@.@@.........@@@@@@@@@@@@
...........................@@......@@@@@@@...........@@@@@@@@@@@@
....................@.....@@@......@@@@@@@@...@......@@@@@@@@@@@@
.@..........@.....@@@.....@@@@....@@@@@@@@@@.........@@@@@@@@@@@@
.......@@.@@@.@@..@@@@....@@@@@@@@@@@@@@@@@@....@....@@@@@@@@@@@@
8
16 60 0
18 14 0
59 27 0
32 62 0
34 40 0
30 10 0
13 45 0
19 54 0

13 62 0
39 59 0
4 9 0
31 62 0
6 9 0
32 23 0
43 50 0
13 61 0
