width 65
height 65
.......@@@@@@@@@..@@@...@@.......@@..@@.......@..........@@@@@@@@
.........@@@@@.....@....@............@@@...@..@.........@@@@@@@@@
.....@...@@@@.....@@.................@@@@................@.@@@@@@
..........@@@.....@@@.@..............@@@......@.............@@@@@
@............@.......................@@@....@.........@@....@@@@@
@.....@......@@......................@@.............@.@@.........
@@..@@@@....@.....................@@..@.......@..................
@@..@@............................................@.......@@.....
@@.@@......................................@.....@@@...@.........
@......@@@@........@...................@...........@@..@....@....
@@@@.@@@@........@@@...........................@..@@@.@@....@....
@@@@.@@@@...@@...@@.@@.........................@@.@@...@@@.......
@@@....@.....@......@@.@.......................@@..@.............
@@@................@@@@@@@@................@...@@..@.............
@@.........@@.....@@@@@@@@@@.........@.@@......@@...@............
.......@..........@@@@@@@@...@..........@...@@@@@.......@@.......
..@...............@@@@@@@@..........@@......@@@@@....@..@@.......
..@@..............@@@@@@@@...........@........@.@...............@
..@@...........@@@@@@@@@@@..........@@@.......................@@@
.................@@@@@@@@.........@@@@@.@..............@.....@@@@
@................@@@@@@@.........@@@@@@@@@@@......@..........@@@@
.................@@@@@@@@........@@@@@@@@@@@..............@.@@@@@
.................@@@@@................@@@.................@@@@.@@
@.......@.........@@@@............@....@@.@..@..@@@@.............
..................@@@@............@...........@.@@@@.............
....@.......@@.......@......................@...@@@@@..@..@......
.@@.........@@@............@...............@@...@@@@@@.@@@@......
@@@....@....@@.............@@...@...........@....@@@@@@@@@@......
@@@.........@....@.@.........@................@@@@@@@@@@@@@@@@@@@
.@@...............@@@.@.....@@@................@@@@@@@@@@@@@@@@@@
..@.........@.........@...............@........@@@@@@@@@@@@@@@@@@
........................@....@@@@.............@@@@@@@@@@@@@@@@@@@
.....................................@@@@...@.@@@@@@@@@@@@@@@@@@@
........@.........@..........................@@@@@@@@@@@@@@@@@@@@
.........@@.....@.@....@..................@@@@@@@@@@@@@@@@@@@@@@@
.....@@@@@@@....@.@.......................@@@@@@@@@@@@@@@@@@@@@@@
..@.@@@@@@@...@@@@@.......@@@.......@......@@@@@@@@@@@@@@@@@@@@@@
...@@@........@@..@.......................@@@@@@@@@@@@@@@@@@@@@@@
....@@@...............@....@..@.........@.....@@@@@@@@@@@@@@@@@@@
@@..@@@@...@..@......@@@@@.@..@.............@@@@@@@@@@@@@@@@@@@@@
@@@.@@@@@...@........@@@@@@@.................@@@@@@@@@@@@@@@@@@@@
@@@@@@@@@...@@.....@@@@.@@.........@.........@@@@@@@@@@@@@@@@@@@@
@@@@@@@@.@..@.....@@@@@............@@.......@@@@@@@@@@@@@@@@@@@@@
@@@@@@@@...@@@@@..@@@@@.....@......@@.......@@@@@@@@@@@@@@@@@@@@@
@@@@@..........@@.@@@@.....@@@@.@@@@@@@.....@@@@@@@@@@@@@@@@@@@@@
@@@@@....@....@@@..@@@......@@@@@@...@@......@@@@@@@@@@@@@@@@@@@@
@@@@@.....@@..@@...@@.......@@@@@@...@@.....@@@@@@@@@@@@@@@@@@@@@
@@@@@@@@...@...@........@@@@@@@@@@...@......@@@@@@@@@@@@@@@@@@@@@
@@@@@@@@.@............@.@@@@@@@@@@.........@@@@@@@@@@@@@@@@@@@@@@
@@@@@@@........@........@@@@@@@@..........@@@@@@@@@@@@@@@@@@@@@@@
@@@@@@..................@@@@@@@..........@@@@@@@@@@@@@@@@@@@@@@@@
@@@........@......@.....@@@@@@@..........@@@@@@@@@@@@@@@@@@@@@@@@
@@@............@@........@@@@@@@........@@@@@@@@@@@@@@@@@@@@@@@@@
@@@......................@@@@@@@@.....@@@@@@@@@@@@@@@@@@@@@@@@@@@
@@.......@...............@@@@@@@.....@@@@@@@@@@@@@@@@@@@@@@@@@@@@
@@.......@@.....@..@@.....@@@@@@@..@@@@@@@@@@@@@@@@@@@@@@@@@@@@@@
@@........@.....@.........@@@@@@...@@@@@@@@@@@@@@@@@@@@@@@@@@@@@@
@...............@@@@..@...@@@@@@.@@@@@@@@@@@@@@@@@@@@@@@@@@@@@@@@
@....@...................@@@@@@@@@@@@@@@@@@@@@@@@@@@@@@@@@@@@@@@@
..@..@.................@@@@@@@@@@@@@@@@@@@@@@@@@@@@@@@@@@@@@@@@@@
......................@@@@@@@@@@@@@@@@@@@@@@@@@@@@@@@@@@@@@@@@@@@
.@.@..............@@@@@@@@@@@@@@@@@@@@@@@@@@@@@@@@@@@@@@@@@@@@@@@
......@@.....@...@@@@@@@@@@@@@@@@@@@@@@@@@@@@@@@@@@@@@@@@@@@@@@@@
.....@.@.........@.@@@@@@@@@@@@@@@@@@@@@@@@@@@@@@@@@@@@@@@@@@@@@@
.@...@.............@@@@@@@@@@@@@@@@@@@@@@@@@@@@@@@@@@@@@@@@@@@@@@
8
9 57 0
37 29 0
45 24 0
12 24 0
42 10 0
11 52 0
28 17 0
34 18 0

46 14 0
34 30 0
8 45 0
58 23 0
10 58 0
17 35 0
42 0 0
32 15 0
