width 65
height 65
@@@@@@@@@@@@@@@@@@@@@@@@@@@@@@@@@@@@@@@@@@@@@@@@@@@@@@@@@@@@@....
@@@@@@@@@@@@@@@@@@@@@@@@@@@@@@@@@@@@@@@@@@@@@@@@...@..@@@@@@..@..
@@@@@@@@@@@@@@@@@@@@@@@@@@@@@@@@@@@@@@@@@@@@@@@@......@@@@@@..@..
@@@@@@@@@@@@@@@@@@@@@@@@@@@@@@@@@@@@@@@@...@@@@..@....@@@@@@.....
@@@@@@@@@@@@@@@@@@@@@@@@@@@@@@@@@@@@@@@@...@..@@....@..@@@@@.....
@@@@@@@@@@@@@@@@@@@@@@@@@@@@@@@@@@@@@@@@...@..........@@@..@..@@.
@@@@@@@@@@@@@@@@@@@@@@@@@@@@@@@@@@@@@@............@........@..@@.
@@@@@@@@@@@@@@@@@@@@@@@@@@@@@@@@@@@@@......................@....@
@@@@@@@@@@@@@@@@@@@@@@@@@@@@@@@@@@@@@..@.....@@............@.@...
@@@@@@@@@@@@@@@@@@@@@@@@@@@@@@@@@@@@@.@@.@.......................
@@@@@@@@@@@@@@@@@@@@@@@@@@@@@@@@@@@@@.......................@..@.
@@@@@@@@@@@@@@@@@@@@@@@@@@@@@@@@@@@@@@.....@......@............@@
@@..@@@@@@@@@@@@@@@@@@@@@@@@@@@@@@@@......@.............@.....@@@
@@...@@@@@@@@@@@@@@@@@@@@@@@@@@@@@@@.....................@@@...@@
@@.....@@@@@@@@@@@@@@@@@@@@@@@@@@@@@@....................@@@...@@
..@..@@@@@@@@@@@@@@@@@@@@@@@@@@@@@@@.....@......@........@.....@@
@....@@@@@@@@@@@@@@@@@@@@@@@@@@@@@@............................@@
@..........@@@@@@@@@@@@@@@@@@@@@@@@@@.....@.......@@@..........@@
......@.....@@@@@@@@@@@@@@@@@@@@@@@@@@@...........@@.@..........@
@...@@@...@....@@@@@@@@@@@@@@@@@@@@@@...........@@@@.@...@..@...@
..........@....@@@@@@@@@@@@@@@@@@@@@@..........@@@@@.............
..@..............@@@@@@@@@@@@@@@@@@@@@........@@@@.@........@@@..
.....@@...@......@@@@@@@@@@@@@@@@@@@@@@.......@@@@..........@@@@.
................@@@@@@@@@@@@@@@@@@@@@@........@@......@@@....@@@@
...@....@.......@@@@@@@@@@@@@@@@@@@@@@........@@@.....@@......@@@
.@...............@@@@@...@@@@@@@@@@@@...@@........@.@@@@.......@.
.@............@@..@@@@....@@@@@@@@@@@...@@............@@.........
.............@.......@....@..@@@@.@...................@@.........
..............................@@......................@@.......@@
.............................@@@@@.........@@@.........@....@@..@
.......................@@@@@...@...@........@@@.......@@@.@@@@@.@
...@.@@.................@@@@@@......@@....................@@@@@@@
........................@@@@@@.........@..................@@@@@@@
......@@@.@..@..........@@.@@@........................@...@@@@@@@
......@............................@@......@..........@..@@@@@@@@
.....@@...............@........@@@@@..................@@...@@@@@@
.....................@.........@@@@@...................@...@@@@@@
@....@........................@@@@@....................@@...@@@@@
@@...................@@........@@@@....................@@....@@@@
@..@.............@..............@@@@...@@................@@@.@@@@
@.......@@...............@.......@.@.@@.......@@.................
......@@@@@@@.......@....@..@.........@..........................
......@@@@@@@@...@......................@@.........@@.....@...@..
@@@..@@@@@@@@@@@.@@@....................@@@.......@@@......@@....
@@...@@@@@@@@@@@@@@....................@..........@@..@@...@@@@..
@@..@@@@@@@@@@@@@@@.......@......................@@...@.@...@....
......@@@@@@@@@@@@...............@...............@@@..@........@.
......@@@@@@@@@@.@...............@@@.............................
......@@@@@@@@@@.........@..@@...@@@@@.................@@@.......
......@@@@@@@.....................@@@@......@..@.....@@@@@.....@@
.....@@@@@@@@...@@....@..............@@.....@@.......@@@@......@@
.....@@@@@@@@.......@.@.............@.......@@......@@@@@@..@@@@@
....@@@@@@@@@@.................@@@@................@@@@@@@.@@@@@@
...@@@@@@@@@@...................@.@................@@@@@@@.@@@@@@
...@@@@@@@@@@@...@......................@...........@@@@@@@@@@@@@
..@@@...@@@@@@@...@..@@@@...............@...........@@@@@@@@@@@@@
@@..@.....@@@@@......@.............@...............@@@@@@@@@@@@@@
@@....@....@@@@@@........................@@.........@@@@@@@@@@@@@
@@.........@.@@@@@...............@@@................@@@@@@@@@@@@@
@@.............@@@.........@.....@@.................@@@@@@@@@@@@@
@.......@.......@@@..........@..................@@@@@@@@@@@@@@@@@
.................@@..........@.....................@@@@@@@@@@@@@@
..........@@@...@......@................@........@@@@@@@@@@@@@@@@
..........@@@@@.....@..@................@@....@@@@@@@@@@@@@@@@@@@
@@...........@@....@@.........@@......@@@@.@..@@@@@@@@@@@@@@@@@@@
8
44 15 0
21 28 0
14 52 0
25 56 0
43 47 0
40 38 0
62 43 0
0 26 0

1 61 0
37 7 0
19 38 0
10 17 0
43 46 0
56 39 0
2 28 0
61 1 0
