width 64
height 64
@@@@@@@@@@@@@@@@@@@@@@@@@@@@@@@@@@@@@@@@@@@@.......@@@@@@@@@@@@@
@@@@@@@@@@@@@@@@@@@@@@@@@@@@@@@@@@@@@@@@@@.........@@@@@@@@@@@@@
@@@@@@@@@@@@@@@@@@@@@@@@@@@@@@@@@@@@@@...@.....@.....@@@@@@@@@@@
@@@@@@@@@@@@@@@@@@@@@@@@@@@@@@@@@@@@@@.........@@@.....@@@@@@@@@
@@@@@@@@@@@@@@@@@@@@@@@@@@@@@@@@@@@@@..........@@......@@@@@@@@@
@@@@@@@@@@@@@@@@@@@@@@@@@@@@@@@@@@@@@..................@@@@@@@@@
@@@@@@@@@@@@@@@@@@@@@@@@@@@@@@@@@@@@@..@...............@@@@@@@@@
@@@@@@@@@@@@@@@@@@@@@@@@@@@@@@@@@@@@@@@@@@@..@.........@@@@@@@@@
@@@@@@@@@@@@@@@@@@@@@@@@@@@@@@@@@@@@@@@@@@@............@@@@...@@
@@@@@@@@@@@@@@@@@@@@@@@@@@@@@@@@@@@@@@@@@..............@@.....@@
@@@@@@@@@@@@@@@@@@@@@@@@@@@@@@@@@@@@@@@..........@.....@@.......
..@@@@@@@@@@@@@@@@@@@@@@@@@@@@@@@@@@@@@.........................
@..@@@@@@@@@@@@@@@@@@@@@@@@@@@@@@@@@@@@..................@....@.
@..@@@@@@@@@@@@@@@@@@@@@@@@@@@@.@@@@.@@@...@......@@.@...@@...@.
@..@@@@@@@@@@@@@@@@@@@@@@@@@@@@.@@@..@@@..@@.......@.......@....
@@...@@@@@@@@@@@@@@@@@@@@@@@@@@.................................
@......@@@@@@@@@@@@@@@@@@@@@@@...................@@.............
........@@@@@@@@@@@@@@@@@@@@@@@....@....@@@.....@@@@......@.....
@.....@@@@@@@@@@@@@@@@@@@@@@@@@.@.....@@@@@@@@@@@@@...@@@.......
@.....@@@@@@@@@@@@@@@@@@@@@@@@@.......@@@@@@@@@@@..@.@@@@.......
@.....@@@@@@@@@@@@@@@@@@@@@@@@@......@@@@@@@@@@@@.....@@@.@@....
@@......@@@@@@@@@@@@@@@@@@@@@........@@@@@@@@@@@@..............@
@@........@@@@@@@@@@@@@@@@@@@........@@@@@@@@@@@@@@............@
@@........@@@@@@@@@@@@.@@@@@@...........@@@@@@@@@@@............@
@@........@@@@@@@@@@@@..@@@...............@@@@@@@@@............@
@@@........@@@@@@@@@@................@....@@@@@@@@@............@
...........@@@@@@@@@@...............@@@....@@@@@@@@@@@.........@
.................@@...@@@...........@@@@..@@@@@@@@@@@@@@........
................@@@@..@...@.......@@..@@....@@@@@@@@@@@.......@@
...............@@@@@.........@@...@@........@@@@@@@@@@@........@
.............@.@@@..........@@@@...............@@@@@@@@....@....
.....................@@@....@@@..............@..@@@@@@@...@@@...
.................................................@@@@@@...@@....
.@@.........................@....................@@@@@@.........
@@@......@@...................................@...@@@@@@.......@
.......@@@@@@..........@...........@..@...........@@@@@@......@@
....@...@@@@@.....................@....@..@......@@@@@.@.......@
....@...@@@@@............@@...@@..@@......@.....@@@@@@.........@
...@@....@@@@..@.........@@.........@......@.....@@@...........@
........@@@@@.@@@@@@@....@@.....@........@.......@@@@...........
........@.....@@@@@@@@@..@....@.@.@........@......@@@...........
.@@@.......@@@@@@@@@@@...........@@@@..@..@@......@@............
.@@@@.......@@@@@...................@......@...................@
@@@@...@........@@.....@@@@@....................................
@......................@@@@@.....................@@@...........@
...............@.......@@@@.@.......@@@..@@......@@@...@....@..@
......@........@........@@@..........@@@@@@.......@@....@....@.@
......@........@........@@@...........@@@......................@
............@@........@@@@@@@@.@......@@@@..@.......@......@@..@
....@@....@.@@.@......@@@@@@@@.......@@@@@..@@@.................
...@@............@....@@@@@@........@@@@@@..@.@@...............@
.............@...@@@@@@@@@@@...@....@@@@@@..............@.@@@@@@
@@@........@....@@@@@@@@@@@@@@@@....@@@@@@...@...@@.....@.@@@@@@
@@@@............@@@@@@@@@@@@@@@@..@..@@@@....@....@.....@@@@@@@@
@@@@..@........@@@@@@@@@@@@@@@@@..@...@@@@.@............@@@@@@@@
@@@@..@....@..@@@@@@@@@@@@@@@@@@....@....@.....@@....@...@@@@@@@
@@@@..@.@@...@@@@@@@@@@@@@@@@@@@...............@@...@...@@@@@@@@
@@@@@@@@@@@@@@@@@@@@@@@@@@@@@@@@.............@.@..@@@....@@@@@@@
@@@@@@@@@@@@@@@@@@@@@@@@@@@@@..@........@@.@.............@@@@@@@
@@@@@@@@@@@@@@@@@@@@@@@@@@@................@............@@@@@@@@
@@@@@@@@@@@@@@@@@@@@@@@@@@@@..........@@.@..............@@@@@@@@
@@@@@@@@@@@@@@@@@@@@@@@@@@@..........@@@@.............@.@@@@@@@@
@@@@@@@@@@@@@@@@@@@@@@@@@@@...........................@...@@@@@@
@@@@@@@@@@@@@@@@@@@@@@@@@@@.....@@@..............@..@@@@@...@@@@
8
26 40 0
38 63 0
27 32 0
35 36 0
57 17 0
22 45 0
2 23 0
48 1 0

34 33 0
59 38 0
6 43 0
38 30 0
54 15 0
45 9 0
61 15 0
49 54 0
