width 64
height 64
@@@@@@@@@@@@@@@@@@@@@@@@..@@@@@@@@@@@@@@@@@@@@@@@@@@@@@@@@@@@@@@
@@@@@@@@@@@@@@@@@@@@@.....@@@@@@@@@@@@@@@@@@@@@@@@@@@@@@@@@@@@@@
@@@@@@@@@@@@@.@@@@@@@...@@@@@@@@@@@@@@@@@@@@@@@@@@@@@@@@@@@@@@@@
@@@@@@@@@@@@...@@@@@@...@@@@@@@@@@@@@@@@@@@@@@@@@@@....@@@@@@@@@
@@@@@@@@@@@.....@@@@......@@@@@@@@@@@@@@@@@@@@@@@@@@...@@@@@@@@@
@@@@@@@@@@@@.....@@.......@@@@@@@@@@@@@@@@@@@@@@@@@@.....@@@@@@@
@@@@@@@@@@@@..............@@@@@@@@@@@@@@@@@@@@@@@@@@@......@@@@@
@@@@@@@@@@@@..............@@....@@@@@@@@@@@@@@@@@@@@@......@@@@@
@@@@@@@@@@@.......................@@@@@@@@@@@@@@@@@@@@.....@@...
@@@@@@@@@@@............................@@@@@@@@@@@@@@@......@...
@@@@@@@@@@............@................@@@@@@@@@@@@@@@.@@.......
@@@@@@@@@@...@@.@@.....................@..@@@@.....@@@@@@@.....@
@@@@@@@@@@......@...........@..........@..@@@......@@@.......@@@
@@@@@@@@...@................@@...................@.@@.......@@@@
@@@@@@@@............................@..............@@.....@..@@@
@@@@@@@@....@.................@....................@@........@@@
@@@@@@@@...@..............@@.@.@@.......@...........@....@@..@@.
@@@@@@@....@....@.......@..............................@@@......
@@@@@@...............@..................................@.......
@@@@@................@.......@................@@@.@@............
@@@@.........@................................@@@.@@@@.@....@..@
@@@@@@@@@....@..@..........@@@.@........@...........@@.........@
@@@@@@@@@@@@....@......@...............@@.......@......@@.......
@@@@@@@@@@@@......................@....@@@.....@@......@@.......
@@@@@@@@@@@@...@.......@@.....@.......@@@@@@.@.@@..@@@..........
@@@@@@@@.......@.@.@@@..@...@@@@......@@@@..@....@@@@@@..@......
@@@@@@@@.@..@....@.@@@.@@...@@@@.......@@@.......@@@@@@.....@@@@
@@@@@@@@@@.@@@..@@@@@..@@@@@@@@@........@........@@@@@@@....@@@@
@@@@@@@@@@.@@..@@@@@@@..@@@@@@@@...................@@@@.....@@@@
@@@@@..........@@.....@.@@@@@@@....................@@@@....@@@@@
@@@@@........................@@@......@...........@@@....@@@@@@@
@@@@@@........................@@@@@....@...........@@....@@@@@@@
@@@@@..................................................@@@@@@@@@
...@..@@.........@@@@.......@@......@................@@@@@@@@@@@
....................@.......@@......@@.......@..@.....@@@@@@@@@@
....@@....@.................@................@..@@@.....@@@@@@@@
..@..@....@@.............................@@@@@..@@.@...@@@@@@@@@
@....@.....@.....@@@....@@.@@@..........@.@@.....@.....@@@@@@@@@
.....@...........@@@@@..@@@.......@.......@............@@@@@@@@@
................@@@@@@.@@@@.............................@@@@@@@@
................@@.@@@@@@@@....@@@@................@..@@@@@@@@@@
.........@.........@@@@@@@......@@@@..@...............@@@@@@@@@@
...................@@@@@@@..................@@.......@@@@@@@@@@@
.......@.........@..@@@@@@.@................@@..@@...@@@@@@@@@@@
....................@@@@@@.@................@@@......@@@@@@@@@@@
@..@@@..............@@@@@..@........@.@@....@.@......@@@@@@@@@@@
@...@...............@@@@........@.....@.......@@.....@@@@@@@@@@@
@...............@...@@........................@@@...@@@@@@@@@@@.
@@@@@@............................@....@......@@@@..@@@@@@@@@...
@@@@@@@@....@............@......@@@..........@@@@@...@.@@@..@...
@@@@@@@@........................@@@@@.......@@@@................
@@@@@@@@..............@@@@@......@@.......@@@.@@.@.@.....@@.....
@@@@@@...@..........@@@@@@@......@@........@...@.....@..........
@@@@@@@.@@..........@@@@@@@@.....................@..............
@@@@@@@@@@...@@....@@@@@...@..........@..........@..@.........@.
@@@@@@@@@@.@@@@@....@@@@@.@.@.........@........@.....@@.......@.
@@@@@@@@@@@@@@.......@@@@.........@@..@@@.....@@...........@....
@@@@@@@@@@@@@@.......@@@@..@......@@@@@@@.....@@@@@@@@.....@....
@@@@@@@@@@@@@@@.......@@@.......@@@@@@@@@@....@@@@@@@@.........@
@@@@@@@@@@@@@@@.@@@.@.@@@@.....@@@@@@@@@@@@@@@@@@@@@@@.........@
@@@@@@@@@@@@@@@@@@..@.@..@....@@@@@@@@@@@@@@@@@@@@@@@@@@@@@@@@@@
@@@@@@@@@@@@@@@@@@@.@@........@@@@@@@@@@@@@@@@@@@@@@@@@@@@@@@@@@
@@@@@@@@@@@@@@@@@@@@@@@@......@@@@@@@@@@@@@@@@@@@@@@@@@@@@@@@@@@
@@@@@@@@@@@@@@@@@@@@@@@@....@.@@@@@@@@@@@@@@@@@@@@@@@@@@@@@@@@@@
8
58 6 0
25 24 0
36 30 0
21 23 0
1 33 0
31 45 0
48 54 0
29 61 0

44 18 0
61 58 0
25 12 0
59 19 0
2 37 0
26 19 0
40 32 0
45 21 0
