width 64
height 64
@@@@@@@@@@@@@@@@@@@@@@@@@@@@@@@@@@@@@@@@@@@@@............@....@@
@@@@@@@@@@@@@@@@@@@@@@@@@@@@@@@@@@@@@@@@@@@@@@................@@
@@@@@@@@@@@@@@@@@@@@@@@@@@@@@@@@@@@@@@@@@@@@@..@..............@@
@@@@@@@@@@@@@@@@@@@@@@@@@@@@@@@@@@@...@@........@@......@......@
@@@@@@@@@@@@@@@@@@@@@@@@@@@@@@@@@@@.............@@....@......@..
@@@@@@@@@@@@@@@@@@@@@@@@@@@@@@@@@@.........@.....@..............
@@@@@@@@@@@@@@@@@@.@@@@@@@@@@@@@@@.@............................
@@@@@@@@@@@@@@@@@..@@@@@@@@@@@@@@.......................@@......
@@@@@@@@@@@@@@@@.....@@@@@@@@@@@@@..@@....@@..@..@......@@......
@@@@@@@@@@@@@@@@@..@..@@@@@@@@@@@@..@@.........@@@@....@@@@@@@@.
@@@@@@@@@@@@@@@.......@@@@@@..@.@....@@...@.....@@@.@@@@@@@@@...
@@@@@@@@@@@@@@@.....@...........@.....@.........@@@.@@@@@@@.@...
@@@@@@@@@@@@@@@.................................@@@@@@@@@@@....@
@@@@@@@@@@@@@@@.................................@@@@@@@@@@@@@..@
@@@@@@@@@@@@@@..............@@.............@..@...@@@@@@@@@@@...
@@@@@@@@@@@......@...........@.............@..@..@@@@@@@@@@@@@..
@@@@@@@@@@@........@@.......@@...................@@@@@@@@@@@@@..
@@@@@@@@@@@......@..........@@..................@@@@@@@@@@@@@@..
@@@@@@@@@@.....@@...............................@@@@@@@@@@@@@...
@@@@@@@@@.........................@.......@@.@@@@@@@@@@@@@@@@@..
@@@@@@@@@..........@.......@....@.........@@@@@@@@@@@@@@@@@@@@@.
@@@@@@@@@......@@..@............@@..........@@@@@@@@@@@@@@@@@@@@
@@@@@@@@@......@@..@...............@........@@@@@@@@@@@@@@@@@@@@
@@@@@@@@@@@...@@@............................@@@@@@@@@@@@@@@@@@@
@@@@@@@@@@@...................................@@@@@@@@@@@@@@@@@@
@@@@@@@@@@@........@...................@.@....@@@@@@@@@@@@@@@@@@
@@@@@@@@@@@@...........@..@.....@@..............@@@@@@@@@@@@@@@@
@@@@@@@@@@@@@..........@........................@@@@@@@@@@@@@@@@
@@@@@@@@@@@@..@...@..@@@......................@...@@@@@@@@@@@@@@
@@@@@@@@@@@@........@@@@@@@@......................@@@@@@@@@@@@@@
@@@@@@@@@@@.........@@@@@@@@@@....@.......@.......@@@@@@@@@@@@@@
@@@@@@@@@@......@...@@@@@@@@@@@...@...............@@@@@@@@@@@@@@
@@@@@@@@@@@@....@@.@@@..@@@@............@.........@@@@@@@@@@@@@@
@@@@@@@@@...........@@..@.@@..............@........@@@@@@@@@@@@@
@@@@@@@@............@@.....@@@@@@@.........@.......@@@@@@@@@@@@@
@@@@@@@@..........@..@....@@@@@@@@..........@........@@@@@@@@@@@
@@@@@@@........@.....@.....@@@@@@@....................@@@@@@@@@@
@@@@@@......................@@..........................@@@@@@@@
@@@@@.......@@..............@@..........................@@@@@@@@
@@@@@.@@@@@@@@@@@@.@.....@.......@@@..@@..........@.@...@@@@@@@@
@@@@...@@@@@@@@@@@....................@@@................@@@@@@@
@@@....@@@@@@@@@@........@.....@@......................@@@@@@@@@
@@@....@@@@@@@@@@...@@...@@@...@..@.........@...........@@@@@@@@
@@@....@@@@@@@@@@@...@.........@..................@@..@.@@@@@@@@
@@...@..@@@@@@@@@....................@@................@@..@@@@@
@@@@......@@@@@@...................@@@@..............@.....@@@@@
@@@.........@@@@..........@.......@@@@@@..@.......@..........@@@
@@@@.........@..........@@......@@@@@@@@@@@.....................
@@@@@@@.........................@@..@.@.@@@.@...................
@@@......@@@@@........@.............@.........@.@...@...........
@@........@@@@@..............@......@...........@...............
@@@......@@@@@@.@@@........@...........................@.@......
@@@...@...@@@@@@@@@.........@...@@....@...@@@@................@@
@@@..@@...@@@@@@@@@......@..@@@.@@..@......@@@..........@.......
@@@@@@@.......@@@@@.........@@@@@@.........@@@...........@......
@@@@@@@.......@@............@@@@@...........@@..............@...
@@@@@@@@.............@...@@@@@@@@@..@........@@..@..............
@@@@@@@@...............@@@@@@@@@@@@.............................
@@@@@@@@@.....@........@@@@@@@@@@@@...@.........................
...@...@.@..........@@@@@@@@@@@@@@.....@@.......@...............
...@.........@@.@@@.@@@@@@@@@@@@@@@@.................@..........
.....@......@@..@@@@@@@@@@@@@@@@@@@@........@....@.......@@@....
..........@@@@..@@@@@@@@@@@@@@@@@@@@.@.......@@@.........@@@...@
@....@@....@@@.@@@@@@@@@@@@@@@@@@@@@@........@@...@@@....@@@..@@
8
40 25 0
43 3 0
18 59 0
55 39 0
24 28 0
13 54 0
63 60 0
29 13 0

55 57 0
29 10 0
24 45 0
63 10 0
54 59 0
13 55 0
19 11 0
47 55 0
