width 64
height 64
@@@@@@@@@@@@@.......@@@@@@@@.........@@@@@@@@@@@@@@@..@@@@@@@@@@
@@@@@@@@@@@@@...........@@@@.....@...@@@@@@@@@@@@@@@...@@@@@@@@@
@@@@@@@@@@@@@@......@....@.......@...@@@@@@@@@@@@@.....@@@@@@@@@
@@@@@@@@@@@@@@@@....@....@@..........@@@@.....@@@@.....@@@@@@@@@
@@@@@@@.@@@@@@@.......................@@@...............@@@@@@@@
@@@......@@@@@@.......................@@@@....@.......@@@@@@@@@@
........@@@@@@@@.....@@.@..@..........@@@@@@.....@....@@@@@@@@@@
....@@@.@@@@@@@@.@@..............@@.....@@@............@@@@@@@@@
..........@@@@@..@@..............@.@@...................@@@@@@@@
@@.........@@@@@@@.................@@...............@..@@@@@@@@@
@@@@@......@@@@@@..............@@@.@...@...@@..........@.@@@@@@@
@@@@@.....@@@@@@@.@@@@@.........@@@@@................@.....@@@@@
@........@@@@@@@@..@@@@@.@.@......@@..............@.......@@@@@@
..........@@@@@....@@@@@..........@@..............@.......@@@@@@
...........@@@@....@@@@@..............@...................@@@@@@
............@@@....@@@@@....@@............................@@@@@@
@............@@....@@@@@.......@..........................@@@@@@
@@@.................@@@@.......@.........@...........@....@@@@@@
@@@............@@@...@@@..........@@....@@.@.............@@@@@@@
.@.............@......@.................@@.............@@@@@@@@@
.......................@@.@......................@@....@@@@@@@@@
.....................................@@@@@..@....@@@...@@@@@@@..
............................@.......@@@@@@@@@............@@.....
.@@@.........................@......@@@@@.@@...........@.@......
.@@@@.............@..........@..@@.@@@@@@..@..@................@
@@@@@@............@@.......@@@@.@@@@@@@@.......................@
@@@@@@............@........@@@@.@@@@@@@@...................@...@
@@@@@@...@.................@@@..@@@@@@@@.....@..@....@.@...@@..@
@@@..@...@.@...............@@@..@@@@@@@@@@..........@@.....@@...
@@@.........@.@...........@@@@@@@@@@@@@@@@@...@.................
@@...@...@..@@@..........@@@@@@@@@@@@@@@@@@.....................
@@@.......@..............@@@@@@@@@@@@@@@@.......................
@@@..............@@@.....@@@@@@@@@@@@@@@@........@@....@@@......
@@@@...............@@.....@@@@@@@@@@@@@@.....@....@........@@@@@
@@@..@..........@...........@@@@@@@@@@@@@@@................@@@@@
@@..............@@...@.......@@@@@@@@@@@@...................@@@@
@@..............@@...........@@@@@@@@@@@@.......@....@.@..@..@@@
@..@.@..........@.............@@@@@@@@.@@...........@@@@....@@@@
@....@........................@@@@@@@@.@@...@@@.....@@@@....@@@@
..............@..............@@@@@@@@@..@..@.................@@@
...................@@@.....@.@.@@@@@@@.......@................@@
...@..@................@@.@@...@@@@@@@..........@..@........@@@@
@@@@...........................@@@@@@.............@@.........@@@
@@@..............................@...........................@@@
@@@............................@................................
@@....@@..@...@......@..................@............@@@@@@.....
@@...@@@@@@.........@@.........................@......@@@@@@....
@@..@@@@@@@@@.......@....@@@@.@...................@...@@@@@.....
@@@@@@@@@@@@@@@...............@@.............@..................
@@@@@@@@@@@@@@.......@.......@@@....@....@.........@.......@....
@@@@@@@@@@@@@@@......@....@.............@@.........@.......@@..@
@@@@@@@@@@@@@@@@@@..@@@@@@@...............@@......@......@......
@@@@@@@@@@@@@@@@@@@@@@@@@@@.@@...@.......@@@@@....@.............
@@@@@@@@@@@@@@@@@@@@@@@@@@@......@...@..@@..@@@.................
@@@@@@@@@@@@@@@@@@@@@@@@@@@@@...............................@@..
@@@@@@@@@@@@@@@@@@@@@@@@@@@@@...@..@...@....................@@..
@@@@@@@@@@@@@@@@@@@@@@@@@@@@@.........@@....................@@..
@@@@@@@@@@@@@@@@@@@@@@@@@@@@..........@@..........@........@@@@@
@@@@@@@@@@@@@@@@@@@@@@@@@@@@.@...@...............@@....@...@@@@@
@@@@@@@@@@@@@@@@@@@@@@@@@@@@@@...@@@@@@@...................@@@@@
@@@@@@@@@@@@@@@@@@@@@@@@@@@@@@..@@@@@@@@@.@.........@......@@@@@
@@@@@@@@@@@@@@@@@@@@@@@@@@@@@@..@@@@@@@@@@......@.@...........@@
@@@@@@@@@@@@@@@@@@@@@@@@@@@@@@@@@@@@@@@@@@@@...@@.............@@
@@@@@@@@@@@@@@@@@@@@@@@@@@@@@@@@@@@@@@@@@@@@@..@@@@.....@@....@@
8
19 22 0
51 2 0
15 40 0
63 53 0
17 10 0
10 27 0
39 16 0
13 20 0

8 33 0
51 8 0
4 29 0
28 3 0
53 56 0
54 24 0
52 19 0
8 11 0
