width 64
height 64
@@@@@@@@@@@.........@@@@@@@@@@@@@@@@@@@@@@@@@@@@@@@@@@@@@@@@@@@@
@@@@@@@@@@@.......@...@@@@@@@@@@@@@@@@@@@@@@@@@@@@@@@@@@@@@@@@@@
@@@@@@.@@@................@@@@@@@@@@@@@@@@@@@@@@@@@@@@@@@@@@@@@@
@@@@@@......@....@@.............@@...@@@@@@@@@@@@@@@@@@@@@@@@@@@
@@@@.......@.......@......@@....@@....@@@@@@@@@@@@@@@@@@@@@@@@@@
@@@...............@@.................@@@@@@@@@@@@@@@@@@@@@@@@@@@
@@...@....@........@...............@...@@@.@.@@@@@@@@@@@@@@@@@@@
@......@..@@.......................@...@@@...@@@@@@@@@@@@@@@@@@@
@......@......@...................@..........@@.@@@@@@@@@@@@@@@@
@......@...@..@@@.........................@.....@@@@@@@@@@@@@@@@
@@...@.@...@..@@..@..@...........................@@@@@@@@@@@@@@@
@@................@..@...........@.............@@@@@@@@@@@@@@@@@
@@...@@@.......@@...............................@@@@@@@@@@@@@@@@
@@..............@.........................@..@..@@@@@@@@@@@@@@@@
@.............................@@........@.@@...@@@@@@@@@@@@@@@@@
@@@..........@.....@....................@.....@@@@@@@@@@@@@@@@@@
@@@@.....@@@@@@@...@.....@....@@............@.@@@@@@@@@@@@@@@@@@
@@@@@.....@@@@.....@@@....@...@@............@@@@@@@@@@@@@@@@@@@@
@@@@@..............@@@............@@.......@@@@@@@@@@@@@@@@@@@@@
@@@@....@...@@..........................@..@@@@@@@@@@@@@@@@@@@@@
@@@..........@.@@............@......@.......@@@@@@@@@@@@@@@@@@@@
@@@..@..........@..@.......@...@....@@.......@@@@@@@@@@@@@@@@@@@
@@.................@....@....................@@@@@@@@@@@@@@@@@@@
@@.........................@......@@@@.......@@@@@@@@@@@@@@@@@@@
@@....................@@@..@......@@@@@....@@@@@@@@@@@@@@@@@@@@@
@@..@@...............@@@@.........@@@@@.....@@@@@@@@@@@@@@@@@@@@
.......................@@..........@@@@@@@@@@@@@@@@@@@@@@@@@@@@@
..........@............@@..........@@@@@@@@@@@@@@@@@@@@@@@@@@@@@
......@...@@@@.........@@.......@@.@@@@@@@@@@@@@@@@@@@@@@@@@@@@@
@@@...@@@@.@@@.................@@...@@@@@@@@@@@@@@@@@@@@@@@@@@@@
@@@...@@@@..........................@@@@@@@@@@@@@@@@@@@@@@@@@@@@
@@@...@@@.....@@...@@@@............@@@@@@@@@@@@@@@@@@@@@@@@@@@@@
@@@..............@@@@@@@.@@@........@@@@@@@@@@@@@@@@@@@@@@@@@@@@
@@@..............@@@@@@@..@@..............@@@@@@@@@@@@@@@@@@@@@@
.@......@@.......@..@@@....@........@.....@@@@@@@@@@@@@@@@@@@@@@
.@..@......@@........@@....................@@@@@@@@@@@@@@@@@@@@@
.@.....................@.@@...............@@@@@@@@@@@@@@@@@@@@@@
.@.....@@.............@@...........@......@@@@@@@@@@@@@@@@@@@@@@
.....................@@@..................@@@@@@@@@@@@@@@@@@@@@@
...........@......@..@@@............@.......@@@@@@@@@@@@@@@@@@@@
@@...........@@@.....@@@.....................@@@@@@@@@@@@@@@@@@@
@@@@.......@@@@.......@@...@....@.............@@@@@@@@@@@@@@@@@@
@@@@......@@@.........@@...@@@@..............@@@@@@@@@@@@@@@@@@@
@.@@.....@@@@..............@@....@..........@@@@@@@@@@@@@@@@@@@@
@.@@...@@@@@@@@.......@..........@...@......@@@@@@@@@@@@@@@@@@@@
@........@@@@@@.......@.........@@............@@@@@@@...@@@@@@@@
....@@...@@@@@@@.@@...........@@@@@.........@.@@@......@@@@@@@@@
..........@...................@@.@@....@@.....@@@......@@@@@@@@@
@.........@......@@@.@@@.......@..............@@@......@@@@@@@@@
..........@@....@@@@@...@............@...............@.@@@@@@@@@
..@@..............@@@@...........................@.....@@@@@@@@@
..@@...............@@@......@.....................@....@@@@@@@@@
@@@@...@@@@@..@....@@@.......@..............@.....@.....@@@@@@@@
@@@@...@@@@@......@.@@...@@......@@@.......@..........@@@@@@@@@@
@@@@..............@..@..@@@......@@@..@.................@@@@@@@@
@@@....@.......................@@@@@...@.@@............@@@@@@@@@
@@@..............@..............@@@@.@...@@@..........@@@@@@@@@@
@@@............................@.@@@.....@@@...........@@@@@@@@@
..@.........@@.@...............@..@@....................@@@@@@@@
...........................@...........@@.....@.@.......@@@@@@@@
...........................@....................@@......@@@@@@@@
.............@@.....@@...........@......................@@@@@@@@
...@.............@@@@...@@@...................@@@@......@@@@@@@@
@@.@....@...............@@..............@..@@@@@@@.....@@@@@@@@@
8
37 34 0
38 40 0
31 61 0
26 16 0
33 41 0
33 22 0
10 60 0
6 2 0

6 50 0
42 52 0
32 26 0
39 13 0
24 40 0
35 40 0
24 11 0
3 20 0
