width 16
height 16
@@@@@......@@@..
....@........@..
................
@@@.......@....@
@@@@.........@..
@.@@............
................
@@..............
......@......@..
...........@....
..........@@....
......@..@@@.@..
...........@....
....@.....@@...@
..@.@.@...@@....
.@@@......@@@...
8
10 0 0
8 8 0
3 9 0
10 8 0
0 2 0
11 3 0
1 12 0
14 8 0

11 3 0
14 14 0
4 11 0
8 13 0
15 15 0
14 1 0
15 2 0
11 4 0
