width 16
height 16
@@@@............
...@........@...
...@@@.........@
...@.....@.....@
..@..........@@@
.....@.....@@@@@
@.........@@@@@@
........@@@@@@@@
.......@@@@@@@@@
........@..@@@@@
..........@@.@@@
...........@.@@@
..............@@
....@...........
....@@@@........
....@@@@......@.
8
12 10 0
3 7 0
6 4 0
2 14 0
10 4 0
9 13 0
5 9 0
1 11 0

13 12 0
2 15 0
8 4 0
8 10 0
4 10 0
14 2 0
5 7 0
1 11 0
