width 16
height 16
@@..@@..........
.....@..........
................
@......@........
@@..@.....@.....
@@..............
................
................
@.............@@
@......@...@...@
...........@...@
.......@.@@....@
.......@@@@@....
....@@@@@@@@....
...@@@@@@@@@@@@@
..@@@@@@@@@@@@@@
8
4 1 0
4 5 0
12 0 0
1 7 0
0 6 0
0 12 0
13 2 0
3 0 0

12 2 0
13 12 0
0 13 0
15 0 0
14 6 0
14 13 0
13 10 0
15 12 0
