width 16
height 16
@@@@@@@@@@@@@@@@
@@@@@@@@@@@@@@@@
@@....@@@@@@@@@@
@@......@@@@@@@@
@.......@@@@@@@@
@.......@@@@@@@@
......@@@@@@@@@@
.......@@@...@@@
...........@@@@@
............@@@@
......@@....@@@@
.......@@.....@@
......@@@...@.@@
..............@@
........@....@@@
..........@.@@@@
8
4 8 0
6 9 0
3 9 0
5 9 0
10 7 0
5 14 0
2 13 0
10 14 0

4 8 0
13 13 0
6 15 0
3 9 0
11 9 0
8 8 0
5 15 0
4 12 0
