width 16
height 16
....@@@@@@@@@@@@
....@.@@@@@@@@@@
......@@@@@@@@@@
......@@@@@@@@@@
.......@@@..@@..
....@@@@@@......
....@@@@@@@.....
....@@@@@@@.....
.....@@@@@@....@
.......@@@@....@
..@.............
..@@@...........
...............@
...............@
..............@@
@@@....@@.....@@
8
10 5 0
1 9 0
3 15 0
7 11 0
13 7 0
11 13 0
12 6 0
15 10 0

0 0 0
7 10 0
2 12 0
15 7 0
1 10 0
8 11 0
12 6 0
15 10 0
