width 20
height 31
.........@....@.....
....@...@...........
..@....@.@.....@....
....................
....@......@........
..........@.@....@..
....................
..@@.....@...@..@...
..@@................
..@@....@..@.@..@...
..............@.....
....@.....@......@..
..........@@........
..@.@...@.......@...
......@.......@.....
.....@...@...@......
....................
...........@........
............@..@....
....@...@...........
....................
@@...........@......
@....@..............
.............@.....@
..........@.........
..@..@...........@..
...............@....
.........@..........
@@.....@............
@@..................
@@@.....@...........
6
12 12 0
10 29 0
14 2 0
2 5 1
3 2 1
7 9 1

13 29 0
0 9 0
1 14 0
12 0 1
9 6 1
19 29 1
