width 20
height 31
...............@....
...........@.@......
....@...............
...@...........@....
...........@........
......@..@..........
....................
.......@......@.....
......@...@.........
....@.....@.........
.....@.........@....
......@...@.@.......
..@.................
..............@.@...
....................
..@.................
.......@.@..........
...@................
..........@.........
..@............@..@.
@.......@...........
....@.@..@..........
............@.......
..........@.@...@...
.........@..........
.@.....@............
.......@....@.......
.............@......
........@.@....@....
.@..........@....@@.
...@.@@.............
6
11 28 0
3 27 0
9 4 0
14 14 1
0 29 1
13 23 1

1 0 0
8 27 0
3 29 0
12 9 1
12 25 1
2 0 1
