width 20
height 31
...@...............@
.......@.@.........@
..@.....@..........@
..........@...@.....
....................
........@..@..@.....
.@@......@..@...@...
....................
......@.............
.....@.........@....
...................@
............@.......
.......@.@..........
...@..@.............
.............@......
..........@.@.@.....
....................
.............@......
.....@..@...@.....@.
..@...........@.....
.@..................
..@...@..@......@...
....@...............
....................
...@...@.........@..
.............@......
.........@..........
..@.@...@........@..
....................
@@.....@........@@..
@@.............@@@.@
6
5 21 0
13 11 0
1 11 0
11 26 1
13 12 1
11 23 1

16 7 0
2 26 0
13 23 0
1 26 1
15 11 1
0 0 1
