width 20
height 31
......@@@...........
...............@....
.......@............
....................
............@...@...
...@.@.@............
@.......@........@..
@@..................
....................
..@.................
...@.......@........
......@@@...........
......@...@.........
.@...@.......@.@....
....................
....@@.....@...@....
@@@..@..............
@@.......@....@..@..
@.....@.............
.......@....@.@.....
.........@.....@....
..@..@..............
.....@.....@........
.............@......
.................@..
@.@@....@....@......
@@@@@.....@.@.......
@@@@@@@.............
@@@@@@@.............
@@@@@...@.......@...
@@@@@...........@...
6
4 6 0
2 5 0
12 16 0
1 0 1
18 29 1
4 3 1

6 24 0
6 26 0
19 2 0
11 0 1
11 14 1
4 8 1
