width 20
height 31
..............@@@@@@
.............@@@@@@@
.@.......@....@@@@@@
@.............@@@@.@
.....@@............@
..............@.....
......@..@..........
....................
........@...@@...@..
.........@.@........
........@.......@...
...@.........@.@..@.
........@...........
...........@........
............@.@.....
...@...@.......@....
....................
......@.............
.................@..
.....@....@.@..@....
...@................
............@.......
...@..@......@..@...
....@....@..........
@.@.......@..@..@...
@@..................
@@................@.
@.........@..@......
@..@..........@.....
....................
....................
6
10 3 0
19 23 0
11 5 0
16 4 1
8 9 1
6 5 1

18 16 0
2 12 0
10 21 0
7 9 1
19 6 1
17 30 1
