width 75
height 75
@@@@..@@@@@..@@@@@@@@@@@@@..............@@..@..@@@@@@@@@.....@@.....@@@@@@@
@.......@.@..@@@@@@@@@@@@@@..@..........@......@@@@@@@@@............@@@@@@@
@......@@....@@@@@@@@@@@@@@....@..........@@...@@@@......@@.........@@@@@@@
...........@@@@@@@@@@@@@@@@......@@@..................@@@@..........@@@@@@@
...........@@@@@@@@@@@@@@@@@.....@..........@@..............@.......@@@@@@@
.............@.@@@@@@@@@@@@@.........................@@..@.@@...@..@@@@@@@@
.....@@........@@@@@@@@@@@@@...........@@.............@..@.@.......@@@@@@@@
...............@@@@@@@@@@@@@@@..........@...........@..............@@.@@@@@
@...@..........@@@...@@@@@@@.@..........@......@@@..@@...........@....@@@@@
......@@..............@@@@@............@@.......@@.@@@........@@.@..@@@@@@@
......................@@@...............@@.......@.@@.......@.@@@@@@@@@@@@@
@.......@.........@.....................@...........@..........@@@@@@@@@@@@
@@@.....@....@...@@.................@...........................@@@@@@@@@@@
@@@..@@..........@....@............@@................@....@.....@@@@@@@@@@@
@@@............@@...................@...........@....@.............@@@@@@@@
@@@@....@......@@...@..........................@@............@....@@@@@@@@@
@@@@...@@@...@...@.............................@@@...@.........@@.@@@@@@@@@
@@@@....@.........@............@@.............@@@@@@@@........@@..@@@@@@@@@
@@@@..........................@@@.............@@@@@@@..@..........@@@@.....
.@..............@.............@.@........@@@...@@@.@@........@@....@@......
....@...........@..........................@@..@@@...........@....@........
.@@@............@@.....@.@.................@@..@@@.............@..@.....@..
..@...@..................@...@.............@..@@@@......................@@.
..............@..@@@.@.....@@.................@@@@@@..@...@..@.............
.................@@@@@@..........................@@.........@@..@@........@
@....@@..........@@@@@@.......@.....@..@@.......@...............@..........
@................@@@@@@.@@@............@@@.................................
@.........@@.....@@@@@@@@@@@...........@@@@.........@.....@............@.@@
@.................@@@@@@@@@@...........@@@.@...@....@.....@..............@@
@......@@@@..@.....@@@@@@@@..........@..@......@@...@.....@..............@@
@..................@@@@@@@@......@................@@@...@@@........@..@@.@@
...................@@..@@@@@............@.........@@@...@@@.......@@@....@@
...................@@...@@@@............@..........@@....@@......@@@@......
............@......@@..@@.........@.........@..@...@@............@@@@@@.@@.
...@..................@@@@.....@.................@@@@@@@@.........@@@.@....
@..@...................@@@@@@..................@@@@@@@@@@@....@...........@
.@.....@@.........@.....@@@@@........@@@.@@@@@@@@@@@@@@@@@......@@....@@..@
.......@@..........@@..@@@@@@....@@@.@@@.@@@@@@@@@@@@@@@@@............@@@.@
@......@@.....@.......@@@@@@@.....@@@@@@@@@@@@@@@@@@@@@@@.........@....@@@@
@@.....@@@....@.....@.@@@@@@@.....@@@@@@@@@@@@@@@@@@@@@...........@....@@@@
@@.....@@@@@.@@.....@...@@@@@.....@@@@@@@@@@@@@@@@@@@@........@@........@@@
@@.....@@@@@@@@.........@...@......@@@@@@@@@@@@@@@@@@....................@@
@@@.......@@@@@@............@......@@@@@@@@@@@@@@@@@.......................
@..@......@@@......................@@@@@@@@@@@@@@@@@...........@@.......@..
@........@@@@..........@............@@@@@@@@@@@@@@@@@....@@@.....@@@..@@@..
@@.......@@@.........@@@.@......@...@@@@@@@@@@@@@@@@.......@...@@@@@..@@@..
@@@..@@...........@......@@.........@@@@@@@@@@@@...@...........@@@@..@@@@..
@@@..@@...........@@.....@@@@@.....@@@@@@@@@@@@@..........@.....@@@@@@@@@..
@@@@@@@@@.........@@@....@.@@@@@..@@@@@@@@@@@@@....@..........@...@@@@@@@..
@@@@@@@@@@........@@@........@@@@@@@@@@@@@@@@@@@...@..............@@@@@@@..
@@@@@@@@@@....@.@.@@@.........@@@@@@@@@@@@@@@...........@......@@@@@@@@@@..
@@@@@@@@@@..@...@@@@@.......@@@@@@@@@@@@@@@@@.....@@....@......@@@@@@@@@...
@@@@@@@@@.......@@@@........@@@@@@@@@@@@@@@@................@.@@@@@@@@@@...
@@@@@@@@@..@......@@.........@@@@@@@@@@@@@@@...................@@@@@@@@@@@.
@@@@@@@@@......@@..............@@@@@@@@.@@@............@.......@@@@@@@@@@@.
@@@@@@@@@@@.............@@.......@@@@.@...@............@......@..@@@@@@@@@.
@@@@@@@@@@@..................@...@@@..@.................@..........@@@@@@@.
@@@@@@@@@@@...........@...@@@@...@@.........................@.......@@@@@@@
@@@@@@@@@@@....@......@....@@@....................@.................@@@@@@@
@@@@@@@@@@@.@..............@@........@@@.................@@.........@@@@@@@
@@@@@@@@@..................@.........................@@@@@@......@.......@@
@@@@@@@@@@@...@............@@@....................@..@@@@@.......@@@.....@@
@@@@@@@@.@....@@......@....@@@..@..............@......@@@@.....@@@@@@......
@@@@@@@...@........@..@@@@@@@@.@@@@....................@@@.......@@@@......
@@@@@@@@.............@@...@@@...@@@@@............@.............@@@@@..@@...
@@@@@@@@@......................@@@@@@............@.............@@@@@....@@.
@@@@@@@@@................@@........@@.........................@@@@@.@...@@@
@@@@@@@@@@@.........@..............@@@...........@@...........@@@@@.....@@@
@@@@@@@@@@@@......@.@@...@.........@@@........@..@@@@....@......@@@.....@@@
@@@@@@@@@@@@...............@........@...........@@@@...@@@@@....@@.......@@
...@@@@.@@@@@.....@......@.@....@...............@@@@...@@@@@...........@@@@
...@@......@......@.............................@@@@@@@@@@@@@........@@@@@@
@.............................@.................@@@@@@@@@@@@@@@........@@@@
@.@@...........................................@@@@@@@@@@@@@@@@@.......@@@@
@@@@.........@@..@.......@.....@.@......@@@..@@@@@@@@@@@@@@@@@@........@@@@
8
30 23 0
14 13 0
19 43 0
22 56 0
23 40 0
55 47 0
4 35 0
59 54 0

50 63 0
52 67 0
9 36 0
42 6 0
30 22 0
56 6 0
11 46 0
61 53 0
