width 75
height 75
@@@@@@@@@@@@@@@@@@@.@...........@@........@...@@@.....@@@@@@@@@@@@@@@@@@@..
@@@@@@@@@@@@@@@@@@..@...........@@.......@@...@@.....@.@@@@@@@@@@@@@@@@@@..
@@@@@@@@@@@@@@@@@.....................@@...................@@@@@@@@@@@@@...
@@@@@@@@@@@@@@@@.....................@@@.........@.....@...@.@@@@@@@@@@@@..
@@@@@@@@@@@@.....@@...@...@..............@@...........@@@....@@@@@@@@@@@...
@@@@@@@@@@@@............@.@@.............@@..@@.......@@@..@@@@..@.@@..@..@
@@@@@@@@@@@@............@.@@............@@@@..@....@@.@@@..@@@@@...........
@@@@@@@@@@@@@@......................@...@@@@.......@@@@@@....@@@...........
@@@@@@@@@@@@@@......................@..@@@..@......@@@@@@....@@@...........
@@@@@@@@@@@@@@@@...@@.....@............@@...@..@...@@@@@@.....@@...........
@@@@@@@@@@@@@@@@...@...............................@@@@@..................@
@@@@@@@@@@@@@@@...................................@@@@.........@...........
@@@@@@@@@@@@@@@.................................@@@@@@@@@@.................
@@@@@@@@@@.@.@@@.....@..................@......@@@@@@@@@@..................
@@@@@@@@.....@@@@@@....@@@....@@....@..........@@@@@@...@...........@......
@@@@@........@@@@@@@@@.........@@@@...........@@@@@@@........@.............
@@@@@......@@@@@@@...@........@@@@@...............@@...@..........@@@@.....
@@@@@......@@@@@@@...@@@@@.@..@@@@...........@................@..@@@@@.....
@@@@......@@@@@@@@.....@@@....@.............................@....@@@@@.....
@@@@@@@..@@..@@@@@.....@@@@@......@@......@................@.....@@@@@@..@@
@@.@@@@...@@.@@@..........@......@.....@.....@............@......@@@@@@@@@@
@@.@@@.......@@........................@....@@..............@.....@@@@@@@@@
@..........@....@......@..@....@......@.............@.......@.....@@@@@@@@@
@...................................@@@.....@...........@.........@@@..@@@@
......................@..............@........@.......@...........@@@@.@@@@
................@.@..@........................@..........@@............@@@@
@..@....@@......@......@@.......@@@.......@...............@.............@@@
@............@@....@...@@...............@..............................@@@@
@.............@........@@@.............................................@@@@
@..@.....@.......@@@..@@..........................@.....@@.....@@........@.
.......@@@.@@...@@@@...............................@.@@@@@@................
.......@@@.@@@@@@@@@................@@.@..@@.......@@@@@@@@@@@@............
.....@@@@@.@@@@@@@.................................@@@@@@@@@@@@@.........@.
....@@@@@@@@@@@@@@............................@....@@@@@@@@@@@@@.@@........
....@@@@@@@@@@@@@@......@@....@....@@@........@@@.......@@@@@@@@@@..@......
...@@@@@@@@@@@@@@.......@...@@@..@@@@@......@@@@@..@@...@@@@@@@............
@@@@@@@@@@@@@@@@@@.....@@@@...@@@@.@@@.......@@@@@......@@@@@@@....@@......
@@@@@@@@@@@@@@@@@@......@@@........@.@..........@.......@@@@@@......@..@...
@@@@@@@@@@@@@@@@@@@......................................@@@@@........@...@
@@@@@@@@@@@@@@.@@@...@@@....................@...@.@...@..@@@@............@@
@@@@@@@@@@@@@@..@@...@@@@.....@....@@...........@.........@@@@@.........@@@
@@@@@@@@@@@@@@.........@...@@@..@..............................@........@@@
@@@@@@@@..@@@@@............@@.........@...@.......@...........@@@.......@@@
@@@@@.@@..@................@@@..@.........@@......@@@..........@......@@@..
@@@@@.@@..................@@@@@@@@.....@..@@..@....@@.....@@......@...@@@..
@@@.............@@.@@.....@@@@.@@...................@.............@...@....
@@@@@.@.........@@@@@....................@.@@@.........@...................
@@@@@@@@@.......@@@@.......@.....@@......@.@@@...............@.............
@@@@@@@@@..@@@@@@@@..........@....@....@@@.@@@.@@.....@@@@.................
@@@@@@@@@@@@@@@@@@.....................@@@@@@@........@@@@.............@@..
@@@@@@@@@@@@@@@@@@@.@@@@..@@..@........@@@@@@@........@@@@..........@@.....
@@@@@@@@@@@@@@@@@@.........@..@.@@@...@@@@@@@@..............@@.....@@@@@...
@@@@@@@@@@@@@@@@@@.......@....@..@@......@@@@@.....@@@.............@@@@@...
@@@@@@@@@@@@@@@@@@......@@.......@@........@.......@@@.............@@@@@.@.
@@@@@@@@@@@@@@@@@........@...................@@@...................@@@@@@@@
@@@@@@@@@@@@@@@@@........@................@......@.................@@@@@@@@
@@@@@@@@@@@@@@@@@@.............................@................@@@@@@@@@@@
@@@@@@@@@@@@@@@@@@@@..................@............@@...........@@@@@@@@@@@
@@@@@@@@@@@@@@@@@@@@@@@@..............@@@.........@@.........@..@@@@@@..@@@
@@@@@@@@@@@@@@@@@@@@@@@@@...............@@.......@@@.....@......@@@@.@..@@@
@@@@@@@@@@@@@@@@@@@@@@@@..@...@..................@@@@.............@@.@..@@@
@@@@@@@@@@@@@@@@@@@@@@@@.......@.................@@@....................@@@
@@@@@@@@@@@@@@@@@@@@@@@@.........@.....@.........@@@............@@@@...@@@@
@@@@@@@@@@@@@@@@@@@@@..............@@..........@@.@@.......@....@@@@...@@@@
@@@@@@@@@@@@@@@@@@@@...............@...........@..@.............@@@@@@@@@@@
@@@@@@@@@@@@@@@@@@@@...........................@.............@@@@@@@@@@@@@@
@@@@@@@@@@@@@@@@@@@@.....................................@...@@@@@@@@@@@@@@
@@@@@@@@@@@@@@@@@@@@.............@.........@............@@...@@@@@@@@@@@@@@
@@@@@@@@@@@@@@@@@@@@.............@.......@@@@@.............@@@@@@@@@@@@@@@@
@@@@@@@@@@@@@@@@@@@@..........@..@...........@........@.....@@@@@@@@@@@@@@@
@@@@@@@@@@@@@@@@@@@.........................@@...@...@@.......@@@@@@@@@@@@@
@@@@@@@@@@@@@@@@@@.....................@@.@...........@@......@@@@@@@@@@@@@
@@@@@@@@@@@@@@@@@@......................@@...................@@@@@@@@@@@@@@
@@@@@@@@@@@@@@@@@@@....@@..@........@....@...@.......@........@@@@@@@@@@@@@
@@@@@@@@@@@@@@@@@@@.@.@@@...........@@...@...@.......@....@.@..@@@@@@@@@@@@
8
53 2 0
45 55 0
18 49 0
39 56 0
39 67 0
60 19 0
26 12 0
20 36 0

27 57 0
20 55 0
58 7 0
18 13 0
39 68 0
37 13 0
34 28 0
43 70 0
