width 75
height 75
.....@@@@@@@@@@@@@@@@@@@@@@@@@........@@@@@@@@@@@@@@@@@@@@@@@@@@@@@@@@@@@@@
....@@@@@@@@@@@@@@@@@@@@@@@@@@.......@@@@@@@@@@@@@@@@@@@@@@@@@@@@@@@@@@@@@@
.@..@@@@..@@@@@@@@@@@@@@@@@@@........@@@@@@@@@@@@@@@@@@@@@@@@@@@@@@@@@@@@@@
....@@...@@@@@@@@@@@@@@@@@@@.........@@@@@@@@@@@@@@@@@@@@@@@@@@@@@@@@@@@@@@
.........@@@@@@@@@@@@@@@@@@@........@@@@@@@@@@@@@@@@@@@@@@@@@@@@@@@@@@@@@@@
......@.@@@@@@@@@@@@@@@@@@@.........@@@@@@.@@@..@@@@@@@@@@@@@@@@@@@@@@@@@@@
.....@..@@@@@@@@@@@@@@...............@@@@...@@....@@@@@@@@@@@@@@@@@@@@@@@@@
.@....@@@@@@@@@@@@@@.........@..@.....@@@@........@@@@@@@@@@@@@@@@@@@@@@@@@
......@@@@@@@@@@@@@@..................@@@@@......@@@@@@@@@@@@@@@@@@@@@@@@@@
@.@.....@@@@@@@@@.@@.........@@@..@.@@@@@@@......@@@@@@@@@@@@@@@@@@@@@@@@@@
@.......@@@@@@@@@.@@..........@.......@@@@......@..@@@@@@.@@@@@@@@@@@@@@@@@
@@......@@@@@@@@@.............@.......@.....@@.......@@@@........@@@@@@@@@@
.@......@....@@@........@@....@@......@.....@@@..........@....@...@.@@@@@@@
........@...............@@.@...@......@.......................@...@.@@@@@@@
.....................@..@......@......@@........................@...@@@@@@@
.....@.....@.........@...............................................@@@@@@
..........@@....................@..@.....@......@....................@@@@@@
.....@@...@@.......@.....................@....@.@....................@@@@@@
.....@@......@...................@......................@.......@....@@@@@@
.....@@@@....@................@@............@...........@@...............@@
.......@@....@.....................@@@@.@.................................@
................@..................@...@@@..........@......................
............@...@......................@@....@.....@.........@............@
......@.@@..........@...........................@..........................
.........@..........@@..@@@.................@................@.............
..@.............@@@@@@@.@@@.....@@............@@..@@......@................
...............@@@@@@@@@@@@...@............@.@.@...@......@@......@@..@...@
............@@@@@@@@@@@@@@@...@.........................@@@.......@@@.....@
@............@@@@@@@@@@@@@@......@...@..................@@@........@@@....@
@............@@@@@@@@@@@@@......@@..........@@.........@@@@.@..@@..@@@....@
@@@@@@@......@@@@@@@@@@@@@.................@@@.........@@@@@@.......@@@....
@@@@@@@@......@@@@@@...@@@.................@@@@@......@..@@@..........@....
@@@@@@.@..........@@....@@....@.............@@@@......................@@...
@@@@@@............@@.....@@...........@.@...@@.....@................@@.@...
@@@@@@....@...@...@@....................@@...@.......@..............@......
...@@@............@............@@@.........................@...........@...
...@@@...........@...............@@...........@............................
...@@@@...............@.............................................@@@....
..@..........@............................@......@.......@@.........@@@@...
....@...@..............@@@@@......@@.@..@...@...@@........@.........@@@...@
..................................@...@@@....@@@@@.........................
@...........................@.........@@@@@...@@@@..............@...@@@@...
@..@@...@...................@.........@@@@@...@@...@................@@@@@@@
@..@@............@...............@..............................@....@@@@@@
......................................@................@.............@@@@@@
...............@...............@..@@@................@@@@............@@@@@@
..............................@@..@@@@...@......@@@@.@@@@@..........@@@@@@@
..@....@..@................@......@@..............@@@@@@@....@......@@@@@@@
..@...@@...............@@..........@..............@@@@@@@...@@...@@@@@@@@@@
...@@@@@..............@@@...@...@.....@@@.........@@.............@@@@@@@@@@
@@@@@@@@@@.............@@@@@@......@..@.....@@....@@.............@@@@@@@@@@
@@@@@@@@...............@@@@@@................@..@@@@......@.....@@@@@@@@@@@
@.@@........@@...@.......@@@....@.................@@.............@@@@@@@@@@
@.@@.......@@.........@...@@..........@@..........................@@@@@@@@@
@.........................@@...........@..@@......................@@@@@@@@@
............@...@...@@.....@..........@@...@..................@.@@@@@@@@@@@
...........@@.@@.....@................@......@...@............@@@@@@@@@@@@@
...@@@.@....@...........@@........................@@..@@.@...@@@@@@@@@@@@@@
...@.................@@................@...............@.@...@@@@@@@@@@@@@@
...................@@@@@@.....@@....@........................@@@@@@@@@@@@@@
.........@..........@@@@@.....@@....@...@@@....@......@......@@@@@@@@@@@@@@
........@.............@@................@@....................@@@@@@@@@@@@@
...@@.....@.............................@......@...............@@@@@@@@@@@@
...................................................@...........@@@@@@@@@@@@
...@..@........................@...............................@@@@@@@@@@@@
.@..@........@...@......@@@....@@..........@.................@@@@@@@@@@@@@@
@@..@@@@......@.@.....@@@@@....@@@...................@@...@.@@@@@@@@@@@@@@@
@@@.@@@@@@.........@..@@@@@.....@....................@@.....@@@@@@@@@@@@@@@
.@@....@@@.......@@@..@@@...@........................@.....@@@@@@@@@@@@@@@@
.......@.@......@@@@....@..@@.......@......................@@@@@@@@@@@@@@@@
.......@.@....@.@@@@.......@.................................@@@@@@@@@@@@@@
.......@........@@@@...@@..@@@............@.......@..........@@@@@@@@@@@@@@
..@@...................@@@@@@@@...........@@...................@@@@@@@@@@@@
@@@@@.@....@...........@@@@@@............@@@...........@.@@..@@@@@@@@@@@@@@
@@@@@....@....@@@......@@@@@@@...@@...........@....@@@@@.....@@@@@@@@@@@@@@
8
25 17 0
21 38 0
53 58 0
18 12 0
27 21 0
19 21 0
17 58 0
28 31 0

62 62 0
47 73 0
58 52 0
56 74 0
55 64 0
20 21 0
1 17 0
60 73 0
