width 75
height 75
@@@@@@@@@@@@@@@@@@@...@@@.....@@@@@@@@.....@.....@@@..@....@.......@@@@@@@@
@@@@@@@@@@@@@@@@@@...........@@@@@@@@@...........@@@...............@@@@@@@@
@@@@@@@@@@@@@@@@@@@.@@......@@@@@@@@.......................@......@@@@@@@@@
@@@@@@@@@@@@@@@@@@@@@@....@..@@@@@@@.......@@@...........@.@......@..@@@@@@
@@@@@@@@@@@@@@@@@@@@@@...@....@@@@@@@@...............................@@@@@@
@@@@@@@@@@@@@@@@@@@@@@@......@@@@@@@@@...............................@@@@@@
@@@@@@@@@@@@@@@@@@@@@@@......@@@@@@@@@.......................@........@@@@@
@@@@@@@@@@@@@@@@@@@@@@@......@@@@@@@........................@..........@@@@
@@@@@@@@@@@@@@@@@@@@@@@......@@..@@@.....................@@@@@..@..........
@@@@@@@@@@@@@@@@@@@@@@@@.........@@@..@........@.....@....@@@@..........@..
@@@@@@@@@@@@@@@@@@@@@@@@.....@...@.........@@.....@.........@@.........@@..
@@@@@@@@@@@@@@@@@@@@@@@@..@..@@.............................@..............
@@@@@@@@@@@@@@@@@@@..@....@........@....@.........@........................
@@@@@@@@@@@@@@@@@...............@@...........@...@.........................
@@@@@@@@@@@@@@@@@...............@.....@......@@@@......@.............@@@...
@@@@@@@@@@@@@@@@@@........@@...........@..@..@@...................@...@@@..
@@@@@@@@@@@@@@@@@@@@......@@@@@@@..@...............@@@@....@@......@@@@@@..
@@@@@@@@@@@@@@@@@@@@@@@...@@@@@@@........@........@@@@.............@@@@@@@@
@@@@@@@@@@@@@@@@@@@@@@@@..@@.......................@@@..........@...@@@@@@@
@@@@@@@@@@@@@@@@@@@@@@@@.@@@...............@.....@@@.................@@@@@@
@@@@@@@@@@@@@@@@@@@@@@..@@@@@....@...............@@@...................@@@@
@@@@@@@@@@@@@@@@@@@@@@.@@@@@@....@.@....@@........@@.................@@@@@@
@@@@@@@@@@@@@@@@@@@@@@..@@@@@@......@@............@..................@@@@@@
@@@@@@@@@@@@@@@@@@@@...@..................................@@............@@@
@@@@@@@@@@@@@@@@@@@@.............@........................@@@@.......@.@@@@
@@@@@@@@@@@@@@@@@@@@@..............................@............@@.@....@@@
@@@@@@@@@@@@@@@@@@@@@@@...........................................@.....@@@
@@@@@@@@@@@@@@@@@@....@....@...............@@........@....@@...@..@.....@@@
@@@@@@@@@@@@@@@@@@....@....@...............@@@@...........@...@@@.......@@@
@@@@@@@@@@@@@@@@@@.......................@.@@@@..@.............@...........
@@@@@@@@@@@@@@@@@@..@.......................@@@@............@..............
@@@@@@@@@@@@@@@@@@@@.......................@@@........@.....@..............
@@@@@@@@@@@@@@@@@@@@@@...................@@@@@................@............
@@@@@@@@@@@@@@@@@@@@@@.........@@@@.....@@@@@@.......................@@...@
@@@@@@@@@@@@@@@@@@@@@@@@@@................@@..........................@....
@@@@@@@@@@@@@@@@@@@@@@@@@@@..........@....@@...@.....................@@....
@@@@@@@@@@@@@@@@@@@@@@@@@@@..........@.........................@@.....@....
@@@@@@@@@@@@@@@@@@@@@@@@@@...@.@.....@.................@..............@....
@@@@@@@@@@@@@@@@@@@@@@@@@..@@...........................@@.................
@@@@@@@@@@@@@@@@@@@@@@@@@...........@@.....................................
@@@@@@@@@@@@@@@@@@@@@@@@...@............................................@@@
@@@@@@@@@@@@@@@@@@@@@@@............@............@@......@................@@
@@@@@@@@@@@@@@@@@@@@@@@..................@.....@@@@@....@@...............@@
@@@@@@@@@@@@@@@@@@@@@@@@@@............@....@.......@.@..@@@@@@@@@@.........
@@@@@@@@@@@@@@@@@@@@@@@@@..........................@.....@@@@@@@...........
@@@@@@@@@@@@@@@@@@@@@@@@@................................@@@@@@@....@@...@@
@@@@@@@@@@@@@@@@@@@@..............@@..@..@...............@@@@@@@.........@@
@@@@@@@@@@@@@@@@@@@..........@@@@.@@..@@.................@@@@@@.....@....@@
@@@@@@@@@@@@@@@@@@@.@........@@@@@@@...@.........@...@@..@@@@@@......@@@...
@@@@@@@@@@@@@@@@@@@@@@....@...@@@@@@......@.....@@@@@@@..@@@@@...@....@...@
@@@@@@@@@@@@@@@@@.............@@@@@@..@@.....@@@@@@@@@@@..@@..............@
@@@@@@@@@@@@@@.@@@............@@@@@@@@@@....@@@@@@@@@@@@...................
@@@@@@@@@@@........@@@........@@@@@@@@@@@@@..@@@@.@@@@@....................
@@@@@@@@@@..@......@@@........@@@@@@@@@@@@@........@@@..............@......
@@@@@@@@@..........@@...........@@@@@@@@@@@........@@.....@..........@.....
@@@@@@@@@...............@@.....@@@@@@@@@@@@@.......@@......................
@@@@@@@@...............@@@....@@@@@@@@@@@@@................................
@@@@@@@@....@.........@@@......@@@@@@@@@@@@....@@....@@.....@..............
@@@@@@@@@.............@@.......@.@@@@@@@@@.........@.@@........@..........@
@@@@@@@@@@@@@@..@.........@......@@@@@@@@..................................
@@@@@@@@@@@@@@..................@@@@@@@................................@@@@
@@@@@@@@@@@@@@.....................@@@.......@...@@................@......@
@@@@@@@@@@@@@@@..........@...@.....@.....@@..@@@.................@@@@......
@@@@@@@@@@@@@@......@@@.....@@...........@@@@@@@.......@........@@@@@@@@...
@@@@@@@@@@@@@@..@@...@@.....@@.@@..........@@@..................@@@@@@@@@.@
@@@@@@@@@@@@@@@@@@...@@@....@@@...@..@.......@.......@...........@@@@@@@@@@
@@@@@@@@@@@@@@@@.....@............@@@@@..........................@@@@@@@@@@
@@@@@@@@@@@@@@@@...@@@..............@@@@.......@..................@@@@@@@@@
@@@@@@@@@@@@@@@....@@@.............@@@@@@..........................@@@@@@@@
@@@@@@@@@@@@@@.....@@...........@....@@@@@................@@........@@@@@@@
@@@@@@.@@@@@@@.....@..................@..@@@............@@@@...@@@..@@@@@@@
@@@@@@.@.@@@.@....@.....@..................@......@.....@@@.......@@@@@@@@@
@@@@@@...........@......@....@.@@................@@......@........@@@@@@@@@
@@@@@@@@@..@....@@@@.........@@@@.................................@@@@@@@@@
@@@@@@@@@@.@.............@...@@@...@...@.............@@.....@......@@@@@@@@
8
71 61 0
40 13 0
20 55 0
26 38 0
21 23 0
41 15 0
25 27 0
74 53 0

26 72 0
39 13 0
57 19 0
66 51 0
62 9 0
16 72 0
53 33 0
23 31 0
