width 75
height 75
@@@@@@@@@@@@@@@@@@@@@@@@@@@@@@@@@@@@@@@@.......@@@@@....@@@@@@@@@@@@@@@@@@@
@@@@@@@@@@@@@@@@@@@@@@@@@@@@@@@@@@@@@@@@...@..@@@@@@....@@@..@@.@@@@@@@@@@@
@@@@@@@@@@@@@@@@@@@@@@@@@@@@@@@@@@@@@@@...@@..@@@@@@....@.@..@..@@@@@@@@@@@
@@@@@@@@@@@@@@@@@@@@@@@@@@@@@@@@@@@@@@........@@@@@@...............@@@@@@@@
@@@@@@@@@@@@@@@@@@@@@@@@@@@@@@@@@@............@@@.@@.....@...@@@...@@@@@@@@
@@@@@@@@@@@@@@@@@@@@@@@@@@@@@@@@@@...........................@@@......@@@@@
@@@@@@@@@@@@@@@@@@@@@@@@@@@@@@@@@..........@...@...@@@@@..................@
@@@@@@@@@@@@@@@@@@@@@@@@@@@@@@@....................@@@@@...................
@@@@@@@@@@@@@@@@@@@@@@@@@@@@@@@@@@..................@@@@...........@.@@....
@@@@@@@@@@@@@@@@@@@@@@@@@@@@@@@@@@@.@@........@..@@.......................@
@@@@@@@@@@@@@@@@@@@@@@@@@@@@@@@@@@@@@@...........................@@.......@
@@@@@@@@@@@@@@@@@@@@...@@@@@@@@@@@@@@...@....@@........@.........@@.......@
@@@@@@@@@@@@@@@@@@@@........@@@@.@@@@.....@.@.................@..@.........
@@@@@@@@@@@@@@@@@@@@@@@@....@@@....@...@...........@.............@.......@@
@@@@@@@@@@@@@@@@@@@@@@...@.............@..........................@......@@
@@@@@@@@@@@@@@@@@@@@@@..@@@@@.@@.................@@..............@@.....@@@
@@@@@@@@@@@@@@@@@@@@@@@..@@@@@@@.....................@@@..@......@@.@....@@
@@@@@@@@@@@@@@@@@@@@@@@.@@..@@@@...@......@@@@......@@..............@......
@@@@@@@@@@@@@@@@@@@@@........@@.........@@@@@@......@.................@...@
@@..@@@@@@@@@@@@@@@.@.........@..@@....@@@@@@@..................@@..@......
@@@.@@@@@@@@@@@@@@@...........@@.......@@@@@........@@.....................
@@@......@@@@@@@@@@@....@@..@...........@@@@......@.@@@......@@............
@@.......@.@@@@@.........@@..................................@@............
@@@.........@@@.......@....................................@@@@............
@@@.........@@@.................@................@...@.....@@@@@...........
@@@..@@.........................@.........@.....@@...@........@....@.......
@@@..@@.@.........@@.................................@@....................
@@@@.........@...@..@.........@....@...@.........@.........................
@@@@.........@....@.............@..@@@@@.@...............@...............@@
@@@@...............................@@@@@.......@@@.....@.@......@........@@
@@@@@............@....................@@.....@@@@@@......@......@@.@@@@...@
@@@@@@@...................@@..........@......@@@@@@@@@..@@......@@..@@@...@
@@@@@@@..................@...................@@@@@@@@@@@@@.@@..@@@..@@....@
@@@@@@@...@@@@@..................@......@....@@@@@@.@@......@..@@@.......@@
@@@@@@@....@@@@...@..@@.........@@..........@@@@@...@@.......@@@@@.......@@
@@@@@.@....@@@@...@..........@@.@@@.........@@@@@.............@@@........@@
@@@....@@...@@.........@.....@@.@@.........@@@@@@..........@@.@@..........@
@............................@..@@.........@@@.............@@@@@@.......@@@
@@....@@@.......@@@....@......................@@.@@@.......@@@@@@.......@@@
@@....@@@......@@@@@@.........................@...@@...........@@.......@@@
@@..@@@@@......@@@@@@.........................@.........@....@..@@.........
@@...@@@@@@..@.@@@@...........@@...@@...@.........@..@..........@@.........
@@..@@@@@@@.....@@@......@@@......@@.....@.@.....................@.........
@@....@@@@..@....@@....@..@@.......@........@@@.@...........@......@.......
........@@......@@........@@@@@....@........@@@...................@@...@@..
.........................@@.@..........@......@......@......@.....@@@@@@...
@.....@.....................@...@@@@.........@@@@................@@@@@@....
@.....@........................@@@@@@@..@....@@@..@..............@@...@@..@
@...........@@@@@@.....@.......@@@@@.......@.@@@.@...@@@.....@...@@......@@
....@..@....@@@@@@@..@@......@@@@@@@@........@@@.....@@@@.@@.@...........@.
@@@@.......@@@@@@@@@@@@@@@..@@@@@@@@@................@@@@@@@...............
@@@@.......@@@@@@@@@@@@@@@@@@@@@@@@@........@........@@@@@@@@..............
@@@@.....@@@@@@@@@@@@@@@@@@@@@@@@@@@....@...............@@.................
@@@@.@@@@@@@@@@@@@@@@@@@@@@@@@@@@@@@@...................@@..@..@@..........
@@@@@@@@@@@@@@@@@@@@@@@@@@@@@@@@@@@@@@..@................@..@..@...@......@
@@@@@@@@@@@@@@@@@@@@@@@@@@@@@@@@@@@@@@.............@.......@......@@@.....@
@@@@@@@@@@@@@@@@@@@@@@@@@@@@@@@@@@@@@@@.........@......@..........@@@@..@@@
@@@@@@@@@@@@@@@@@@@@@@@@@@@@@@@@@@@@@@@...............@@..........@@@@@@@@@
@@@@@@@@@@@@@@@@@@@@@@@@@@@@@@@@@@@@@@@@............@@@@..........@@.@@@@@@
@@@@@@@@@@@@@@@@@@@@@@@@@@@@@@@@@@@@@@@@....................@@@......@.@@@@
@@@@@@@@@@@@@@@@@@@@@@@@@@@@@@@@@@@@@@@@@@................@@@@....@.....@@@
@@@@@@@@@@@@@@@@@@@@@@@@@@@@@@@@@@@@@@@@@@.....@..................@.......@
@@@@@@@@@@@@@@@@@@@@@@@@@@@@@@@@@@@@@@@@@@.......................@.......@@
@@@@@@@@@@@@@@@@@@@@@@@@@@@@@@@@@@@.@@@@@@.................@............@@@
@@@@@@@@@@@@@@@@@@@@@@@@@@@@@@@@@@...@.@@.........@....................@@@@
@@@@@@@@@@@@@@@@@@@@@@@@@@@@@@@@@@.@@@.................@..@.........@@.@@@@
@@@@@@@@@@@@@@@@@@@@@@@@@@@@@@@@@@..@@.@...............@............@@.@@@@
@@@@@@@@@@@@@@@@@@@@@@@@@@@@@@@@@@..@@............................@@@@.@.@@
@@@@@@@@@@@@@@@@@@@@@@@@@@@@@@@@@@..@@@................@.........@@@@@@@...
@@@@@@@@@@@@@@@@@@@@@@@@@@@@@@@@@@...@@...............@@..........@@@@@@...
@@@@@@@@@@@@@@@@@@@@@@@@@@@@@@@@@.....@.......@.......@@......@@@...@@@@...
@@@@@@@@@@@@@@@@@@@@@@@@@@@@@@@@@.......@....................@@@@@......@.@
@@@@@@@@@@@@@@@@@@@@@@@@@@@@@@@@@@@...@........@@........@@..@@@@@.........
@@@@@@@@@@@@@@@@@@@@@@@@@@@@@@@@@@@........@@............@......@@@........
@@@@@@@@@@@@@@@@@@@@@@@@@@@@@@@@@@@.......@@@@@@....@@...@...@@@@@@........
8
43 44 0
11 38 0
10 24 0
45 16 0
39 33 0
42 65 0
44 2 0
29 28 0

48 64 0
8 33 0
39 17 0
54 67 0
41 40 0
47 54 0
53 10 0
66 71 0
