width 49
height 49
@@@@@@.@@@@@..@.@@@.@@@@@.......@@...@@@@@@@@@@@@
@@@@@@...@..........@@@@@@...........@@@@@@@@@@@@
.@@@@...@.......@...@@@@@@...@@.......@@@@@@@@@@@
....@.........@...@.@@@@@@.......@....@@@@@@@@@@@
...@@...............@@...........@....@@@@..@@@@@
....@@...@..........@...@@.....@.@....@@@...@@@@@
....................@....@..........@@@@@...@@@@@
....................@.....@@@@......@@@@@....@@@@
............................@@.@...@@@.@@@....@..
.........................@...@....@@@..@@@.......
.@................................@..............
@.................................@...@..........
..................................@.@@@@.........
@@..@.@@.............................@..@........
@@..@@@...................@@.........@...........
@@@@@@........@.@..........@....................@
@@@@@...@..@@@.................@........@@......@
@@@@@.......@@@..@......@.......@@.@.....@......@
@@.@@..@@@@@@@......@..............@.............
.@.@@..@@@@.@@........................@........@@
.......@@@@.....@..............................@@
........@@@....@@@@............@@..............@@
........@@@....@..@..........@......@............
........@@@.........@.......@@@@....@............
..........@@....@@.@.......@@@@@@@@@.............
@..........@...@@@.........@@@@@@@@..@@@...@....@
@.........@....@@@........@@@@@@........@.@@@@..@
@@.......@@.@@@@@........@@@@@@.........@@@.@@@@@
@@...@.@.....@@@..........@.@....@...@.......@@@@
@@@..@.........@.........@@..........@..@.....@@@
@@@......@............@..@@...................@@@
@@@......@.....@..........@@.................@@..
@@@.....@@@......@@@@...@......@.@@..........@@..
@@@@.....@@@........@....................@...@...
@@@@.....@@@@......@....@...........@....@@......
@@@@...@........@......@@.@@@.......@@......@....
@......@....@......@......@@@@......@@..........@
@@.....@....@......@....@.@@@@@@@...@@...........
@...........@...........@@@@@@@@@................
@.......................@@@@@@@@@............@...
@...............@........@@@@@@@@@...............
@........................@@@@@@@@@...............
@............@......@....@@@@@@@@@.@.............
@@...........@.....@@@@....@@@@@@@@@.............
@@...@.............@@@....@.@@@@@@@@..........@..
@@..............@@@@@@@.....@.@.@@@@.@...........
.........@......@@@@@@@.........@@@@.............
...................@@@...@......@@@.............@
@@................@@@@@@@@@.....@@@.............@
8
32 28 0
16 34 0
45 43 0
47 12 0
22 21 0
30 10 0
25 8 0
41 5 0

5 13 0
32 6 0
38 33 0
11 48 0
26 22 0
31 10 0
33 20 0
46 18 0
