width 49
height 49
@@@@@@@@@@@@@....................@@@.........@@@@
@@@@@@@@@@@@@@@......@............@..........@@@@
@@@@@@@@@@@@@@@@...@..........................@@.
@@@@@@@@@@@@@@@@.........................@....@..
@@@@@@@@@@@@@@...................................
@@@@@@@@@@@@@..................@........@........
@@@@@@@@@@@@@.....................@.....@........
@@@@@@@@@@@@@.......@......@@.....@@.............
@@@@@@@@@@@@@...............@@@@.................
@@@@@@@@@@@@@..........@@...@@@@@@...............
@..@@@@@@@@@@@........@@@@..@@@@@@...............
@..@@@@@@@@@@.......@@@@@@@@@@@@@....@......@....
...@@@@@@@@@...@....@@@@@@@@@@@@@.@.............@
...@@@@@@@@@.@......@@@@@@@@@@@........@@.@@..@@@
.....@@@@@@@......@@@@@@@@@@@@@................@@
.....@@@@.@@......@@@@...@@@@@@.............@..@@
@......@...........@@@@@..@@....@........@@@@@@@@
@...................@@@@...@@..@.........@@@@@@@@
@@...................@.@..@@...@@........@@@@@@@@
@@....@........................@@........@@@@@.@@
@@@...........................@@..........@@....@
@@@..@........................@@@...............@
@@@@.@......@...........@......@.................
@@@@@@......@...........@.......................@
@@@@@......................@...................@@
@@@@@.........................@@@..@.....@.....@@
@@@@@....@@@..................@@........@@.....@@
@@@@@...@.......@...@.........@@..........@....@@
@@@@@.......................@...........@...@@@@@
@@@@@.........@...@....@@...@..............@@@@@@
@@@@@@@...@.@.....@@....@......@..........@.@@@@@
@@@@@@@.......................@@..........@...@@@
@@@@@@@............@......................@...@@.
@@@@@@@.....@.................@...............@..
@@@@@@@.......@...........@@..@@@.....@..........
@@@@@@@@@.....@..@@...........@@.................
@@@@@@@@@...@@@..@...@...@...@@@...............@.
@@@@@@@@@@@@@@@......@.@@@@..@@@........@@.@.....
@@@@@@@@@@@@@@@........@@@@..@@.............@....
@@@@@@@@@@@@@@......@@...@....@..................
@@@@@@@@@@@@@@......@.....................@@.....
@@@@@@@@@@@@@@..........@................@@@....@
@@@@@@@@@@@@@@...@.....@@@..............@@@@..@@@
@@@@@@@@@@@@@@@@......@@@@@............@@@@...@@@
@@@@@@@@@@@@@@@@....@@@@@@@...............@@@@@@@
@@@@@@@@@@@@@@@@.....@@@@@@................@@@@@@
@@@@@@@@@@@@@@@....@@@@@@@@..............@@@@@@@@
@@@@@@@@@@@@@@......@@@@@@@........@..@@@@@@@@@@@
@@@@@@@@@@@@@@@.....@@@@@@@......@@@@.@@@@@@@@@@@
8
19 47 0
32 7 0
18 40 0
38 24 0
36 6 0
32 37 0
45 40 0
17 28 0

36 0 0
7 27 0
15 15 0
37 23 0
37 1 0
0 15 0
16 24 0
17 28 0
