width 73
height 73
@@@@@@@@@@@@@@@@@@@@@@@@@........@@..................@@@@@@@@@@@@@......@
@@@@@@@@@@@@@@@@@@@@@@@......@...@..................@@@@@@@@@@@@@@.......
@@@@@@@@@@@@@@@@@@@@@@@.@@..........................@@.@@@@@@@@@@@......@
@@@@@@@@@@@@@@@@@@@@@@@@@@@............................@@@@@@@@@@@.....@@
@@@@@@@@@@@@@@@@@@@@@@@@@@@........@...................@@@@@@@@@@.....@@@
@@@@@@@@@@@@@@@@@@@@@@@@@@...@@....@@@.................@@@............@@@
@@@@@@@@@@@@@@@@@@@@@@@@@@@@@@@@@.@@@@.................@@@....@.......@@@
@@@@@@@@@@@@@@@@@@@@@@@@@@@@@@@@@@@@@....@.............@@@............@@@
@@@@@@@@@@@@@@@@@@@@@@@@@@@@@@@@@@@@@...............@@@@@@.......@....@@@
@@@@@@@@@@@@@@@@@@@@@@@@@@@@@@@@@@@@@.................@@@..........@...@@
@@@@@@@@@@@@@@@@@@@@@@@@@@@@@@@@@@@@..................@@@.............@@@
@@@@@@@@@@@@@@@@@@@@@@@@@@@@@@@@@.........@...........@@@.............@@@
@@@@@@@@@@@@@@@@@@..@@@@@@@@@@@@@......................@@.............@@@
@@@@@@@@@@@@@@......@@@@@@@@@@@@@@@......@................@...........@@@
@@@@@@@@@@@@@@......@@@...@@@@@@@@...........@...........@...........@@@@
@@@@@@@@@@@@@@.......@@...@@@.@@@........................@@@.........@@@@
@@@@@@@@@@@@@.............@@..@@.....@@.........................@.@...@@@
@@@@@@@@@@@@@.................@@................@@..............@.....@@@
@@@@@@@@@@@@@...@@@@@................@..@...@@.@@@@.@@.........@@...@@@@@
@@@@@@@@@@@@@...@@@@@.@.......@........@.......................@@..@@@@@@
@@@@@@@@@@@.....@.............@@.......@....@.........................@@@
@@@@@@@@@@@@............@...............@.........@..................@@@@
@@@@@@@@@@@@@.....@@....@.....@.........@............................@@@@
@@@@@@@@@@@@@@@@@.@....@@.............@.@...........@........@@......@@@@
@@@@@@@@@@@@@@@@@@@.....@.....................@................@@....@@@@
@@@@@@@@@@@@@@@@@@@...@..................@@...@@@.............@@@@@..@@@@
@@@@@@@@@@@@@@@@@.....@.................@@@.....@........@@......@@@@@@@@
@@@@@@@@@@@@@@@@@......................@@@@.....@...@............@@@@@@@@
@@@@@@@@@@@@@@@@@@@...@........@.......@@@@@.....................@@@@@@@@
@@@@@@@@@@@@@@@@@@@@...............@......@@@@@@.................@@@@@@@@
@@@@@@@@@@@@@@@@@@@@@...............@@...@.@.............@......@@@@@@@@@
@@@@@@@@@@@@@@@@@@@@@@@@.............@........@......@....@@.........@@@@
@@@@@@@@@@@@@@@@@@@@@@@@.....@.................@@.@@@@@.@............@@@@
@@@@@@@@@@@@@@@@@@@@@@@@@...................@.....@@@@@.@.@@.......@..@@@
@@@@@@@@@@@@@@@@@@@@@@@@@...........................@@@@@@@@............@
@@@@@@@@@@@@@@@@@@@@@@@@@.........@@.......@@.......@@@@@@@@.............
@@@@@@@@@@@@@@@@....@@@@@..........@...@.@..........@@@@@@@@...@.........
@@@@@@@@@@@@@@@@@...@@@@@@..@.....@...............@@@@@@@@@..@.......@...
@@@@@@@@@@@@@@@.@...@@@@@@@@@...............@@@....@@@@@@@@@@.....@......
@@@@@@@@@@@@@.......@@@@@@@@@.....@@........@........@@@@@@@....@........
@@@@@@@@@@@@@.......@@@@@@@@@@....@@..................@@@@@@@.........@@.
@@@@@@@@@@@@........@@@@@@@@@@.....................@.@@@@@@@@........@@@@
@@@@@@@@@@@..........@@@@@@@@@....@@.....@............@@@...........@@@@@
@@@@@@@@@@@..........@@@@@@@@@@@...@@.................@...............@..
@@@@@@@@@.@.......@@..@@@@@@@@@@............@@....@...@....@@@...........
@@@@@@@@@.............@@@@.@@@@@@@....@......@@............@@............
@@@@@@@................@@@.@@@@@@@....@...@..@@..........................
@@@@@@@..............@@@@..@@@@@@@@...@..@@....@@.@@@..................@@
@@@@@@@........@........@.....@.@.....@..@@....@@.@@@.......@.......@.@@@
@@@@@@@........@...........@@.........@...@....@@....@..............@@@@@
@@@@@@@.............@..@@..@@................@@@@...................@@@@@
@@@@@@@.@@.........@@.@@@..@.......@.@.......@@.@......................@@
@@@@@@@@@..@@.........@@...@.......@.@.............@.......@.......@....@
@@@@@@@@@...................@............@.............@.................
@@@@@..@@..@@......@........@...@........@......................@......@.
@@@@@.....@@.....@.............@@..............@.....@.................@.
@@@@@.....@@...@.@..@...........@@.@................@.@............@@....
@@@@.......@.....@..@....................@.....@......@............@@.@..
@@@@@.....@@......................................@.....@@@@@.........@..
@@@@@@.....@.....@.................@....@.........@.@...@@@@@.........@@@
@@@@@@...@............@....@.............................@@@@........@@@@
@@@@@@@.......@@........@....@...................................@@..@@@@
@@@@@@.@...............@@....@...........@@.@@@@@....@...............@@@@
@@@@@@.@............@..@@@...@...........@@.@@.......@............@@@@@@@
@@@@@..............@@@@@@................@@....................@..@@@@@@@
@@@@@@@............@@@@@@@..................@@...@........@...@@@..@@@@@@
@@@@@@@@@@..@.@@@@@@@@..........@..@......@.@@.....................@@@@@@
@@@@@@@@@..@@.@@@@@@@@..@@@@.@@@@@@@.........@@@@..............@...@@@@@@
@@@@@@@@@@@@@@@@@@@@@@@@@@@@@@@@@@@@@........@@@@..........@@..@....@@@@@
@@@@@@@@@@@@@@@@@@@@@@@@@@@@@@@@@@@@........................@@......@@@@@
@@@@@@@@@@@@@@@@@@@@@@@@@@@@@@@@@@@...@@....@@@@@@..................@@@@@
@@@@@@@@@@@@@@@@@@@@@@@@@@@@@@@@@@@@@@@@...@@@@.................@.....@@@
@@@@@@@@@@@@@@@@@@@@@@@@@@@@@@@@@@@@@@@@@@@@@@..................@......@@
8
45 57 0
35 57 0
25 53 0
41 61 0
43 62 0
63 10 0
63 56 0
60 27 0

30 27 0
67 0 0
49 1 0
63 43 0
40 70 0
34 56 0
37 21 0
30 64 0
