width 73
height 73
.....@...@..@@@@@@@.......@...@@....@@@@@@@@@@@@@@@@@@@@@@@@@@@@@@@@@@@@@
..@..@@.....@@@@@@....................@@@@@@@@@@@@@@@@@@@@@@@@@@@@@@@@@@@
@.....@......@@@@.........@@@@@......@@@@@@@@@@@@..@@@@@@@@@@@@@@@@@@@@@@
@@............@.@.@.@.....@@@........@@@...@@@.@@.@@@@@@@@@@@@@@@@@@@@@@@
@@.................@@...............@@............@@@@@@@@@@@@@@@@@@@@@@@
.........@...@.......@@@.............@...........@@@@@@@@@@@@@@@@@@@@@@@@
.........@..@@.......@...@................@......@@@@@@@@@@@@@@@@@@@@@@@@
.........@@@@@.......@......................@....@@@@@@@@@@@@@@@@@@@@@@@@
.........@@@@........................@..@..@@....@..@@@@@@@@@@@@@@@@@@@@@
........@@@@@@.........@....@@@..@@.@...@@@@.....@..@@@@@@@@@@@@@@@@@@@@@
..@.@@@@@@@@@..............@@@@........@@@@@........@@@@@@@@@@@@@@@@@@@@@
..@...@@@@@@@.....................@..@@@.@@@@......@@@@@@@@@@@@@@@@@@@@@@
......@@@@@@....@@.......@................@@@.....@@@@@@@@@@@@@@@@@@@@@@@
.......@@@.......@....@.......@.@..@........@.....@@@@@@@@@@@@@@@@@@@@@@@
....@@.@@@..........@@..........@@........@.......@@@@@@@@@@@@@@@@@@@@@@@
....................@@@.........@@...............@@@@@@@@@@@@@@@@@@@@@@@@
....................@@@.........@@...............@@@@@@@@@@@@@@@@@@@@@@@@
......@@.......@...@@@..........@@..@............@@@@@@@@@@@@@@@@@@@@@@@@
@@@@........@.....@@@@......@.........@..@@.....@@@@@@@@@@@@@@@@@@@@@@@@@
@@@@@....@...@.@...@@@@.......@............@@..@@@@@@@@@@@@@@@@@@@@@@@@@@
@@@@@...@@...@........@..@..@.......@..........@@@@@@@@@@@@@@@@@@@@@@@@@@
@@@@@@@@@@@...........@....@@@...............@@@@@@@@@@@@@@@@@@@@@@@@@@@@
@@@@@@@@@@......@....................@......@@@@@@@@@@@@@@@@@@@@@@@@@@@@@
@@@@@@@@@............................@@....@@@@@@@@@@@@@@@@@@@@@@@@@@@@@@
@@@@@@@@.@..........................@@@.@@@@@@@@@@@@@@@@@@@@@@@@@@@@@@@@@
@@@@@@.........@@..........@.@@@...@@@@@@@@@@@@@@@@@@@@@@@@@@@@@@@@@@@@@@
@@@@@@.@@.....................@@@.@@@@@@@@@@@@@@@@@@@@@@@@@@@@@@@@@@@@@@@
@@@@@@.@.....@@.....@..........@@@@@@@@@@@@@@@@@@@@@@@@@@@@@@@@@@@@@@@@@@
@@@@@.........@@@@..@......@..........@@@..@@@@@@@@@@@@@@@@@@@@@@@@@@@@@@
@@...............@....................@@@...@@@@@@@@@@@@@@@@@@@@@@@@@@@@@
..........................................@..@@@@@@@@@@@@@@@@@@@@@@@@@@@@
@@.............@.....@....................@@@@@@@@@@@@@@@@@@@@@@@@@@@@@@@
...@.................@@....@.......@.@@.@@@@@@@@@@@@@@@@@@@@@@@@@@@@@@@@@
..................@@@@@@@...@@.....@....@@@@@@@@@@@@@@@@@@@@@@@@@@@@@@@@@
....................@@@@@@..@......@....@..@@@@@@@@@@@@@@@@@@@@@@@@@@@@@@
....@.......@...@@...@@@.@.........@.......@@@@@@@@@@@@@@@@@@@@@@@@@@@@@@
................@........@...@@...@@@.@@..@@@@@@@@@@@@@@@@@@@@@@@@@@@@@@@
...................................@..@@@@@@@@@@@@@@@@@@@@@@@@@@@@@@@@@@@
......................................@@@@@@@@@@@@@@@@@@@@@@@@@@@@@@@@@@@
........@........@.@...................@@@@@@@@@@@@@@@@@@@@@@@@@@@@@@@@@@
.@......@@...@...........@..............@@..@@@@@@@@@@@@@@@@@@@@@@@@@@@@@
......@.................@@..............@@...@@@@@@@@@@@@@@@@@@@@@@@@@@@@
.............@......@@@..@..@@.........@@.....@@@@@@@@@@@@@@@@@@@@@@@@@@@
......@@...........@@@@..........@@............@@@@@@@@@@@@@@@@@@@@@@@@@@
@@..........@.......@@@..........@.............@@@@@@@@@@@@@@@@@@@@@@@@@@
@@...@@..@..@.......@@@@...@..............@....@@@@@@@@@@@@@@@@@@@@@@@@@@
@@....@..@.@...........@@.@@..................@@@@@@@@@@@@@@@@@@@@@@@@@@@
@@@@.@........@@.......@@@@@..@@@@......@.....@@@@@@@@@@@@@@@@@@@@@@@@@@@
@@@............@.......@@@@@.......@......@...@........@@@@@@@@@@@@@@@@@@
..@....................@@@@@....@@@@......@.............@@@@@@@@@@@@@@@@@
...........@............@@@.....@@@@.................@@@@@@@@@@@@@@@@@@@@
........................@@@@.....@...................@@@@@@@@@@@@@@@@@@@@
@...........@........@@.@@@......@...................@@@@@@@@@@@@@@@@@@@@
@...........@.........@..........@..........@........@@@@@@@@@@@@@@@@@@@@
......................@@.........................@.@@@@@@@@@@@@@@@@@@@@@@
........@@@..@.................@.......@.......@@@@@@@@@@@@@@@@@@@@@@@@@@
........@......................@@......@.....@..@@@@@@@@@@@@@@@@@@@@@@@@@
........@...........@..........@@....@@@.........@@@@@@@@@@@@@@@@@@@@@@@@
........@.....@@....@....@.......................@@@@@@@@@@@@@@@@@@@@@@@@
........@..@........@..@@@...@...........@......@@@@@@@@@@@@@@@@@@@@@@@@@
........@................................@@@@.@.@.@@@@@@@@@@@@@@@@@@@@@@@
...........@......................@@.....@@@......@@@@@@@@@@@@@@@@@@@@@@@
...@@@@....@......................@@@@........@....@@@@@@@@@@@@@@@@@@@@@@
...@@...........@..........@@@...@@@@......@......@@@@@@@@@@@@@@@@@@@@@@@
..@......@@....@@..........@@....@@@@@.@@..........@@@@@@@@@@@@@@@@@@@@@@
..............@@@................@@@......@.........@@@@@@@@@@@@@@@@@@@@@
.................................@@....@....@....@...@@@@@@@@@@@@@@@@@@@@
....................@.@.......@..@...................@@@@@@@@@@@@@@@@@@@@
.@@....@............@............@......@.....@......@@@@@@@@@@@@@@@@@@@@
@@.....@.@.@@@@@....@........@@.........@............@@@@@@@@@@@@@@@@@@@@
@@@@....@@.@@@@@@@@........@.@@.............@@....@@@@@@@@@@@@@@@@@@@@@@@
@@@.....@@.@@@@@@@@@@........@@...@...........@@@@@@@@@@@@@@@@@@@@@@@@@@@
@@@@@@.@@@...@@@@@@@@........@@..........@....@@@@@@@@@@@@@@@@@@@@@@@@@@@
8
22 39 0
3 68 0
22 55 0
6 48 0
48 57 0
24 10 0
19 7 0
33 31 0

19 10 0
46 8 0
41 65 0
46 70 0
44 55 0
5 69 0
30 31 0
44 68 0
