width 73
height 73
@@@@@@@@@@@@@@@@@@@@@@@@@@@@@@@@@@@@@@@@@@@@@..............@@@@@@@@@@@@@@
@@@@@@@@@@@@@@@@@@@@@@@@@@@@@@@@@@@@@@@@@@@@@.............@@@@@@@@@@@@@@@
@@@@@@@@@@...@@@@@@@@@@@@@@@@@@@@@@@@@@@@@@@@@....@........@@@@@@@@@@@@@@
@@@@@@@@@@...@@@@@@@@@@@@@@@@@@@@@@@@@@@@@@@@@@@...........@@@@@@@@@@@@@@
@@@@@@@@@@...@@@@@@@@@@@@@@@@@@@@@@@@@@@@@@@@@.......@.....@@@@@@@@@@@@@@
@@@@@@@@@@.@.@@@@@@@@@@@@@@@@@@@@@@@@@@@@@@@@@...............@@@@@@@@@@@@
.@@@.@@@..........@@@@@@@@@@@@@@@@@@@@@@@@@@@@@.............@@@@@@@@@@@@.
..................@@@@@@@@@@@@@@@.@@@@@.@@@@@@@@.....@..@@.@@@@@@@@@@@@..
.................@@@@@@@@@@@@@@....@@@..@@@@@@@@@.@...@.@@...............
.............@....@.@@@@@@@@@@@.........@@@@@@@@@.@.........@............
....................@@@@@@...@@@...@@...@@@@@@..............@..@@.......@
....@@.........@......@@@@.............@@@@@@@.......@@....@@@@@@@.......
........@..............@@@.............@@@@@@........@@......@@@@@@@@@...
........@............@@@@@@@.........@.@@@@@@@@....................@@..@@
..@.....@..............@@@@@..@@.....@@@@@@@@@@@....@..............@@..@@
....@@@@@..............@@@@@.........@..@@@@@@.......@..............@....
..................@......@@..........@..@@@@@.......................@....
........@.@@....@........@@..............................@@.........@....
........@@............@..@@@@.........@.........@........@@@....@..@@....
........@.....................@................@@........@@@.............
..........................................@@.........@....@@....@......@@
......@..........@@..@.@@........@...@....@@....................@.....@@@
......@..@...........@@@@........@........@@@...........@.@............@@
@.....@@...@..........@@@...............@..@@...........@.@...........@@@
@@@@..@@...............@@...................@.....@......@@............@@
@............@.........@@.........@...@@....@.@@........................@
..................@@......................@@@..@.@...........@@.........@
@@................@@@@...............@...........@......................@
@................@..@@.......@...@...................@..@...............@
@...........@....@..............@@..@..............@@@..@.............@@@
@.............................@.....................@@@@@...@....@....@@@
@..@.........@.....@.....@@@.............@..........@...@......@@@......@
@@@@@........@@@...@.......@...................................@@@.....@@
@@@@..@...@@@@@............................@@...@@..........@@@@@@@...@@@
...........@@@@......................@....@...........@.....@@@@@@@...@@@
............@@............@..@.....................@........@@@@@@......@
@.@....@..............@......@.@........................@...@@@@@@@.....@
@@@@..................@@...................................@@@@@@.@....@@
@@@@@.@......................@@..............@.............@@@........@@@
@@@@@......................@.@@........@.....@........@...@@.....@....@@@
@@@@@@@@......................@@.................................@....@@@
@.....@.......................@@@@@@@..................@@............@@@@
@.............@........@........@@@@@@@....@@....@....@@@..@@.......@@@@@
...@............@....@@.....@...@@@@..@.........@@..........@......@@@@@@
.@@@...........@@@@..@@....@......@@@..................@...........@@@@@@
.@@@...@.......@@@@...@...@.......@@@...@@@.........@........@....@@@@@@@
................@@.................@@@.............................@@@@@@
................@@....@.@.................@@@.................@....@@@@@@
.............@..........................@@..@..@..............@.....@@@@@
....@@.....@...........@@.........@@@@@......................@@.......@@@
....@@@@...............@@.@.........@@.......................@........@@@
@@...@@@....@@..........@.................@@@......@........@........@@@@
.....@@@......@........@@...@@@....@.@....@@@@@...@......................
................@...@@.....@@@@@........@@@@@@@@.@@@......@..............
............................@@@@..........@@@@@....@@.....@@@............
......@...........@...@......@@..........@@@........@@....@@@@...........
..........@..@@@@.......@.....@..........@@.........@@....@@@...@@.......
@..............@@@@.@@...@..............@@@..........@...@@@@...@@@......
....@.........@@@@@@....@........@..............................@@@@.....
..@...........@..@@@@.@..@.............@@........................@@@.....
..........@...@....@@@@..............@.@.........@.@@@....@.@......@@...@
....................@@@......@..@...@..............@..............@@.....
....@@@.....@.......@.@@.....@.................................@.........
.....@......@@......@........@..........@.............@..@@..........@...
@@@...........................@....@....@.........................@......
@@@@@@@..@...................@@...@@@@@@@.....@......@........@@@........
@@@@@@@@@@@@........@..@........@@@..@@@......@.....@@........@@@@..@....
@@@@@@@@@@@@........@..@.@.......@@..@@@............@@.........@...@.....
@@@@@@@@@@@@@.....@..............@@.....@........@........@.@............
@@@@@@@@@@@@@....@.....@...@@................@...@..........@............
@@@@@@@@@@@@@.......@@@.............@..........@.@.........@@..@@@@......
@@@@@@@@@@@@@.@@...@@@@@.................@.......@.......@.....@@@@@@.@@@
@@@@@@@@@@@@@.@@..@@@@@@..............@.......@@@........@..@@.@@@@@@@@@@
8
17 72 0
35 16 0
9 38 0
14 20 0
69 58 0
55 0 0
10 52 0
21 24 0

1 54 0
41 67 0
48 20 0
19 42 0
68 54 0
54 71 0
45 37 0
53 41 0
