width 73
height 73
@@@@@@@@@@@@@@@@@@.......@@@@@@@@@@...@..@@@@@@@@@@@@@@@@@@@@@@@@@@@@@@@@
@@@@@@@@@@@@@@@@@@.......@@@@@@@.........@@@@@@@...@@@@@@@@@@@@@@@@@@@@@@
@@@@@@@@@@@@@@@@@@..@@...............@.@@@@@@@@@@..@@@@@@@@@@@@@@@@@@@@@@
@@@@@@@@@@@@@@@@@@.....@...............@@@@@@@@.....@@@@@@@@@@@@@@@@@@@@@
@@@@@@@@@@@@@@@@@...@........@@........@@@@@@@@@...@@@@@@@@@@@@@@@@@@@@@@
@@@@@@@@@@@@@@..............@@@.........@@@....@....@@@@@@@@@@@@@@@@@@@@@
@@@@@@@@@@@.............@.@.........................@@@@@@@@@@@@@@@@@@@@@
@@@@@@@@@@@@....@....@..@...........................@@@@@@@@@@@@@@@@@@@@@
@@@@@@@@@..@.........@......@................@.@@@@....@@@@@@@@@@@@@@@@@@
@@@@@@@@@.......@@@@........@............@..@@@@@@@....@@@@@@@@@@@@@@@@@@
@@@@@@@@........@@@......................@..@@@@@@@....@@@@@@@@@@@@@@@@@@
@@@............@@@@....@@.......@...........@@@@@@.....@@@@@@@@@@@@@@@@@@
@@@@........@....@@.....@.@..................@@@@@@.....@@@@@@@@@@@@@@@@@
@@@@@@......@..........@@.@@.................@@@@@@.......@@@@@@@@@@@@@@@
@@@@@@@@@@@@@..........@@.@@.......@@......@...@@@@@........@@@@@@@@@@@@@
@@@@@@@@@@@@@..........@@@@@....@@@@@..@.@......@@....@......@@@@@@@@@@@@
@@@@@@@@@@@@@@@...........@....@........@................@@..@@@@@@@@@@@@
@@@@@@@@@@@@@@@...@@.@@.@...@@@@@..............@............@@@@@@@@@@@@@
@@@@@@@@@@@@@@@@.....@@@@...@@@@@......@.....................@@@@@@@@@@@@
@@@@@@@@@@@@@@........@@@.....@@@...............@@...........@@@@@@@@@@@@
@@@@@@@@@@@@@.......@...................@.......@@...........@@@@@@@@@@@@
@@@@@@@@@@@@@.......@.....................................@..@@@@@@@@@@@@
@@@@@@@@@@@@..@.............@...@.........................@........@@@@@@
@@@@@@@@@@@@@...............@...........@...................@......@@@@@@
@@@@@@@@@@@@@......@@...............@............@......@.........@@@@@@@
@@@@@@@@@@@@@@@@@@@@......@...............@......@................@@@@@@@
@@@@@@@@@@@@@@@@@@@@@............@...........@...@............@@@.@@@@@@@
@@@@@@@@@@@@@@@@@@@@@...........@@@@@..@..@@.........@@@@@@@@@@@@.@@@@@@@
@@@@@@@@@@@@@@@@@@@@.......@@.....@@@@.@...@............@@@@@@@@@@@@@@@@@
@@@@@@@@@@@@@@@@@@@@@@..........@@@@......................@@@@@@@@@@@@@@@
@@@@@@@@@@@@@@@@@@@@@@............@@......................@@@@@@@@@@@@@@@
@@@@@@@@@@@@@@@@@@..........@@..........@...@...............@...@.@@@@@@@
@@@@@@@@@@@@@@@@@@.........@@@@@@@.............@@.@@................@@@@@
@@@@@@@@@@@@@@@@.............@@@@.@............@@@@.................@@@@@
@@@@@@@@@@@@@@@@@@.............@..........@@..@@@@.....@@............@@@@
@@@@@@@@@@@@@@@@@@..@@@@....@@................@@@@...................@@@@
@@@@@@@@@@@@@@@.....@@@.......................@@@@....@..............@@@@
@@@@@@@@@@@@@@........@....................@....@........@@...@@.....@@@@
@@@@@@@@@@@@@@................@....@.....................@@..@@@.....@@@@
@@@@@@@@@@@@@@.@@........................................@@@.........@@@@
@@@@@@@@@@@@@@@@@...@@........@@@...............@@@.......@...@.....@@@@@
@@@@@@@@@@@@@@.@@@................................................@@@@@@@
@@@@@@@@@@@@@@...@.....@..............@.........@...@............@@@@@@@@
@@@@@@@@@@...@.....@........@.......@...............@..........@..@@@@@@@
@@@@@..............@@@@@@@..@.......@.....@@@.......@@@.@.........@@@@@@@
@@@@.........@.......@@@@@@@@...............@..@.................@@@@@@@@
@@@@@........@.......@@@@@@@@...............@@...............@...@@@@@@@@
@@@@@@@..............@@@@@@@@.........................@..@.......@@@@@@@@
@@@@@@@.@....@.@@....@@@@@@@@...........................@@@@......@@@@@@@
@@@@@@@.@.@.@@@@@....@@@@@@@.........@........@.........@@@@.....@@@@@@@@
@@@@@@@@@@@@@@@@@....@@.@@@.......................@@....@@@@.....@@@@@@@@
@@@@@@@@@@@@@@@@@@....................@..@....@@@.@@....@.@.....@@@@@@@@@
@@@@@@@@@@@@@@@@@@......@........@............@@@@..............@@@@@@@@@
@@@@@@@@@@@@@@@@@@......@....@@.................@@@.......@@....@@@@@@@@@
@@@@@@@@@@@@@@@@@@......@@...@@.................@@@.......@...@@@@@@@@@@@
@@@@@@@@@@@@@@@@@@@......@......................@@@.......@.@@@@@@@@@@@@@
@@@@@@@@@@@@@@@@@@@........................@@.............@..@@@@@@@@@@@@
@@@@@@@@@@@@@@@@@@................@....@.....................@@@@@@@@@@@@
@@@@@@@@@@@@@@@@@.......@...@.............@@...................@@@@@@@@@@
@@@@@@@@@@@@@@@@.....@@@@@@@@........@.....@..................@@@@@@@@@@@
@@@@@@@@@@@@@@@@@@@@.@@@@@@@@.................................@@@@@@@@@@@
@@@@@@@@@@@@@@@@@@@@@@@@@@@@@@.............@...........@@@.....@@@@@@@@@@
@@@@@@@@@@@@@@@@@@@@@@@@@@@@@@@..................@.......@.....@@@@@@@@@@
@@@@@@@@@@@@@@@@@@@@@@@@@@@@@@....................................@@@@@@@
@@@@@@@@@@@@@@@@@@@@@@@@@@@@@..................@..................@@@@@@@
@@@@@@@@@@@@@@@@@@@@@@@@@@@@@@@.@@.............@...@.....@@.......@@@@@@@
@@@@@@@@@@@@@@@@@@@@@@@@@@@@@@@..@.@............@..@.....@@@.....@@@@@@@@
@@@@@@@@@@@@@@@@@@@@@@@@@@@@@@..@.........................@@.....@@@@@@@@
@@@@@@@@@@@@@@@@@@@@@@@@@@@..............................@.......@@@@@@@@
@@@@@@@@@@@@@@@@@@@@@@@@@@@........@.............................@@@@@@@@
@@@@@@@@@@@@@@@@@@@@@@@@..@........@@@...@.............@...@@@@.@@@@@@@@@
@@@@@@@@@@@@@@@@@@@@@@@@@............@.................@.....@@@@@@@@@@@@
@@@@@@@@@@@@@@@@@@@@@@@@@.....@@@@...@.@....@.............@@@@@@@@@@@@@@@
8
35 39 0
29 44 0
36 50 0
64 36 0
41 60 0
52 48 0
20 54 0
48 28 0

19 59 0
32 48 0
54 34 0
52 50 0
42 57 0
12 9 0
27 51 0
27 71 0
