width 73
height 73
@@@@@@@@@@@@@@@@@@..........@......@@@...........@@@@@@@@@@@@@@@@@@@@@@@@
@@@@@@@@@@@@@@@@....................@............@@@@@@@@@@@@@@@@@@@@@@@@
@@@@@@@@@@@@@@@@@...............@.....@.....@@....@@@@@@@@@@@@@@@@@@@@@@@
@@@@@@@@@@@@@@@@@@..........@@.........@....@....@@@@@@@@@@@@@@@@...@@@@@
@@@@@@@@@@@@@@@@@@@@........@...@@..............@@@@@@@@@@@@@@@@@...@@.@@
@@@@@@@@@@@@@@@@@@@@........@@@.@......@........@@@@@@@@@@@@@@@@.......@@
@@@@@@@@@@@@@@@@@@@@@......@@@@.@..@@@.@..@..........@@@@@@@@@.@....@..@@
@@@@@@@@@@@@@@@@@@@@@@@.............@@................@@@@@@@@..@.@...@@@
@@@@@@@@@@@@@@@@@@@@@@@..@@..................@.....@.@.@@@@@@.....@...@@@
@@@@@@@@@@@@@@@@@@@@@@@..@@@.......@@...........@..@...@@@@.......@@..@@@
@@@@@@@@@@@@@@@@@@@@@@@@@@@........@@....@......@@.@......@@............@
@@@@@@@@@@@@@@@@@@@@@@@@@@@@....................@@.......................
@@@@@@@@@@@@@@@@@@@@@@@@@@@@@...........@@........@@.....................
@@@@@@@@@@@@@@@@@@@@@@@@@@@@@..............@@..............@........@@...
@@@@@@@@@@@@@@@@@@@@@@@@@@@.................@@@@@........@.@.@@.....@@..@
@@@@@@@@@@@@@@@@@@@@@@@@@@@@........................................@@..@
@@@@@@@@@@@@@@@@@@@@@@@@@@@@@......@....@..................@.@..........@
@@@@@@@@@@@@@@@@@@@@@@@@@@@@@......@....................................@
@@@@@@@@@@@@@@@@@@@@@@@@@@@@@..................................@@@@@....@
@@@@@@@@@@@@@@@@@@@@@@@@@@@@@@@....@@@.....@@.....@............@@@@.....@
@@@@@@@@@@@@@@@@@@@@@@@@@@@@@.....@@@@@@...@....@.......................@
@@@@@@@@@@@@@@@@@@@@@@@@@@@@@....@@@........................@...@........
@@@@@@@@@@@@@@@@@@@@@@@@@@@@@....@.........@............@................
@@@@@@@@@@@@@@@@@@@@@@@@@@@@....@@............@.............@.......@....
@@@@@@@@@@@@@@@@@@@@@@@@.@@..@..@.............................@........@.
@@@@@@@@@@@@@@@@@@@..@@@.@@........................@.......@.....@.......
@..@@..@@@@@@@@@@@@..@@@........................@@..............@@@.....@
@...@.@@..@@@@@@@@...@@......@@................@.................@@......
......@@.......@@@.........@...................@.................@.......
.................@....@....@......@@.............................@....@..
............@.......@@@...........@@@@...........................@....@.@
....................@@@...........@@....@....@@...........@.....@@@....@@
....................@.............@@..@@..................@@...@@@@....@@
..........@..............@........@...@@...@@@.@..@@.......@@..@@.....@@@
........................@@....@@............@..............@@......@@@@@@
.........@.........@....@@.@.....................@.@................@@@@@
.........@.....................@@@...................................@@@@
@@........@@....@@..............@.............@@@......................@@
@@.@......@.....@@..............@.....@.......@........................@@
@@......@.......@@.......@.....@..........@@@@@@...................@...@@
..@....@..............@@.@...........@.....@@@@@@@.......@............@@@
.........................@..................@@@@@...@...@@............@@@
.........................@...................@@@@........@@....@...@...@@
........@....................................@@@@@@.@..........@@@....@@@
..............@..@....@@......@@.............@@@@@@.............@@@@@@@@@
..............@.......@@@....@@@.............@@@@@................@@@@@@@
.@...........@@...@@..@@@.....@@@............@@@@@@.......@@.....@@@@@@@@
.............@.....@@.@@@.....@@@..@@........@@@@...............@@@@@@@@@
.......................@@.....@@@..@@@....@@..@....@........@....@@@@@@@@
............@..........@....@.@@@.....................@.........@@@@@@@@@
.....................@@........@@@...@.........@@@@..@@@@......@.@@@@@@@@
.@@.......@..............@.........................@@@@@@......@.@@@@@@@@
.@@@@@....................................@........@@@@@@...@....@@@@@@@@
@@@@@@@@@..............@@....@.....@......@........@@@@@@@.......@@@@@@@@
@@@@@@@@@@@@.........@@@@..........@...@@..........@@@@@@@.....@@@@@@@@@@
@@@@@@@@@@@@.........@@@@........................@.@.@@@@......@@@@@@@@@@
@@@@@@@@@@@............@@............@.................@@......@@@@@@@@@@
@@@@@@@@@@@@@@.........@@@...........@.........................@@@@@@@@@@
@@@@@@@@@@@@@@@........@@@@....................................@@@@@@@@@@
@@@@@@@@@@@@@@..........@@........@..@.....@.................@@@@@@@@@@@@
@@@@@@@@@@@@@@..........@@.................@.............@@.@@@@@@@@@@@@@
@@@@@@@@@@@@@@....@.....@...@....@@.@@@@@.@@..........@@@@@.@@@@@@@@@@@@@
@@@@@@@@@@@@@@..@@@@@@..@@@@@@......@@@@@@@@@@@@@.....@@@@@@@@@@@@@@@@@@@
@@@@@@@@@@@@@@@@@@@@@@.@@@@@@@.@@@@@@@@@@@@@@@@@@@@@@@@@@@@@@@@@@@@@@@@@@
@@@@@@@@@@@@@@@@@@@@@@@@@@@@@@@@@@@@@@@@@@@@@@@@@@@@@@@@@@@@@@@@@@@@@@@@@
@@@@@@@@@@@@@@@@@@@@@@@@@@@@@@@@@@@@@@@@@@@@@@@@@@@@@@@@@@@@@@@@@@@@@@@@@
@@@@@@@@@@@@@@@@@@@@@@@@@@@@@@@@@@@@@@@@@@@@@@@@@@@@@@@@@@@@@@@@@@@@@@@@@
@@@@@@@@@@@@@@@@@@@@@@@@@@@@@@@@@@@@@@@@@@@@@@@@@@@@@@@@@@@@@@@@@@@@@@@@@
@@@@@@@@@@@@@@@@@@@@@@@@@@@@@@@@@@@@@@@@@@@@@@@@@@@@@@@@@@@@@@@@@@@@@@@@@
@@@@@@@@@@@@@@@@@@@@@@@@@@@@@@@@@@@@@@@@@@@@@@@@@@@@@@@@@@@@@@@@@@@@@@@@@
@@@@@@@@@@@@@@@@@@@@@@@@@@@@@@@@@@@@@@@@@@@@@@@@@@@@@@@@@@@@@@@@@@@@@@@@@
@@@@@@@@@@@@@@@@@@@@@@@@@@@@@@@@@@@@@@@@@@@@@@@@@@@@@@@@@@@@@@@@@@@@@@@@@
@@@@@@@@@@@@@@@@@@@@@@@@@@@@@@@@@@@@@@@@@@@@@@@@@@@@@@@@@@@@@@@@@@@@@@@@@
8
62 22 0
57 48 0
35 27 0
37 15 0
69 24 0
38 4 0
38 58 0
3 41 0

64 11 0
18 2 0
0 52 0
62 22 0
56 40 0
3 50 0
58 48 0
67 4 0
