width 73
height 73
@@@@@@@@@@@@........@@.....@.....@........@@@@.....@@@.@@@@@...........@@
@@@@@@@@@@@@@@.......@...@@@....@...........@......@@@............@@.....
@@@@@@@@@@@@@@...........@.@@...................@...............@........
@@@@@@@@@@@@@@..................................................@..@@...@
@@@@@@@@@@@@@...........@............@....@@..........@...........@@@...@
@@@@@@@@@@@@.........................@@@..@@............@@@.......@.....@
@@@@@@@@@@@@...................................@@@@@.....@@.......@....@@
@@@@@@@@@@@@.........@@........................@@......@.@@....@@........
@@@@@@@@...............................@.......@...@...........@@@...@...
@@@@@@@@...........@.........@@.......@........................@@...@@@@@
@@@@.....@.......@..........@.........@........................@.....@@@.
@@@@..@...@.............................@@.....................@.........
@@........@.....@.......................@..................@@..@@....@..@
@@....@.@@@@@..@@............@.......@@@@................@@@@.@@@........
@@@.@...@@@@....@....................@.@@...@@..........@@@@@@@@@@.......
........@@......@...........................@@...@......@@@@@@@@@@.......
.....@...............@......@@.@...@@...................@@@@@@@@@@......@
..........@.......................@@@@.....@.@.......@...@@@.@@@@@.@.....
@@@.............@..................@.......@@@.@@@.........@.......@.....
@@@...............@........@@..@..@@@...........@............@@.......@..
.............@...@@@@..@...@@@@..............................@@@....@@@..
..@@........@@...@@@@..@@..@@@.............@@......@.@......@@@@.@..@.@@@
............@@..@@@@@@..@............@@..@@@@@......@@@.....@@........@@@
............@@@@@@@@@@@@@.@@............@@@@@@......@@@@@.............@@@
............@@.@@@@@@@@@@@@............@@@.....@@@@@.@@@......@.......@@@
.....@......@@.@@@@@@@@@@@....@@..@....@@............@@.......@@@.....@@@
.........@.....@@@@@@@@@@@..@@@@@...........................@@@@.........
@......@@.......@@@@@@@@@..@@@@@..........@@.....@.........@@@@@...@.....
.......@@.......@@@@@@@@@@@@@@@@..........@@..@@...........@@@@....@.....
...@.@@@@...@@@@@@@@@@@@@@@@@@@@.@........................@@@@@@..@@.....
...@@@@@@@.@@@@@@@@@@@@@@@@@@@@@..........................@@...@.........
...@@@@@@@@@@@@@@@@@@@@@@@@@@@@....@@................@....@@.............
...@@@@@@@@@@@@@@@@@@@@@@@@@@@@@.....................@........@....@@....
...@@@@@@@@@@@@@@@@@@@@@@@@@@@@@...................................@@@...
....@@@@@@@@@@@@@@@@@@@@@@@@@@@@.....@@..............@@.....@............
....@@@@@@@@@@@@@@@@@@@@@@@@@..........@.............@@..................
@@@@@@@@@@@@@@@@@@@@@@@@@@@@.....@@@@@...............@@@.................
@@@@@@@@@@@@@@@@@@@@@@@@@@......@@@@@@.....................@............@
@@@@@@@@@@@@@@@@@@@@@@@@@@......@@@.@@@........@@...@...@...........@..@@
@@@@@@@@@@@@@@@@@@@@@@@@@@@..........@.....@..@@@.......@@.............@@
@@@@@@@@@@@@@@@@@@@@@@@@@@@...................@@@.........@@........@.@@@
@@@@@@@@@@@@@@@@@@@@.@@@@@@@.............@.....@@.....................@@@
@@@@@@@@@@@@@@@@@@.....@@@@............@..................@.......@@@@@@@
@@@@@@@@@@@@@@@@@@......@@@@.........@@@.........@........@@....@@@@@@@@@
@@@@@@@@@@@@@@@@@........@@@@@.@.@@@@@@@....@....@........@....@@@@@@@@@@
@@@@@@@@@@@@@@@@@@...............@@@.@@@........@@.......@@....@@@@@@@@@@
@@@@@@@@@@@@@@@@@@...............@@@...@@...@.......@..@@@@@@..@@@@@@@@@@
@@@@@@@@@@@@@@@@@@...............@.@@......@@...@@.@@..@@@@@@@@@@@@@@@@@@
@@@@@@@@@@@@@@@@@@@.....@@..@..............@@@@@@@@@@@.@@@@@@@@@@@@@@@@@@
@@@@@@@@@@@@@@@@........@@@.@.@...@.........@@@@@@@@@@@@@@@@@@@@@@@@@@@@@
@@@@@@@@@@@@@@@.........@.........@.........@@@@@@@@@@@@@@@@@@@@@@@@@@@@@
@@@@@@@@@@@@@@@@@...........................@@@@@@@@@@@@@@@@@@@@@@@@@@@@@
@@@@@@@@@@@@@@@..............................@@@@@@@@@@@@@@@@@@@@@@@@@@@@
@@@@@@@@@@@@@...............................@@@@@@@@@@@@@@@@@@@@@@@@@@@@@
@@@@@@@@@@@.......................@@........@@@@@@@@@@@@@@@@@@@@@@@@@@@@@
@@@@@@@@@@@@.......@......@...@...@.......@@@@@@@@@@@@@@@@@@@@@@@@@@@@@@@
@@@@@@@@@@@@@@@..@@....@....................@@@@@@@@@@@@@@@@@@@@@@@@@@@@@
@@@@@@@@@@@@@@@............@..@..........@..@@@@@@@@@@@@@@@@@@@@@@@@@@@@@
@@@@@@@@@@@...@@@........................@..@@@@@@@@@@@@@@@@@@@@@@@@@@@@@
@@@@@@@@@@@.@.@@@@.....@................@@...@@@@@@@@@@@@@@@@@@@@@@@@@@@@
@@@@@@@@@@@@@..........................@@@...@@@@@@@@@@@@@@@@@@@@@@@@@@@@
@@@@@@@@@@@@@@......................@@@@@@@@@@@@@@@@@@@@@@@@@@@@@@@@@@@@@
@@@@@@@@@@@@@@.......................@@@@@@@@@@@@@@@@@@@@@@@@@@@@@@@@@@@@
@@@@@@@@@@@@@@..........@.@.@@.......@@@@@@@@@@@@@@@@@@@@@@@@@@@@@@@@@@@@
@@@@@@@@@@@@@@@@@..........@.........@@@@@@@@@@@@@@@@@@@@@@@@@@@@@@@@@@@@
@@@@@@@@@@@@@@@@@......................@@@@@@@@@@@@@@@@@@@@@@@@@@@@@@@@@@
@@@@@@@@@@@@@@@@@@....@@.............@@@@@@@@@@@@@@@@@@@@@@@@@@@@@@@@@@@@
@@@@@@@@@@@@@@@@@@@...@@.............@@@@@@@@@@@@@@@@@@@@@@@@@@@@@@@@@@@@
@@@@@@@@@@@@....@@@@..................@@@@@@@@@@@@@@@@@@@@@@@@@@@@@@@@@@@
@@@@@@@@@@@@................@..........@.@..@@@@@@@@@@@@@@@@@@@@@@@@@@@@@
@@@@@@@@@@@@@@..........@@@.@.....@....@.....@@@@@@@@@@@@@@@@@@@@@@@@@@@@
@@@@@@@@@@@@@@@...........@@@.....@@@@.....@@@@@@@@@@@@@@@@@@@@@@@@@@@@@@
@@@@@@@@@@@@@@@..@@....@..@@@.....@@@@..@@..@@@@@@@@@@@@@@@@@@@@@@@@@@@@@
8
41 50 0
22 52 0
39 7 0
69 5 0
15 15 0
14 28 0
36 51 0
51 44 0

42 51 0
35 58 0
43 2 0
38 33 0
42 12 0
14 26 0
55 30 0
27 49 0
