width 73
height 73
@@@@@@@@@@@@@@@@@@..@@@.......@.@.@............@@@@@@@@@@@@@@@@@@@@@@@@@@
@@@@@@@@@@@@@@@@@.........@.......@............@@@@@@@@@@@@@@@@@@@@@@@@@@
@@@@@@@@@@@@@@@@@@.......@@................@..@@@@@@@@@@@@@.@@@@@@@@@@@@@
@@@@@@@@@@@@@@@@@@.@.....@@....................@@@@@@@@@@@...@@@@@@@@@@@@
@@@@@@@@@@@@@@@@@@.@@..........@..@@@..........@@@@@@@.@@@...@@@@@@@@@@@@
@@@@@@@@@@@@@@@@@@@@@..........@...............@@@@..........@@@@@@@@@@@@
@@@@@@@@@@@@@@@@@@@@@....@@@.........@@..........@@...@@...@@@@@@@@@@@@@@
@@@@@@@@@@@@@@@@@@@@@...............@@...........@@........@@@@@@@@@@@@@@
@@@@@@@@@@@@@@@@@@@@@.....@......................@@@.......@@@@@@@@@@@@@@
@@@@@@@@@@@@@@@@@@@@@@@..@....................@@@@@@.@@...@@@@@@@@@@@@@@@
@@@@@@@@@@@@@@@@@@.@@@@@.............@..@....@@@@@@@@@@....@@@@@@@@@@@@@@
@@@@@@@@@@@@@@@@@@............................@@@@@@@.@@.......@@@@@@@@@@
@@@@@@@@@@@@@@@@@@....................@.........@@@@.........@@@@@@@@@@@@
@@@@@@@@@@@@@@@@@@....................@.....@@@...@@........@@@@@@@@@@@@@
@@@@@@@@@@@@@@@@@@..@@.............@.....@..@@....@..........@@@@@@@@@@@@
@@@@@@@@@@@@@@@@.........................@........@............@@@@@@@@@@
@@@@@@@@@@@@@@@@.......................@..........@..@@....@..@@@@@@@@@@@
@@@@@@@@@@@@@@@..@.......@.@.................@...............@@@@@@@@@@@@
@@@@@@@@@@@@@@@....................@...@..@@@.......@@@@@@@@@@@@@@@@@@@@@
@@@@@@@@@@@@@@@.....@......@@@@@..........@@@.......@@.@@.@@@@@@@@@@@@@..
@@@@@@@@@@@@@@...........@.@@@@@.@@@.......@@...............@@@@....@@...
@@@@@@@@@@@@@@@@...........@@@@@@@@..@.....@@.............@.@............
@@@@@@@@@@@@@@@@............@@@@@@@.......................@....@.........
@@@@@@@@@@@@@@@@...........@@@@@@@@@@.....................@....@@@.....@@
@@@@@@@@@@@@@@@@..............@@@@@@@@...@@....@@................@@....@@
@@@@@@@@@@@.@@@@..............@@@@@@@@@@..@.....@@...............@.....@@
@@@@@@@@@@@.@@@...............@@@@@@@@....@.....@..........@@..........@@
@@@@@@@@@@..@@@....@@@.....@...@@@@@@@@@...@@.@......@............@@.@..@
@@@@@@@@@@.@....@..@@@.........@@@@@@@@@@..............................@@
@@@@@@@@........@..@@@@...@....@@@@@@@@@@@....@....@..@...........@....@@
@@@@@.........@@...@.........@@@@@@@@@@@@.......@...@@@@..........@@....@
@@@@@.........@..@.@@........@@@@@@@@@@@@.............@.@...............@
@@@@@@.....@...........@@@..@@@@@@@@@@@@@....@..........................@
@@@@@@.............@...@@@...@@.@@@@@@@@@@......@@..............@.......@
@@@@@@..@......@...@...@@@@@....@@@@@@@@@@.....@@@@.............@....@...
@@@@..............@@...@@@@@@...@@@@@@@@@@.....@@@....@..................
@@@@............@......@........@@@@@@@@@@@@...@@@.......................
@@@@.....@....@@@............@...@@@@@@@@@@.....@........................
@@@@.......@@@@@@@...........@@@@@@@@@@@@@@....@@........................
@@@@........@@@@....@....@.@@@@@@@@@@@@@@@@.....@....................@@..
@@@@@......................@@@@@@@@@@@@@@@@...........................@@@
@@@@@@.@......@............@@@@@@@@@@@@@@.....@@.......................@@
@@@@@.................@...@@@@@@@@@@@@@@@.......................@@.....@@
@@@@@@....@........@......@@@@@@@@@@@@@@@.@@@..........................@@
@@@@@@..@@@@.......@@@.....@@@@@@@@@@@@@@@@@@@..............@...........@
@@@@@@@@@@@..@.....@@......@@@@@@@@@@@@@@@@@@@@@..@.......@..............
@@@@@@@@@@@@.......@.........@@@@@@@@@@@@@@@@@.................@.....@...
@@@@@@@@@@@........@......@......@@@@@@@@@@@@............................
@@@@@@@@@@@......@@.............@@@@@@@@@@@@................@...@@....@@@
@@@@@@@@@.................@.....@@@@@@@@@@@@....@.....................@@@
@@@@@@@@..............@...@...@@@@@@@@@@@@@@....@..................@@@@@@
@@@@@@@...............@.....@@@@@@@@@@@@@@@...@.............@......@@@@@@
@@@@@@@........................@@@@@@@@@@@................@.........@@@@@
@@@@@@......@..@@@.@..........@@@...@@@@@@..@@@@.....................@@@@
@@@@@@..@......@@@............@@@...@@@@@@...@...@....@.@.............@@@
.@@@@@@@@@.....@@@.......@.........@@@@@................................@
.@@@@@@@@@@...@.@@............@@...@@@@@.................................
..@@@@@@@@....@..................@..@@....@....@...@@..........@@@@@@....
........@@.@@.......................@@...@@@@@....@@.........@@@@@@@@@@.@
.......@..................@....@@@..@@...@@@@...........@@.......@@@@@@@@
.......@........@@.......@@...@@@@..@...................@@........@@@@@@@
.....@.@@@......@@.@.@....@@..@@@@@...............@.................@@@@@
@................@@@.@@@..@@@@@@@@@@...............@.........@.......@@@@
.........@.......@@@......@@@@@@@@@@@........@.....@........@@.......@@@@
.@.......@.........@.......@@@@@@@@@@@@......@........@......@.........@.
......@...............@@...@@@@@@@@@@@..@................@...@.@.........
@@@@..@...............@@@..@@@@@@@@@@@..@@..........@........@@@@.......@
@@@@.........@........@.......@@@@@@@@@@@...@...........@.....@@@.......@
..........@...@.....@@@@......@@@@@@@@@@@@....@........@........@.......@
....................@@@......@@@@@@@@@@@@@@...@..........................
....................@........@@@@@@@@@@@@@@@@@@.@................@....@@.
....@@@.............@....@@..@@@@@@@@@@@@@@@@@@@@.....@@@........@....@@@
.....@..@@..........@...@@@.@@@@@@@@@@@@@@@@@@@@@@@@.@@@@.......@@....@@@
8
16 51 0
38 3 0
24 19 0
49 57 0
45 37 0
21 58 0
40 58 0
42 54 0

38 14 0
54 47 0
71 69 0
55 60 0
55 51 0
52 6 0
17 1 0
24 3 0
