width 73
height 73
@@@@@@@@..@@.@@@@@@@@@@@@@..@@@@.......@......@....@@@@@@@@@@@@@@@@@@@@@@
@@@@@@@@.....@@@@@@@@@@@@@..@@@........@............@@@@@@@@@@@@@@@@@@@@@
@@@@@@@.....@@@@@@@@@..@@@..@.@......................@@@@@@@@@@@@@@@@@@@@
@@@@@@@.....@@..@@..@....@....@@....................@@@@@@@@@@@@@@@@@@@@@
@@@@@@..........@..........................@@@.......@@@@@@@.@@@@@@@@@@@@
@@@@@@@........@............@.............@@@@.......@@@@@@@.@@@@@@@@@@@@
@@@@.@@.@@.........@..@...................@....@.....@@@@@@@..@@@@@@@@@@@
@@@@........................@.............@@@..@@@.@.@@@@@@@.@@@@@@@@@@@@
@@...............@.........@@@......@...........@@...@@@@@@@.....@@@@@@@@
@@@@.............@@@.@...@@@@@..........................@@@@..@..@@@@@@@@
@@@@.............@@@@@.@@@@@....................@.............@.@@@@@@@@@
@@@@@........@.@..@..@@@@@@@...................@@...............@@@@@@@@@
@@@@@@@......@@......@@@@@@@..........@.............@........@@..@@@@@@@@
@@@@@@@@@............@@@@@@...............@.....@.......@....@@..@@@@@@@@
@@@@@@@@@............@@@@@.............@@@@@.............@.......@@@@@@@@
@@@@@@@@@.............@@@@..........@@@@@@@@...........@.@.........@@@@@@
@@@@@@@@@......@@.....@@@@...........@@@......@.............@.......@..@@
@@@@@@@@@.............@@@.......@....@@@..........@............@........@
@@@@@@@@@@@@@.........@@.......................................@.........
@@@@@@@@@@@@@.....@...@.......@....@@....................................
@@@@@@@@@@@@@................@@.......@..@@......@.......................
@@@@@@@@@@@@@..............@@@@@@@....@...@@..................@@@@@......
@@@@@@@@@@.@@..............@@@..@@........@.................@..@@@@......
@@@@@@@.....................@............@@......................@@......
@@@.@@@@@...@@@......@@....@@.....................@..@@@@@...............
@@..@.....@@@@@......@...........@....................@..................
@@...........@@.................@.................................@......
@@.....................................@.....................@.......@...
@@......@........@@......................@.......@...................@...
@@@.....@.....@@@@@.............@..................................@@@...
@@@@..........@@@@@........................@@......@.........@...@...@...
...@..@.....@...........@.....@.....@..@...@@@@@@@@@@@@..........@@......
...........@...........@@.............@@@@@@@@@@@@@@@@@..........@.......
.......................@@@............@@@@@@@@@@@@@@@@@@@@.............@.
.................@@....@@@....@.......@@@@@@@@@@@@@@@@@@@...........@@...
@....................@.@@............@@@@@@@@@@@@@@@@@@.......@.....@@@..
@@....@...............@@@.............@@@@@@@@@@@@@@@@..............@@@..
@@....@..@...@@@...@..@@@..........@..@@@@@@@@@@@@@@@@............@@@@@..
@@@@@........@@@@@.....................@@@@@@@@@@@@@@@@@..........@@@@@@@
@@@@@.......@@@@@@....................@@@@@@@@@@@@@@@@@@@@.......@@@@@@@@
@@@@@....@@@@@@@@@........@...........@@@@@@@@@@@@@@@@@@@........@@@@@@@@
@@@@@....@@@@@@@@@........@.........@@@@@@@@@@@@@@@@@@@@@@@@@@@@@@@@@@@@@
@@@@@@....@@@@@@@......@....@@..@...@@@@@@@@@@@@@@@@@@@@@@@@@@@@@@@@@@@@@
@@@@@@.....@@@@@@............@........@.@@@@@@@@@@@@@@@@@@@@@@@@@@@@@@@@@
@@@@@@.......@@@@..............@.........@@@@@@@@@@@@@@@@@@@@@@@@@@@@@@@@
..@.@.........@@@...@..........@.......@@@@@@@@@@@@@@@@@@@@@@@@@@@@@@@@@@
@.......@......................@.@...@@@@@@@@@@@@@@@@@@@@@@@@@@@@@@@@@@@@
.......@@@.....................@.....@@@..@@@@@@@@@@@@@@@@@@@@@@@@@@@@@@@
@...................@@...................@@@@@@@@@@@@@@@@@@@@@@@@@@@@@@@@
@@@@.@.........................@.........@@@@@@@@@@@@@@@@@@@@@@@@@@@@@@@@
@@@@@....................................@.@@@@@@@@@@@@@@@@@@@@@@@@@@@@@@
@@@@.................................@@@...@@@@@@@@@@@@@@@@@@@@@@@@@@@@@@
@@@@...........@..................@...@@.@@@@@@@@@@@@@@@@@@@@@@@@@@@@@@@@
@@@@.............@@..............@@...@...@@@@@@@@@@@@@@@@@@@@@@@@@@@@@@@
@@@@@......@@...@..............@.@........@@@@@@@@@@@@@@@@@@@@@@@@@@@@@@@
@@@@@@.....@@@@.........@......@.@........@@@@@@@@@@@@@@@@@@@@@@@@@@@@@@@
@@@@@......@@@.......@....................@@@@@@@@@@@@@@@@@@@@@@@@@@@@@@@
@@@@@............@...@@.......@@@..@.@@@@@@@@@@@@@@@@@@@@@@@@@@@@@@@@@@@@
.@@...............@..@@.......@@@...@@@@@@@@@@@@@@@@@@@@@@@@@@@@@@@@@@@@@
.....................@@......@@@@@..@@@@@@@@@@@@@@@@@@@@@@@@@@@@@@@@@@@@@
....@@@..............@@......@@.......@@@@@@@@@@@@@@@@@@@@@@@@@@@@@@@@@@@
....@@@......................@@@......@@@@@@@@@@@@@@@@@@@@@@@@@@@@@@@@@@@
....@@........@................@.....@@@@@.......@@@@@@@@@@@@@@@@@@@@@@@@
..............@................................@@@@@@@@@@@@@@@@@@@@@@@@@@
.................@.........@@@..@..............@@@@@@@@@@@@@@@@@@@@@@@@@@
...........@......@@.......@@@@....@......@@@@@@@@@@@@@@@@@@@@@@@@@@@@@@@
@..........@......@@@@@@@@@@@@@...........@@@@@@@@@@@@@@@@@@@@@@@@@@@@@@@
......@..@.......@@@@@@@@..@@.............@@@@@@@@@@@@@@@@@@@@@@@@@@@@@@@
..@...@@@@.........@@@@@@.....@@..@@....@@@@@@@@@@@@@@@@@@@@@@@@@@@@@@@@@
......@@@..........@@@@@@.....@@......@@@@@@@@@@@@@@@@@@@@@@@@@@@@@@@@@@@
@.....@@@@@........@@@@@@@@...@@.......@@@@@@@@@@@@@@@@@@@@@@@@@@@@@@@@@@
@....@@@@@@.........@@@@@@@@..@@.......@@@@@@@@@@@@@@@@@@@@@@@@@@@@@@@@@@
@....@@@@@.........@@@@@@@@@..@@@.......@@@@@@@@@@@@@@@@@@@@@@@@@@@@@@@@@
8
19 30 0
2 31 0
43 64 0
64 38 0
19 25 0
39 53 0
69 31 0
48 6 0

67 34 0
29 47 0
63 14 0
64 38 0
22 21 0
34 37 0
36 53 0
18 44 0
