width 20
height 35
@...........@@@@....
@@..........@@@@....
@...@.....@..@......
.@.....@.@..........
......@.@...........
....................
......@.............
...........@........
....@.......@@......
.......@....@.......
...............@....
........@@..........
...............@.@..
.....@...@..........
........@...........
...........@.....@.@
....................
...@..@........@....
.....@............@.
....@........@......
@...........@@......
.....@......@@....@@
....@...@....@......
....................
.........@........@@
..@.................
...@@...............
..............@.....
...@.....@...@......
..@...........@.....
........@.......@...
...@..@.@...@.......
....@.......@.......
..................@.
....................
6
2 28 0
2 23 0
1 22 0
6 18 1
19 31 1
19 23 1

13 9 0
19 2 0
5 11 0
7 2 1
3 7 1
0 18 1
