width 20
height 35
....................
.........@......@...
....................
.....@..............
......@..@....@.....
..........@.........
...........@........
...@..@......@..@.@.
........@...........
........@@@.........
........@@.....@.@..
...@....@@......@...
.....@.............@
..@...@...@@.@.....@
.@........@@.....@..
....................
..........@.........
......@....@....@@..
.........@..@...@@@@
....@...@..@....@@@@
..@.......@..@......
@...................
...............@....
............@.......
.....@.............@
.@.@........@.@.....
.@.......@......@...
....................
.........@..........
....@..............@
...........@......@@
.......@..........@@
......@......@....@@
.................@@@
.................@@@
6
11 29 0
10 12 0
7 27 0
14 22 1
18 6 1
9 33 1

11 27 0
1 27 0
8 1 0
10 29 1
5 0 1
14 9 1
