width 20
height 35
....................
..@..........@@..@..
.......@........@...
@....@.@...@........
....................
.............@...@..
........@...........
..@...........@.....
..@.........@...@...
.....@...........@..
.@......@..@........
.....@.@......@.....
.........@...@...@..
...@.@........@.....
............@....@..
.........@.....@....
....@...............
......@..........@..
................@...
...@......@..@......
.....@.@............
................@..@
@...........@......@
.........@..........
..@..............@..
...........@....@.@.
....................
....................
.....@...@..@......@
....................
..............@.@...
....@.....@.........
..........@..@.....@
..........@....@...@
..........@........@
6
6 25 0
1 14 0
10 2 0
1 26 1
6 4 1
15 31 1

1 24 0
11 11 0
0 34 0
7 27 1
6 5 1
1 0 1
