width 59
height 59
@@@@...@@.....@.....@@@@@@@@@@@@@@@@@@@@@@@@@@@@@@@@@@@@@@@
@@@@@@................@@@@@@@@@@@@@@@@@@@@@@@@@@@@@@@@@@@@@
@@@..............@@....@@@@@@@@@@@@@@@@@@@@@@@@@@@@@@@@@@@@
@@@........................@@@@@@@@@@@@@@@@@@@@@@@@@@@@@@@@
......@.............@.....@@@@@@@@@@@@@@@@@@@@@@@@@@@@@@@@@
..@...@@............@.....@@@@@@@@@@@@@@@@@@@@@@@@@@@@@@@@@
....@...................@@@@.@@@@@@@@@@@@@@@@@@@@@@@@@@@@@@
......@................@@@....@@...@@@@@@@@@@@@@@@@@@@@@@@@
......@@@@.............@@..........@@@@@@@@@@@@@@@@@@@@@@@@
......@@@@@..@.......@@@@.@@.......@@@@@@@@@@@@@@@@@@@@@@@@
.....@@@@@@.........................@@@@@@@@@@@@@@@@@@@@@@@
......@@.@@.............@.............@@@@@@@@@@@@@@@@@@@@@
.......@...........@...........@......@@@@@@@@@@@@@@@@@@@@@
..@@..@@..@@.......@..@@..............@@.@@@@@@@@@@@@@@@@@@
@@@@@@....@@.@.........@@.@@...@.........@@@@@@@@@@@@@@@@@@
@@@@@@@....@@@.........@@..@.............@@@@@@..@@@@@@@@@@
@@@@@@@@@..@@@@....@....@.....@.....@@......@.....@@@@@@@@@
@@@@@@@@....@@.....@@...@........@@@@...@.........@@@@@@@@@
@@@@@@@@.........@@@.............@@@....@.........@@@@@@@@@
@@@@@@@@....@..........@@........@@@....@....@...@..@@@@@@@
@@@@@@@@@..@@....@..............@@@@....@...@@@.@....@@@@@@
@@@@@@@@@@.................@...@@@@@.......@@@@........@@@@
@@@@@@@...@..................@@@@@@@.......@@@@@........@@@
@@@@@@@...@.....@..............@@..........@@@@......@....@
@@@@@@@.........@@@@@@.........@....@@......@@@...@.......@
@@@............@@@@@@@@........@...........@...@...........
..@........@.@@@@@@@@@@@@@@@...............@...............
.............@@@@@@@@@@@@@@@..@@.......@@.@@........@......
.@.....@...@..@@@@@@@@@@@@@@.@@@.............@.............
.......@....@@@@@@@@@@@@@@@@.@@...........@................
..@.........@@@@@@@@@@@@@@@@.@@.......@.......@..@.......@@
............@@@@@@@@@@@@@@@@@@@@...@@@@.......@........@@@@
@...@.......@@@@@@@@@@@@@@@@@@@@@@@@@@@@@..............@@@@
@@...@.....@@@.@@@@@@@@@@@@@@@@@@@@@@@@@......@@......@@@@@
@@........@@@@..@@@@@@@@@@@@@@@@@@@@@@@@....@.........@@@@@
@@...@@........@@@@@@@.@@@@@@@@@@@@@@@@...............@@@@@
@..............@@@@@@...@@@@@@@@@@@@@@@............@.@@@@@@
@..............@@@@@@......@@@@@@@@@@@..............@@@@@@@
@..@@@.........@@@@@@@@@.@....@@@@@@@@....@@@......@@@@@@@@
...@@@@......@@@@@@.@..@@.....@@@@@@@@.....@@....@@@@@@@@@@
..............@@@@@.....@.......@@.@@....@@@@....@@@@@@@@@@
..............@@@@........................@@@@@@.@@@@@@@@@@
.@@@...@........@............@@........@.........@@@@@@@@@@
.@@.............@.........@........@.............@@@@@@@@@@
.@@...........................@....@@........@...@@@@@@@@@@
......@..@..@..@@............................@@@@@@@@@@@@@@
..@...............@@........@...............@@@@@@@@@@@@@@@
...........................@............@@...@@@@@@@@@@@@@@
@........@..@.@..@@@@@...............@...@...@@@@@@@@@@@@@@
@...@@.............@@@..........@............@..@@.@@@@@@@@
...........@@..............................@.......@@@@@@@@
....@...............@...@.@.......................@@@@@@@@@
.......................@@@@@@@.....@@.....@@......@@@@@@@@@
..@.....................@@@@@.................@..@@@@@@@@@@
......@@@@....@......@@@@@@@@...................@@@@@@@@@@@
.......@@@...@@@......@@@@@@@.......@........@@@@@@@@@@@@@@
@...........@@@@@@@...@@@@@@........@@@....@@@@@@@@@@@@@@@@
@@........@@@@@@@@@..@@@@@@@@@..@.@.@@@@@@@@@@@@@@@@@@@@@@@
@@@@@@..@@@@@@@@@@@..@@@@@@@@@@@@@@.@@@@@@@@@@@@@@@@@@@@@@@
8
41 19 0
38 16 0
58 25 0
28 12 0
8 23 0
12 7 0
52 33 0
39 24 0

41 37 0
11 32 0
22 16 0
41 38 0
56 24 0
9 3 0
45 51 0
23 53 0
