width 59
height 59
@@@@@@@@@@@...........@@@.....@@@@@@@@@@@@@@@@@@@@..@@@@@@@
@@@@@@@@@@@............@@.....@.@@@@@@@@@@@@@@@@@@@..@.@@@@
@@@@@@@@@.....................@...@@@@@@@@@@@@@@@@@@...@@@@
@@@@@@@@@@.............@..........@@@@@@@@@@@@@@@@@@@....@@
@@@@@@@@@@...............@@.......@@@@@@@@@@@@@@@@@@....@@@
@@@@@@@@@....@...................@@@@@....@@@@@@@@@.....@@@
@@@@@@@@........@...........@.@.....@@....@@@@@@..@@....@@@
@@@@@@@@............@.........@@@@.........@@@..........@@@
@@@@@@@@.......@.@.............@@@................@@...@@@@
@@@@@@@@.......@@@...........@@@@..@..............@...@@@@@
@@@..@@...@@........@@@@@@@@...@@.@@@.@@.............@@@@@@
@@...@@.............@@@@@@@.......@..@@@@@@.@........@@@@@@
@@@................@@@@@@@@..........@@@@@@............@@@@
@@@..............@@@@@@@@@@.......@@@@@@...............@@@@
..........@.......@@@@@@@@@......@@@@@@@....@...........@@@
..@....................@@@@...@...@@@@@@@@@@............@@@
.......@...............@@@@......@@@@@@@@@..............@@@
.....@@@...............@@@@..@@....@@@@@@@...@@...@..@..@@@
.....@@.........@......@@@@..@.....@@..@@...@.....@@@@@@@@@
@....@..................@@@......@.....@.......@...@@@@@@@@
@@@......................@@...................@....@@@@@@@@
@@@..@...............@.............................@@@@@@@@
@....@..............@@@....................@@......@@@@@@@@
@..............@@@@...@....................@......@@@@@@@@@
....@.....@.......................................@@@@@@@@@
............................@.........@@@@@..@@...@.@@@@@@@
@....................@...............@@@@@..........@@@@@@@
@...............@...@@@@@@@@@..........@@@...........@@@@@@
................@...@@@@@@.........@....@@@@.........@@@@@@
....................@@@@@@............@...@......@@@@@@@@@@
.@..........@@............@....@@.@...@...........@@@@@@@@@
...........@@@@....@.@@.............@.............@@@@@@@@@
...........@@@...@@@...........@..............@.@..@@@@@@@@
...........@@@....................@@@.....@@@@@.@..@@@@@@@@
@@..........@@..................@..@@......@@....@.@@@@@@@@
@@@.......@@@@@@...................@@@...........@.@@@@@@@@
@@@....@..@@@@@.......@.....@..@@....@.............@@@@@@@@
@@@@@......@@@@@.....@@........@...........@....@...@@@@@@@
@@@@@..@@@@.@@.................@..@@.......@......@@@@@@@@@
.........@@.@@...@..............@@.....@@.........@@@@@@@@@
............@@...........@......@.....@@@.........@@@@@@@@@
....@@.................@..@.....@......@.........@@@@@@@@@@
..................@...........@@@.@...............@@@@@@@@@
.......@........@@@@....@...........@..@@.........@@@@@@@@@
.........@@...@@@@@@@@..@..............@@.........@@@@@@@@@
.......@.@@@@.@@@@@@@@@.@@..@....................@@@@@@@@@@
..@........@@@@@@@@@@@@@.@............@.....@@@@@@@@@@@@@@@
............@@@@@@@@@@@@...@..........@.....@@@@@@@@@@@@@@@
............@..@@@@@@@.....................@@@@@@@@@@@@@@@@
@....@..........@@@@@@.....................@@@@@@@@@@@@@@@@
@..@@@......@@@.@@@@@@@@..............@....@.@@@@@@@@@@@@@@
...@@@.......@@.@@@@@@@@@....................@@@@@@@@@@@@@@
................@@@@@@@@@....................@@@@@@@@@@@@@@
@...............@...@@@@@.......@.@@@........@@@@@@@@@@@@@@
@.......@@...........@@@@........@.....@@....@@@@@@@@@@@@@@
@...........@........@@@..............@@@....@@@@@@@@@@@@@@
..........@.............................@@@@@@@@@@@@@@@@@@@
....@@@.....@......@.....@@@.....@....@@@@@@@@@@@@@@@@@@@@@
.....@@............@@...@@@@..........@@@@@@@@@@@@@@@@@@@@@
8
12 13 0
40 21 0
25 52 0
2 51 0
54 7 0
40 29 0
3 42 0
31 51 0

45 14 0
39 21 0
50 19 0
27 46 0
1 45 0
39 30 0
1 42 0
48 26 0
