width 59
height 59
@@@@@@.........@@@@@.....@.....@@@@@@@@@@@@@@@@@@@@@@@@@@@@
@@@@@..........@@.@@.....@@....@@@@@@@@@@@@@@@@@@@@@@@@@@@@
@@@@.....................@.@...@@@@@@@@@@@@@@@@@@@@@@@@@@@@
@@@@......@..@.............@..@@@@@@@@@@@@@@@@@@@@@@@@@@@@@
@@@@@..@.........................@@@@@@@@@@@@@@@@@@@@@@@@@@
@@@@@.@@........................@@@@@@@@@@@@@@@@@@@@@@@@@@@
@@@@..@@....................@@....@@@@@@@@@@@@@@@@@@@@@@@@@
@@@@.....@.......@@.........@@..@..@@@@@@@@@@@@@@@@@@@@@@@@
@@@@......@......@..............@..@@@@@@@@@@@@@@@@@@@@@@@@
@@@@...............................@@@@@@@@@@@@@@@@@@@@@@@@
@@@@@......@.........@.............@@@@@@@@@@@@@@@@@@@@@@@@
@@@..........@.....................@@@@@@@@@@@@@@@@@@@@@@@@
@@@...............................@@@@@@@@@@@@@@@@@@...@@@@
@@@...@......@@.....@...............@@@@@@@@@@@@@.......@@@
@.....@@.....@........@.............@@@@@@@@@@@@.........@@
......@@..............@........@....@@....@@@@............@
.......@@...........@@.........@....@......@@........@@....
.......@................@........@....@....@@........@@@...
.......@....@..........@@..@.......@.@......@.....@@@@@@...
@@@@..........@........@@.......................@@@@@......
@@............@........@@......@.....@@.@........@.........
@.@.............@..................@@@..@@..............@..
..........@......................@@@@...@@.@...............
.................................@@@....@@.................
.@@.@...............@....@@.....@@@@@......@..........@...@
..........@..@..........@@@.....@@@@@@.........@...........
@...........@@...........@......@@.@@@..........@@.........
@@............@..........@.@.....@.@@@........@@@@.........
@@.................................@@@..........@@.........
@@.@...............................@@....@.......@@@.......
@.............@...@@@............@.......@@@...@.@.....@@..
@..................@@@....................@@.....@.....@@@@
@..................@......................@@@@@@......@@@@@
@@..........@..@.........@@..@...........@.@@@@@@@...@@@@@@
@@@.@@@@...@@@@@.........@@.................@@@@.@...@@.@.@
@@@@@@@@.@@@@@@@@@..................@......@@@@.........@..
@@@@@@@@@@@@@@@@@@...............@@@.............@.........
@@@@@@@@@@@@@@@@.............@.........@.@....@..@@@.......
@@@@@@@@@@@@@@@@@............@.........@.........@@@.......
@@@@@@@@@@@@@@@..................@...............@@@.......
@@@@@@@@@@@@@@@........@...............@.........@@........
@@@@@@@@@@@@@@@........@@@...............@.......@@........
@@@@@@@@@@@@@@....@@...@@@........@..........@.............
@@@@@@@@@@@@@.....@@....@@........@@.....@...@@............
@@@@@@@@@@@@@@@@.......@@@.......@@@@......@@@.............
@@@@@@@@@@@@@@@@@..@...@@@.......@@...@..@@@@..............
@@@@@@@@@@@@@@@@@@.@..@@@@....@@@@@..@@...@@@.....@........
@@@@@@@@@@@@@@@.@@@@...@......@@@@@@..@@@@@...@...........@
@@@@@@@@@@@@.....@@@............@..@@@@@@@@.......@@......@
@@@@@@@@@@@.......@@...............@@@@@@@.....@.@.@@......
@@@@@@..@..........................@@@...@.......@.........
@@@@@.......@......................@@......@@...........@@.
@@@@@.@.....@.@..........@................@........@....@@@
@@@@..............@@.....@.........@.......................
@@@@@..............@.......................................
@@@@@.@..@.......@@@.@......@.........................@....
@@@@@........................@@...@..@@@@............@@....
@@@@@............@...@.......@@@@@@.@@@@@@..@.......@@@....
@@@@...@@...@...........@@......@@@@@@@@@.........@@@@@....
8
17 39 0
39 22 0
31 55 0
23 13 0
43 54 0
54 46 0
15 22 0
0 25 0

57 17 0
17 34 0
17 40 0
54 52 0
7 21 0
14 42 0
44 36 0
45 49 0
