width 59
height 59
@@@@@@@@@@@@@@@@@@@@@@...........@@...........@@@@@...@.@..
@@@@@@@@@@@@@@@@@@@@@@.....@@....@......@.....@@@@.........
@@@@@@@@@@@@@@@@@@@@@.................@........@@@..@...@@.
@@@@@@@@@@@@@@@@@.@@..........................@@@@.........
@@@@@@@@@@@@@@.....@............................@......@...
@@@@@@@@@@@@@@...............@@@@..........................
@@@@@@@@@@@@@@..@.........@.@.@@@..........................
@@@@@@@@@@@@@@.@....@.........@@@..........................
@@@@@@@@@@@@@..@...@@....@....@@@@......@.................@
@@@@@@@@@@@@@.....@@@.@..@....@@@@@..........@....@....@@@@
@@@@@@@@@@@@....@@@.....@@@...@@..........@......@@........
@@@@@@@@@@@@....@@@@....@@@@.................@@@@@.........
@@@@@@@@@@...............@@@@................@..@@.........
@@@@@@@@@@...............@@@@...........................@@.
@@@@@@@@@@.....@@........@@@@...........@.@..............@@
@@@@@@@@@@...@.@@@.......@................@@...............
@@@@@@@@@@@@@@@@@@............@..@....@...@@@@.....@@@..@..
@@@@@@@@@@@@@@@@@@....................@...@................
@@@@@@@@@@@@@@@@@....@..@@...........@@..@............@@@..
@@@@@@@@@@@@@@@@.....................@@..@...@..@.....@....
@@@@@@@@@@@@.......@....@....@.......@...........@@@..@....
@@@@@@@@@@@@.......@..............................@@.......
@@@@@@@@@@@@.....@....................@@@............@.@.@@
@@@@@@@@@@......@@@........@...........@...................
@@@@@@@@.........@@........@.@@..............@@@.@........@
@@@@@@@.....@...............................@@............@
@@@@@@@.....@......................@.@....@@@@.............
@@@.....................@...........@@....@@@@....@........
.@@..........@.@...................@@@....@@@............@@
..........@@.@@@@.......@.........@@@@.....@@.............@
.......@..@@@@...................@..@@@...@................
....@.....@@@@......@...............@@@@..........@........
@.@.....@..@....@.@.................@@@@...@@@@............
@@@........................@........@@...@.@@@@..........@@
@@@.............@@...............@..@......@@@@............
...............@............................@@@............
.....@@............................................@.......
..@.......@..............................@.....@..........@
@@@......................................@@................
@@@.......................@........@@..................@@@@
@@@...@@..................@@@@....@@.@..........@....@@@@@@
@@@@@@@..@................@@@@@......................@@@@@@
@@@@@@@..........@........@@@@@..................@..@@@@@@@
@@@@@@@...................@@@@@........@...........@@@@@@@@
@@@@@@@@@................@@@@@..........@..........@@@@@@@@
@@@@@@@@....@.......@........@....@.......@....@@....@@@@@@
@@@@@@@..........@@........@..............@...@@@.........@
@@@@@@@@.@.......@........................@....@.........@@
@@@@@@@@...@.......@......................@..@@..........@@
@@@@@@@@@@..................................@@@@.@@..@...@@
@@@@@@@@@@....@@..................@......@@.@@@@..@...@@@@@
@@@@@@@......................................@........@@@@@
@@@@@@@@.............@.............@.....@@........@..@@@@@
@@@@@@@..........................@.......................@@
@@@@@@@...@..........................@...........@.........
@@@@@@@@@.@@.@@@@@@....@..........@.............@@...@@@...
@@@@@@@@@@...@@@@@@@...@.......................@@@@@@@@@...
@@@@@@@@@@....@@@@@@@@@@...@@@.......@.....@...@@@@@@@@...@
@@@@@@@@@@@@..@@@@@@@@@@@@@@@@@@@....@@.......@@@@@@@@@...@
8
20 12 0
32 53 0
44 18 0
15 27 0
26 52 0
11 57 0
32 45 0
10 27 0

58 56 0
56 11 0
11 52 0
42 37 0
54 2 0
56 46 0
57 12 0
10 28 0
