width 59
height 59
@@@@@@@@@@@@@.......@.@@...@.....@......@@@@@@@@@@@@@@@@@@@
@@@@@@@@@@@...........@................@@@@@@@@@@@@@@@@@@@@
@@@@@@@@@@@...........@...@............@@@@@@@@@@@@@@@@@@@@
@@@@@@@@@@@.............@@.....@........@@@@@@@@@@@@@@@@@@@
@@@@@@@@@@@@@.........................@@@@@@@@@@@@@@@@@@@@@
@@@@@@@@@@@@@@............@.@.........@@@@@@@@@@@@@@@@@@@@@
@@@@@@@@@@@@@@...............@........@@@@@@@@@@@@@@@@@@@@@
@@@@@@@@@@@@@@@......................@@@@@@@@@@@@@@@@@@@@@@
@@@@@@@@@@@@@@.......................@@@@@@@@@@@@@@@@@@@@@@
@@@@@@@@@@...@.......................@@@@@@@@@@@@@@@@@@@@@@
@@@@@@@@@...@@......@...............@@@@@@@@@@@@@@@@@@@@@@@
@@@@@@@@....@@.@..............@..@@@@@@@@@@@@@@@@@@@@@@@@@@
@@@@@@.....@@@................@@@@@@@@@@@@@@@@@@@@@@@@@@@@@
@@@@@@.....@....@...............@@@@@@@@@@@@@@@@@@@@@@@@@@@
@@@@@@@................@..........@@@@@@@@@@@@@@@@@@@@@@@@@
@@@@@@@..@.......@..............@@@@@@@@@@@@@@@@@@@@@@@@@@@
@@@@@@@.....@@...........@........@@@@@@@@@@@@@@@@@@@@@@@@@
@@@@@@@.........@.....@..........@@@@@@@@@@@@@@@@@@@@@@@@@@
@@@@@@@..............@@............@@@@@@@@@@@@@@@@@@@@@@@@
@@@@@@.........@.....@@@.@.......@@@@@@@@@...@@@@@@@@@@@@@@
@@@@@@@..@....................@...@..@@@@@..@@@@@@@@@@@@@@@
@@@@@@............................@..@@@@@@.@@@@@@@@@@@@@@@
@@@@@@...............................@@@@@@.....@@..@@@@@@@
@@@@@@@....@@...............@.......@@@@@@@........@@@@@@@@
@@@@@@@@@@@@@@.@...........@@......@@@@@@@@@........@@@@@@@
@@@@@@@@@@@@@@@@.....@.....@@....@...@@@@@@..........@.@@@@
@@@@@@@@@@@@@@@@..@......................@@@@............@@
.@@@@@..@@....@..@.......@.........@@@...@@@@...@..........
........@@.........@......@.....@...@...@@.@@..............
..........@........@@@@.........@@..@.........@............
......@...@.....@...@@....................@...@.....@@.....
....@@....@.......................@...@@..@........@@@....@
..........@........................................@@@.....
@@..........@..............................................
@@.........@@.@...........................@.........@......
@..........@..............................@...@@...........
@....@...........@....@@.............................@....@
..@..@..@........@....................@..................@@
..@.@@..........@@...........@..............@............@@
.....@......@@@.@@..................@......@@..............
.......@..@.@@@@.........@.................................
.@.....@............@@.....................................
.....................@..................@..@@@...........@.
.....................@@@.@..@..............@@@.@@..@@......
.............@.......@@.....@.....@.......@@.......@@......
..........................................@@@.........@@...
...........@@@@@........@.................@@..........@@@..
........@@@@@@@@@.......@@...........................@@@@..
........@@@@@@@@@@......@@.....@@...@..................@@@@
.............@@@@@....@.@@....@@....................@..@@@@
........@@....@@.............@@@.....@@@@...@........@@@@@@
...@@.................................@@@@@@@.....@@.@@@@@@
@@@@@@@@..............@..............@@@@@@@@@.....@@@@@@@@
@@@@@@@@@@...@.......................@@@@@@@@@@@@...@@@@@@@
@@@@@@@......@.......@......@........@@@@@@@@@@@....@@@@@@@
@@@@@@.......................@........@@@@@@@@@..@@@@@@@@@@
@@@@@@...............@................@@@@@@@@@@@@@@@@@@@@@
@@@@@@@.......................@........@@@@@@@@@@@@@@@@@@@@
@@@@@@.......@@.@@.@@........@@.........@@@@@@@@@@@@@@@@@@@
8
35 47 0
46 43 0
19 25 0
19 18 0
7 50 0
44 31 0
31 56 0
30 23 0

27 8 0
50 32 0
23 21 0
5 49 0
35 28 0
45 33 0
33 48 0
7 43 0
