width 74
height 74
.@@@@@@@..@@@@@@@......@@......@@@@@@............@@@@@@@@..........@@@.@@@
.@.@@@@@..@@@@@@@.@....@@......@@@@@@@..........@@@@@@@@@@.........@@@.@@@
....@........@@@@.....@@@.......@@@@..............@@@@@@@@@............@@@
.............@@.........@......@@@@@.............@@@@@@@@................@
.....................@..@@....@@@@@@.............@@@@@@@@.................
.........@...................@@@@@@.@...............@@@@@..@.@........@@@@
@...@.........@.......@......@@.@@@.@...............@@@..............@@@@@
@..@....@...................@@......@...@@....@.@..........@..@......@@@@@
..................@@..............................................@.@@@@@@
..................@@........@@......................@......@....@@@@@@@@@@
............@....@@.@@......@@...........@@..@.............@.....@@@@@@@@@
..@@@.......@.......@@............@............@...@...........@@@@@@@@@@@
..@@@..........@....@@.........................@.....@.........@@@@@@@@@@@
..@@@..........@@@@@@@......@@@............@@............@.@....@@@@@@@@@@
........@......@@@@@@@@......@.........@.............@@..@@@@.@@@@@@@@@@@@
....@............@@@@........@@@.........@.......@........@...@@@@@@@@@@@@
...@@@...@......@@@@@@.......@@.....................@.........@@@@@@@@@@@@
...@@.@@........@@@@@@..........................@@@........@..@@@@@@@@@@@@
.................@@@@@@.................@@@@@...@@@@.........@@@@@@@@@@@@@
@...........@..................@@@......@@@@@@..@@@@..........@@@@@@@@@@@@
........@........@.....@.......@@@.....@@@@@@@@@@@@@@@@........@@@@@@@@@@@
........@.......@@.....................@@@@@@@@@@@@@@........@.@@@@@@@@@@@
.........@@.....@@@..........@@........@@@@@@@@@@@@@@....@.@@@@@@@@@@@@@@@
..........@@@...@@@@.........@@..@.@..@@@@@@@@@@@@@@@@.@@@.@@@@@@@@@@@@@@@
..@.....@....@...................@@@....@@@@@@@@@@@@@@@@@@@@@@@@@@@@@@@@@@
@@@..........@................@....@.....@@@@@@@@@@@@@@@@@@@@@@@@@@@@@@@@@
@.....................@.@@.@...............@@@@@@......@@.@@...@.@@@@@@@@@
@.....................@....@......@@.......@@@..........@.........@@@@@@@@
@.@........................@@.....@@.......@@@.........@@..@..@....@@@@@@@
...@........@...@@.......@.@.@.............@............@@...........@@@@@
.................@@...@.................@..@....@............@.......@@@@@
@@.............@@@@...@.................@...@.@@.......@..............@@@@
@@@...........@@..@@..@......@............@...@@@@.....@...@@........@@@@@
@..........@@....@@@@........@.........@.....@@.@@.........@@@........@@@@
........@@@@@..............@@@.........@.........@.....@....@@.......@@@@@
..@.....@@@@@..............@@.............................................
...@....@@@@@...........@.@@.....................@@.......................
...@.@..@@@@@........@..@@@.............@........................@..@@@...
........@@@@@...........@@......@@....@.@@..........................@@@...
.......@@@@@@@.............@....@@....@.@...........................@@@...
.....@@@@@@@@....@.................................@..........@@@@..@.....
......@@@@@@@@@............@......@@..@...................@....@@@........
......@@.............@...@.........@..@@..................@...............
..@...@.....@@....@@.....................@@@...........@..@@..............
..@@......................................@..........@.@.........@......@.
..................@...............@@@....@..........................@@@@@.
.@.........@....@........@....@...@.........@@..........@...........@@@@..
.@@@.........................@@..@................................@@@@@@@@
..@@...@@.....@..............@........@.....................@....@@@@@@@@@
@.@@@@@@@........................@@@........................@...@@@@@@@@@@
...@@@@...............@..........@@@@.......................@@..@@@@@@@@@@
@..@@@@.....@@..................@@@@@...............@@.....@@...@@@@@@@@@@
...@@@@.....@@..........@@.......@@@@.....@.........@@@@@@@@@@@@@@@@@@@@@@
.@............@........@@@@..@......@.@......@......@@@@@@@@@@@@@@@@@@@@@@
@@@......@....@.......@......@......@@@...@@.......@@@@@@@@@@@@@@@@@@@@@@@
@@@.........@@....@..@@.....@@......@....@@@...@@@.@@@@...@@@@@@@@@@@@@@@@
@@@@@.......@@..@@@@@@@@...@@@..................@...@@....@@@@@@@@@@@@@@@@
@@@@@.......@@@@@@@@@@@@@..@.........................@@....@@@@@@@@@@@@@@@
@@@@@.........@@@@@@@@@@@@....@..@....@......@@...............@@@@@@@@@@@@
....@.........@@@@@@@@@@@@....@..@..............@@@...........@@@@@@@@@@@@
..............@@@@@@@@@@@@......................@@@@..@.......@@@@@@@@@@@@
..........@...@@@@@@@@@@@.........@.....................@....@@@@@@@@@@@@@
..........@.@@@@@@@@@@@@@.........@.....@..............@@....@@@@@@@@@@@@@
...........@@@@@@@@@@@@@@.............@@@...@........@........@@@@@@@@@@@@
.......@@@.@@@@@@@@@@@@@@@.....@.....@@@@.......@@@...........@@@@@@@@@@@@
.........@@@@@@@@@@@@@@@@@...........@@@........@@@...........@@@@@@@@@@@@
..........@@@@@@@@@@@@......@........@@@......................@@@@@@@@@@@@
..........@@@@@@@@@@@..@.............@@@......................@@..........
.....@@...@@@@@@@@@@..................@.......................@...........
.@.@@@@@.@@@@@@@@@@@..................@.............@.@...................
.@.@@@@@@@@@@@@@@@@....@.............................@@@@.................
.@@@@@@@@@@@@@@@@@@@@.........@......................@@@..................
@@@@@@@@@@@@@@@@@@@@@@..............@..............@@@@@.@..@.....@@@..@..
@@@@@@@@@@@@@@@@@@@@@@@@@.......@@..@.@................@...@@..@@@@@@..@@@
8
42 66 0
39 43 0
23 13 0
37 62 0
25 32 0
54 10 0
23 33 0
23 36 0

28 63 0
4 24 0
45 62 0
39 59 0
62 38 0
54 10 0
64 3 0
68 7 0
