width 74
height 74
@@@@@@@@@@@@@@@@@@@@@@@@@@@@@@@@@@@@@@@@@@@@@@@@@@.....@.@.....@@@@@@@@@@@
@@@@@@@@@@@@@@@@@@@@@@@@@@@@@@@@@@@@@@@@@@@@@@@@@@............@@@@@@@@@@@@
@@@@@@@@@@@@@@@@@@@@@@@@@@@@@@@@@@@@@@@@@@@@@@@@@.............@@@@@@@@@@@@
@@@@@@@@@@@@@@@@@@@@@@@@@@@@@@@@@@@@@@@@@@@@@@@@@...............@@@@@@@@@@
@@@@@@@@@@@@@@@@@@@@@@@@@@@@@@@@@@@@@@@@@@@@@@@@@...............@@@@@@@@@@
@@@@@@@@@@@@@@@@@@@@@@@@@@@@@@@@@@@@@@@@@@@@@@@@................@@@@@@@@@@
@@@@@@@@@@@@@@@@@@@@@@@.@@@@@@@@@@@@@@@@@@@@@@@@@@...@....@......@@@@@@@@@
@@@@@@.@@@@@@@@@@@@@@@@...@@@@@@@@@@@@@@@@@@@@@@@@@@@@@@@..@.....@@@@@@@@@
@@@@@..@@@@@@@@@@@@@@@@.....@@.@@@@@@@@@@@@@@@@@@@@@@@@@@@........@@@@@@@@
@@@@@....@@@@@@@@@@@@@@......@.@@@@@@@@@@@@@@@@@@@@@@@@..@..@...@@@@@@@@@@
@@@@@...@@@@@@@@@@@@@@@.........@@@@@@@@@@@@@@@@@@@@@@@.......@@@@@@@@@@@@
@@@@@...@@@@@@@@@@@@@@@.........@@@@@@@@@@@@@@@@@@@@@@@.......@@@@@@@@@@@@
@@@....@@@@@@@@@@@@@@@@@........@@@@@@@@@@@@@@@@@@@@@@@.........@@@@@@@@@@
@@@....@@.@@@@@@@@@@@...@@......@@@@@@@@@@@@@@@@@@@@@@@............@@@..@@
@@@@.......@@@@@@@@@@...@.......@..@@@@@@@@@@@@@@@@@@....@....@....@@@@.@@
@@@@.......@@@@@@@@@...................@@@@@@@...@@@@................@@...
@@@@.....@@@@@@@@@@@@.................@@@@@@.....@@@@.....@...........@...
.........@@@@@@@@@@@@@@@@..@.......@..@@@@@@@....@@@@@....................
...........@@@@@@@@@@@@@......@@........@@@@......@@@................@...@
....@......@@@@@@@@@@@@@@.....@@...................@@.............@@@@@..@
...@@@@@......@@@@@@@@@@........@@......@..........@@.............@@@@@@.@
...@@@@@......@@@@@@@@@.....@@@.........@...@@................@..@@@@@@@@@
...@@@@......@@@..@@@@@@@@@@@@........@....@@................@....@@@@@@@@
.@..@@.......@....@.@@@@@@@@@@.@@@@.................@........@@...@@@@@@@@
.@..@.......@@.......@@@@@@@@@@@@@@.............@............@@...@@@@@@@@
....@..................@@@@@@@@@@@@@@@@@.....@@.......@......@@..@@@@...@@
@......................@@@@@@@@@@@@@@@@@..@....@.............@@@...@@...@@
@@@......@...............@@@@@@@@@@@@@@@.....@.........@......@........@@@
...@.....@....@@.........@@@@@@@@@@@@@...@.....@.............@@@........@@
..............@..........@@@@@.....@@@......@...........@@...@@.........@@
.@...........@@...........@@@@..............@...........@...............@@
.@@.@@...@.....@............@@..........................@...............@@
............@@@.............@@@...........@.....@.......@............@.@@@
@...........@@@.......@@@@...@@@...@@@.......@..@.@.....@@.@........@@@@@@
@@.@@.................@..@..@@@@@...@..................@..@@...@.....@@@@@
@@.........@.............@.....@@..........@@.............@....@@@@@@@@@@@
@@@...........@@@@................@.........@.........@...........@@@@@@@@
@@@..........@@.@@............@.............@@@@@@@...............@@@@@@@@
@@.......@............@..@...................@@@@@@...............@@@@@@@@
........................@......@............@@@@@@@@@...@@....@..@@@@@@@@@
............................................@@@@@@@@@..@@@.......@@@..@@@@
........@...........................@.....@@@@@@.@@@...@........@.@@..@@@@
...............@...................@@@@..@@@.....@@@..@@.....@@...@@..@@@@
.....@...@@................@@@@....@@@@..@........................@@..@@@@
.......@@@@@...............@@@@@..@@@@@.........................@..@......
.@.@@.@@@@@@@@@@@@........@@@@@@..@@@@.........@........................@.
...@@@@@@@@@@@@@@@........@@@@@@..@.@@......@@@...........................
.@@@@@@@@@@@@@@@@@........@@@@@@.@@....@......@..............@............
.@@@@@@@@@@@@@@.............@@@...@...........@@@....@@@@....@............
@@@@@@@@@@@@@..........@@............................@@......@@...........
@@@@@@@@@@@@@..........@@@@............@@............@..@....@............
@@@@@@@@@.@@@...........@@@@....................@...........@@@....@......
@@@@@@@@................@@@@......@.............@...........@@@@@@@@......
@@@@@@@@................@@@.......@.........@...@........@.@@@@@@@@@@.....
@@@@@@@.................@@....@..............@@..........@.@@@@@@@@@@.....
@@@@@@@.....@........@..@..........@........................@@@@@@@@@@....
@@@@@@.....@@...........@@@.....@@@@@@......@...............@@@@@@@@@@....
@@@@@@@....@@...........@@......@@@@.........................@@@@@@@@@@@@@
@@@@@@@....@............@@....@..@......................@...@@@@@@@@@@@@@@
@@@@.......@....................................@.@.........@@@@@@@@@@@@@@
@@@.......@@@...............................................@@@@@@@@@@@@@@
@@@@@....................@@.......@@......@@@...............@@@@@@@@@@@@@@
@@@@@@@........@@........@@...............@@@@@.@.@@.......@@@@@@@@@@@@@@@
@@@@@@@@@@...............@@@.....@.........@@@@@@.@@@....@@@@@@@@@@@@@@@@@
@@@@@@@@@................@@@...............@@.@@@@@@@......@@@@@@@@@@@@@@@
@@@@@@@@@.....@.@......@@@@..........@......@...@@@@.......@@@@@@@@@@@@@@@
@@@@@@@@@.@.......@....@@@.....@.....@.....@.......@@@@...@@@@@@@@@@@@@@@@
@@.@......@.......@............@..................@@@@@...@@@@@@@@@@@@@@@@
@..@@....................@....@@..................@@@@@...@@@@@@@@@@@@@@@@
@@.@.....@........@......@..............@@........@@@@@....@@@@@@@@@@@@@@@
@@.......@........@@@......@..................@@@@@@@@@.....@@@@@@@@@@@@@@
@@@@...........................@@@@.@...........@@@@@@.........@@@@@@@@@@@
@@@@.......................@..@@@@...@@.....@...@@@@@@.........@@@@@@@@@@@
@@@@.@......@..............@@@@@@@@@@@@..@@@@...@@@@@@.........@@@@@@@@@@@
8
65 49 0
7 34 0
11 69 0
8 22 0
20 67 0
15 30 0
30 64 0
43 20 0

57 59 0
4 35 0
40 24 0
53 3 0
60 29 0
38 62 0
67 29 0
20 67 0
