width 20
height 47
.................@@@
..........@.........
..@..@......@.......
....................
............@...@..@
.....@....@..@..@...
................@...
...@..@.............
..........@.........
...@....@......@....
..@....@............
...@........@.......
.........@.....@.@..
@...............@...
@@....@.....@...@...
@@.......@....@.....
@@@....@............
@@@...@.....@....@.@
@@@...............@.
@@@@@@@..@.@........
............@.......
....................
@....@..............
@..@..@.....@.@.....
........@.......@...
............@.......
..@.................
....@.....@....@..@.
..@..@..............
..............@.....
.........@.@........
...............@.@..
.............@......
........@........@..
............@.......
.......@..........@.
...@.@......@..@....
.........@..........
....................
.......@.....@.@....
@...............@...
@@..........@@......
@@..@.......@@......
............@@..@...
....@...@...........
.......@@.....@..@..
.......@@...........
6
9 35 0
18 1 0
18 44 0
18 29 1
13 28 1
5 30 1

3 12 0
11 1 0
19 1 0
19 34 1
11 34 1
0 20 1
