width 20
height 47
....@..............@
..@.@........@......
....................
.............@......
.......@.........@..
....................
...@......@....@....
......@............@
...................@
...@.@....@........@
........@....@..@..@
..........@...@....@
.......@....@.......
......@@..........@.
..@......@..@.......
....@.....@.........
........@.....@...@@
.......@..........@@
...................@
...@...........@....
.....@@.............
..................@.
..@.........@.......
.......@............
..........@..@......
....................
....@.....@....@....
......@@@@.@........
....................
...@.....@..........
..............@..@..
....@...@..@........
.......@.........@..
..................@.
..@.................
......@.@......@....
..@.................
..@....@............
....................
.........@..........
....................
.........@..........
....@.....@...@.@...
@..........@........
....................
......@............@
..............@.....
6
8 15 0
2 38 0
13 30 0
2 44 1
12 8 1
7 34 1

0 41 0
18 35 0
2 6 0
12 31 1
6 42 1
0 9 1
