width 20
height 47
....@@..........@@@@
....@@..........@@..
..........@......@..
...@................
......@......@......
....@...........@...
.................@..
@.......@..@........
....................
......@.......@.....
.......@............
.........@.@..@.@...
............@.......
.....@.........@....
..@......@.......@..
.....@..............
....................
......@@.@...@......
...@..........@.....
....@.....@.@....@..
........@........@..
.....@........@.....
...@....@...........
....@..@............
.................@..
..@.............@...
.@......@..@..@.....
................@...
.........@..........
..@..........@......
@...@....@........@.
.@.@................
.............@.@....
..........@.........
@..........@..@.....
....................
........@...........
......@....@.@......
..@............@....
....@...............
......@..@....@.....
..........@.........
....@.......@.......
..............@.....
...........@........
....@...............
....................
6
4 40 0
2 22 0
12 31 0
0 41 1
8 8 1
9 13 1

10 15 0
3 1 0
8 33 0
1 40 1
16 46 1
7 44 1
