width 20
height 47
...........@........
...............@@...
............@.......
@....@..............
@..@....@...........
................@...
....@.......@.......
....................
....@........@......
.........@........@.
..........@..@.@....
..@.................
...@................
......@.........@...
.........@.....@....
.@..@.......@.......
......@.......@.....
....@...............
....................
......@......@.....@
..........@.........
.................@..
.@.....@............
..............@.....
..@..........@......
.......@...@......@.
@...............@...
@..@.@..@......@....
...@@.......@.....@.
................@...
...............@....
....................
......@.............
........@...........
......@........@....
....@...@.........@.
.@..................
..@............@....
.....@.@..@.....@...
....................
....@...............
...@....@..........@
...@.......@...@....
.............@......
..@.................
.........@..........
........@...@.......
6
9 38 0
3 40 0
3 15 0
1 17 1
7 9 1
2 21 1

0 15 0
19 0 0
6 38 0
0 43 1
18 45 1
19 46 1
