width 20
height 47
@@@...........@@@@..
.......@.....@...@..
..@......@..........
.............@......
....................
...........@..@.....
..@............@...@
...................@
........@....@.@....
....................
@.@.@..@...@........
@.................@.
............@..@....
......@...@.........
.................@..
.....@..@.@..@......
..@.@...............
....................
.......@...@....@@..
....@...............
......@..@..........
....@...........@...
......@..........@..
....@......@........
..............@.@..@
........@...........
..@............@....
....@........@.@....
........@...........
....................
..@............@....
...@................
.......@@...........
...@...........@..@.
....@@..............
.@.@..@....@.....@.@
..@............@....
..@.......@...@.@...
......@.@...@.......
..@.................
.@..@....@......@...
.......@....@.@.....
....................
..@...@....@........
....................
.....@............@.
....................
6
17 43 0
1 32 0
6 8 0
0 32 1
15 9 1
5 25 1

11 27 0
19 1 0
6 6 0
9 14 1
15 32 1
6 31 1
