width 20
height 47
@@..@@@@.........@..
@...........@.....@.
@......@.......@@...
...........@.@......
@......@..........@.
..@..@...@..........
.............@......
....................
.@........@.........
.............@.@....
@......@..@.........
@.....@.............
@...............@...
....@.@.@...@.......
...............@....
..........@........@
.....@..@.....@.....
..@.........@..@....
..........@..@......
....................
.@..@...@...@...@...
....................
.....@............@.
........@.@.........
..@.................
.....@.@....@.@.....
................@...
.....@.@.@..........
.@..@...............
.................@..
...........@.@.@....
..@@........@.......
..@@................
...@@.........@.@...
...@@...............
......@............@
...................@
...@......@....@....
.......@..@........@
................@...
.........@...@......
.......@.......@@@@.
..@.................
.............@......
....................
....................
@@@......@@.........
6
19 19 0
10 6 0
10 43 0
3 17 1
10 36 1
12 11 1

18 43 0
16 45 0
2 2 0
18 44 1
6 39 1
11 11 1
