width 20
height 47
..............@.....
........@......@..@.
.........@..@.....@@
...@.@............@@
..@...............@@
.............@.....@
.@.......@......@..@
......@....@........
...@.@...@........@.
.......@....@.......
@................@..
........@......@....
..@.....@...........
...........@........
............@.......
....................
..@..@...@..........
...........@....@...
....................
.....@...........@..
........@.@.........
.......@......@.....
.@...........@......
.@...@......@.@.....
....................
.......@............
...@................
@.....@.......@.@...
.....@...@........@.
....................
..@.................
.........@..@.......
....................
.@..@.@...........@.
.....@..............
....................
...........@..@.....
.@....@.....@.......
....................
.@............@.....
................@@..
.........@.@........
....................
...@.......@...@...@
...................@
....@..............@
..................@@
6
14 29 0
18 12 0
4 20 0
8 32 1
15 38 1
16 8 1

6 4 0
7 45 0
17 41 0
0 0 1
16 4 1
2 3 1
