width 20
height 47
................@...
..@..........@.....@
@........@......@...
.....@..@....@...@..
............@...@...
...............@...@
....@....@..@......@
........@........@..
......@....@........
..@....@............
.@..............@...
....@....@..........
...@...@............
.......@.......@....
...@.........@......
..................@.
..@...@.............
...@...@............
.....@..............
.................@..
..@..........@......
.@.......@....@.....
....................
....@......@........
...@..........@.....
......@.@.@.........
.@..................
......@.@.@.@..@....
..@.@........@.@....
...............@....
........@.@.........
......@.....@.......
....................
.@@@............@...
...@................
.@..@...............
.............@..@...
........@...........
..........@.@..@....
...@..............@.
.........@..........
.....@..............
.......@............
...............@.@..
....@..@............
....................
....................
6
12 25 0
3 10 0
10 39 0
10 46 1
3 26 1
11 27 1

17 8 0
9 46 0
19 10 0
18 25 1
15 18 1
13 27 1
