width 20
height 19
....................
....................
..@.................
...............@....
....@..@............
.................@..
..@.........@...@...
...@...@.......@..@.
......@.............
.....@....@..@..@...
....................
....................
...............@....
....@....@.@........
.....@....@.........
......@........@..@@
..@.@...............
....................
......@.............
6
18 16 0
16 11 0
15 11 0
18 3 1
0 2 1
11 17 1

14 5 0
9 2 0
13 11 0
9 0 1
19 14 1
18 10 1
