width 20
height 19
@@@.................
.@@.........@.......
.............@......
....@.......@.......
......@.......@.....
....@...............
..............@...@.
..................@@
..........@.........
....................
....@...@.@.........
..............@.....
....................
..@...........@.....
.....@..............
....................
............@.......
.@......@...........
....@............@..
6
15 4 0
7 18 0
10 0 0
3 12 1
19 0 1
9 12 1

9 18 0
10 18 0
1 12 0
4 9 1
3 16 1
16 2 1
