width 20
height 19
@@....@..@..........
.....@...@..........
....................
.........@........@.
.....@..............
..............@.....
...@..@........@....
........@.@@@...@...
..@......@..........
....................
....................
.@......@@.@....@.@.
......@@@..@........
....................
..@..@.@............
....@...............
...@......@.........
.......@..........@.
..................@.
6
14 8 0
11 13 0
7 8 0
0 8 1
8 4 1
15 18 1

11 4 0
6 11 0
7 7 0
17 8 1
0 17 1
7 9 1
