width 20
height 19
@............@@.....
.............@......
...........@........
....................
..@.................
....@@@.....@.@.@...
..@..........@.@....
..........@.........
...............@....
.............@......
..@......@..........
...........@........
..@............@....
.....@..............
@...................
........@...@.@.....
...@.........@...@..
....................
...@................
6
1 2 0
1 4 0
17 11 0
5 10 1
6 10 1
0 6 1

7 0 0
7 11 0
11 17 0
2 3 1
14 6 1
6 14 1
