width 20
height 19
....................
....................
...@.@..............
..............@.@...
.@..................
..........@..@......
....@......@...@.@..
....................
..............@.....
@.........@.@..@.@..
......@....@........
....................
........@.......@...
.@@........@........
..@..@...@...@......
............@.@.....
...........@...@....
.@............@@@...
..............@@@@..
6
1 16 0
6 1 0
4 0 0
8 13 1
1 8 1
6 12 1

9 2 0
18 15 0
2 18 0
16 1 1
5 8 1
0 17 1
