width 20
height 19
.............@......
....................
................@...
...............@....
...@...@............
....@....@...@......
...............@....
...@....@........@..
...@@...............
.....@..............
......@.@....@......
.......@.@.......@..
....@.......@.......
.......@............
.........@......@...
..........@....@..@.
............@.......
....@...............
....................
6
14 1 0
2 14 0
10 5 0
6 3 1
2 16 1
5 14 1

5 1 0
0 11 0
15 14 0
8 3 1
3 5 1
10 7 1
