width 97
height 97
@@@@@@@@@@@@@@@@@@@@@@@@@@@@.....@..@.......@@@@@@@....@........@@....@@@@@@@@@@.....@.........@.
@@@@@@@@@@@@@@@@@@@@@@@@@@@................@@@@..@.....@.....@@..@....@@@@@@@@...................
@@@@@@@@@@@@@@@@@@@@@@@@@@.............................@....@@@..@@...@@@@@@.@..........@........
@@@@@@@@@@@@@@@@@@@@@@@@@...........................@@......@@@@.@@.@.@@@@.@.....................
@@@@@@@@@@@@@@@@@@@@@@@@@..................@................@@@..@@.@............................
@@@@@@@@@@@@@@@@@@@@@@@@.......@...............@............@@@@.@@...............@.............@
@@@@@@@@@@@@@@@@@@@@.@@........@@...................@@......@@@@...........@.....................
@@@@@@@@@@@@@@@@.....@@.......@@@@@.........................@........@...........................
@@@@@@@@@@@@@@@@......@.......@@@@@@@................................@.......@...................
@@@@@@@@@@@@@@@@@@............@@@@@@@@@...@.............................@@@........@..@.......@..
@@@@@@@@@@@@@@@@@............@@@@@@@@@@@@@@................@............@@.....@...@.@@..........
@@@@@@@@@@@@@@..@...........@@@@@@@@@@@@@@@................@......@.....@@....@@@..@...........@@
@@@@@@@@@@@.................@@@@@@@@@@@...@@..........@@...@..@@@@@...........@@@@@@...........@@
@.@@@@@@@@@@.@...............@@@@@@@@@......@.........@@......@..@........@....@@@@@@..........@@
...@@@@@@...................@@@@@@@@@......@.........@@@.....@@@......@......@@@@@@@@@...@.......
...@@@@..@@................@@@@@@@@@@................@@@.....@@@@@@.........@@@@@@@@@@...........
.@.@.............@.............@@@@@......@......@..@@@@@.....@@@@@..@......@@@@@@..@@..@@...@...
...........@....................@@.@@..........@@....@@@@......@@@@..........@@.....@@@.@@...@...
@...@.@....@........@@@....@@..@...@@.........@.@...@@@@@.......@@@...........@@....@@...........
@...@.....@@@........@@@....@.......................@@@@@@......@@@..@...........@......@........
....@.....@@................@.................@@...@@@@@@@....@.@@............@@@@...............
.....@@@......................@............@@@@@@@@@@@@@@@....@...@...@.......@@@@...............
..............................@.........@@@@@@@@@@@.............@.@........@..@@@@@........@.....
@@.......@..............@.............@@@@@@@@@@@@@........................@...@@.@...........@..
@@..@..@............................@.@@@@@@@@@@@@...@...............@................@..........
@@@...................................@@@@@@@@@@.........@......................@.........@....@.
@@@@...........@.......................@@@@@@@@@...............@.@..............@@...............
@@@@@@...............................@..@@@@@.........@...@.....@@..@................@@..........
@@@@@@.@.......@....................@@..@@@@@.............@..@......@................@...@@.....@
@@@@@..@.........@@@........@@..........@@@@......@...@@@....@@@...........@@@@.@...............@
@@@@@..@.......@@@@@@............@.........@...........@@....@.@......@....@@@@.............@@.@@
@@@@@.........@@@@..@...........@..........@@@...@@..@.@@@@@..........@........................@@
@@@@@@@@......@@@@..@@........@@@@@@...@@@................@........................@...........@@
@@@@@@@@@.@.@.......@@....@...@@@@@@...@@@@...............@....@@@..............@@.@...@.....@@@@
@@@@@@@@@...........@@.........@@@@@@.@@@..@.....@........@@...............@....@@@@@@.@.........
@@@@@@@@@@@................@...@@@@@@@@@@.................@@....@..........@....@@@@@@....@@.....
@@@@@@@@@@............@.........@@@@@@@@@.........@.......@...@@..........@@@@@@@@@@@@@.@@@@....@
@@@@@@@@@@@@@..........@........@@@@@@@@.........@@...@@@@@...............@@@@@@@@@@@@@@@@@@.....
@@@@@@@@@@@@@...................@@@@@@..........@@@..@@@@@@................@@@@@@@@@@@@@@@@@@....
@@@@@@@@@@@@@@@@@................@@@............@@@..@@@@@@......@.........@@@@@@@@@@@@@@........
@@@@@@@@@@@@@@@@@@.................@...........@@@@@.@@@@@@@.....@.@......@@....@@@@@@@@@.......@
@@@@@@@@@@@@@@@@@..................@@......@@@@@@@@@@@@@@@@@...@@...@......@........@@@@@@@.....@
@@@@@@@@@@@@@@@@@.................@@@....@..@@@@.@@@@@@@@@@@...........@............@@@@@@......@
@@@@@@@@@@@@@@@@@@@..@......@..@.........@@.@@@@.@@@@@@@@@@@............@........@..@@@@@@@....@@
@@@@@@@@@@@@@@@@@@@@@@..@@.@.............@@......@@@@@@@@@......@@@........@@@@@@@.............@@
@@@@@@@@@@@@@@@@@@@@@@..@................@@.....@@@@@@@@@.......@@.......@@@@@@@@@..@..........@@
@@@@@@@@@@@@@@@@@@@@@@....................@......@@@@@....@@.@............@@@@@@@@@.@@.........@@
@@@@@@@@@@@@@@@@@@@@@@@@........@.......@@@......@@@@@.......@@...........@@@@@@@..............@@
@@@@@@@@@@@@@@@@@@@@@@@@@...............@@@......@@@@.@.@@@@@@@@@..........@@@@@@....@.@.........
@@@@@@@@@@@@@@@@@@@@@@@@@................@@......@@@@...@@@@@@@@@......@@..@@@@@@@.....@.........
@@@@@@@@@@@@@@@@@@@@..@@@........................@..@@@...@.@@@@@.............@@@@.........@.....
@@@@@@@@@@@@@@@@@@@..@@@@..........@..@.............@@@.....@@@@@...@.........@@@@..@............
@@@@@@@@@@@@@@@@@@....................@@............@@......@@@@@@.............@...........@....@
@@@@@@@@@@@@@@@@@@@...............@...@@......@......@......@@.....@@...........................@
@@@@@@@@@@@@@@@@@@..................................................@@....@@...................@@
@@@@@@@@@@@@@@@@@..............................@.......@@...........@@@@..@@@@@......@..@.......@
@@@@@@@@@@...@@@.....................................@@.............@......@@@...................
@@@@@@@@@@@..................................................@@.@....................@.@.@@@....@
@@@@@@@@@@............@@...........@...@...............@@...@..............@...........@..@.....@
@@@@@@@@@.......@@.....@...............@.@................................@@....................@
@@@@@@@@@.......@@@@@@.................@........@@................................@.....@@@..@@@@
@@@@@@@@@......@@@@@@..........@.....@.@....@....@.........@........@.............@.........@@@@@
@@@@@@@@@@.....@@@@@@......@........@@@......@@.............@..@@..@@.......................@@@@@
@@@@@@@@@@....@@@..@@@...................................@...@.........@@....................@@@@
@@@@@@@@@@.........@@@.........@............@@..........@@@......@.........@@...@@.@.@@@.....@@@@
@@@@@@@@@......................@@@.@.......@@@......@...@@..............@@@@@....@@@@@@@@@.......
@@@@@@@@@@@@..............@.@@.@@@.................@@@@@@@@@@...........@@@@@@...@@@@@@@@@@.....@
@@@@@@@@@@@....@................@@.....@...........@@@@@@@@@@...@@.@....@@@@@....@@@@@@@@@@....@@
@@@@@@@@@@@@.................@..@@@...........@...@@@@@@@@@@@@..@@@@..@@@@@......@@@@@@@@@@@....@
@@@@@@@@@@@@.................@..@.......@@....@...@@@@@@@@@@@@@@@@@@......@........@@@@@@@@@....@
@@@@@@@@@@@@@@@@.@@@....@....@.....@..@@@@@.....@@@@@@@@@@@@@@@@@@@@@@@@..@........@@@@@@@......@
@@@@@@@@@@@@@@@@@@@.....@@@.......@@@@@@@@......@@@@@@@@@@@@@@@@@@@@@@.@.........@@@@@@@@@......@
@@@@@@@@@@@@@@@@@@@@@@@@@@@.......@@@@@@@@@@@..@@@@@@@@@@@@@@@@@@@@@@@.@.........@@@@@@@.......@@
@@@@@@@@@@@@@@@@@@@@@@@@@@@@.....@@@@@@@@@@@..@@@@@@@@@@@@@@@@@@@@@@@@...........@@@@....@.....@@
@@@@@@@@@@@@@@@@@@@@@@@@@@@@...@@@@@@@@@@@@@..@@@@@@@@@@@@@@@@@@@@@.........@....@@@.....@@......
@@@@@@@@@@@@@@@@@@@@@@@@@@@@..@@@@@@@@@@@@@@@@@@@@@@@@@@@@@@@@@@@.@.........@...............@@...
@@@@@@@@@@@@@@@@@@@@@@@@@@@@...@@@@@@@@@@@@@@@@@@@@@@@@@@@@@@@@@@...........@....................
@@@@@@@@@@@@@@@@@@@@@@@@@@@@@..@@@@@@@@@@@@@@@@@@@@@@@@@@@@@@@@@..@@............................@
@@@@@@@@@@@@@@@@@@@@@@@@@@@@@@@@@@@@@@@@@@@@@@@@@@@.....@@@@@@@@@@@@..........@................@@
@@@@@@@@@@@@@@@@@@@@@@@@@@@@@@@@@@@@@@@@@@@@@@@@@@@.@.....@@@@@@.@@...........@...@@@@@..........
@@@@@@@@@@@@@@@@@@@@@@@@@@@@@@@@@@@@@@@@@@@@@@@@@@@........@@@@@..@....@............@@@..........
@@@@@@@@@@@@@@@@@@@@@@@@@@@@@@@@@@@@@@@@@@@@@@@@@@@@@@.........@.....@.@.....@......@@@..@.......
@@@@@@@@@@@@@@@@@@@@@@@@@@@@@@@@@@@@@@@@@@@@@@@@@@@@@@@..@...............@@@...@....@@@@.........
@@@@@@@@@@@@@@@@@@@@@@@@@@@@@@@@@@@@@@@@@@@@@@@@@@@@@@@@@...........................@@@@@........
@@@@@@@@@@@@@@@@@@@@@@@@@@@@@@@@@@@@@@@@@@@@@@@@@@@@@@@@@...@.@................@................@
@@@@@@@@@@@@@@@@@@@@@@@@@@@@@@@@@@@@@@@@@@@@@@@@@@@@@@@@@.....@................@......@..........
@@@@@@@@@@@@@@@@@@@@@@@@@@@@@@@@@@@@@@@@@@@@@@@@@@@@@@@@@......................@.................
@@@@@@@@@@@@@@@@@@@@@@@@@@@@@@@@@@@@@@@@@@@@@@@@@@@@@@@@@@......................................@
@@@@@@@@@@@@@@@@@@@@@@@@@@@@@@@@@@@@@@@@@@@@@@@@@@@@@@@@@@...............@.....@@........@@......
@@@@@@@@@@@@@@@@@@@@@@@@@@@@@@@@@@@@@@@@@@@@@@@@@@@@@@@@@.....@................@@..@@............
@@@@@@@@@@@@@@@@@@@@@@@@@@@@@@@@@@@@@@@@@@@@@@@@@@@@@@@@@@@@............@..........@@............
@@@@@@@@@@@@@@@@@@@@@@@@@@@@@@@@@@@@@@@@@@@@@@@@@@@@@@@@@@@@.....@......@..........@.............
@@@@@@@@@@@@@@@@@@@@@@@@@@@@@@@@@@@@@@@@@@@@@@@@@@@@@@@@@@@@.......................@@@@........@@
@@@@@@@@@@@@@@@@@@@@@@@@@@@@@@@@@@@@@@@@@@@@@@@@@@@@@@@@@@@@@@...................@@@@@..........@
@@@@@@@@@@@@@@@@@@@@@@@@@@@@@@@@@@@@@@@@@@@@@@@@@@@@@@@@@@@@@@...................@@@@@..@@@@@....
@@@@@@@@@@@@@@@@@@@@@@@@@@@@@@@@@@@@@@@@@@@@@@@@@@@@@@@@@@@@@................@..@@@@@@@@@@@@@@@@.
@@@@@@@@@@@@@@@@@@@@@@@@@@@@@@@@@@@@@@@@@@@@@@@@@@@@@@@@@@@@@.@@...@.......@.@..@@@@@@@@@@@@@@@@@
8
73 55 0
58 19 0
12 13 0
32 20 0
1 20 0
70 67 0
73 18 0
84 6 0

27 21 0
53 36 0
48 11 0
34 20 0
28 54 0
2 14 0
26 6 0
12 59 0
