width 97
height 97
@@@@@@@@@@@@@@@@@@@@@@@@@@@@@@@@@@@@@@@@@@..........@.......@.@..@@@@.@@@@@@@@@@@@........@@@@@@@
@@@@@@@@@@@@@@@@@@@@@@@@@@@@@@@@@@@@@@@@@@......@..@@@@.......@..@@@@.@@@@@@@@@@@@.........@.@@@@
@@@@@@@@@@@@@@@@@@@@@@@@@@@@@@@@@@@@@@@@@........................@@@..@@@@@@@@@@@@...........@@@@
@@@@@@@@@@@@@@@@@@@@@@@@@@@@@@@@@@@@@@@@@@.........................@..@@@@@@@@@@@@@@..@@.....@@..
@@@@@@@@@@@@@@@@@@@@@@@@@@@@@@@@@@@@@@@@@@.......@........@...........@@@@@@@@@@@@@@@..@@........
@@@@@@@@@@@@@@@@@@@@@@@@@@@@@@@@@@@@@@@@@@............................@@@@@@@@@@@@@@@.....@.....@
@@@@@@@@@@@@@@@@@@@@@@@@@@@@@@@@@@@@@@@@@.............................@@@@@@@@@@@@@@@@@.........@
@@@@@@@@@@@@@@@@@@@@@@@@@@@@@@@@@@@@@@@@..............................@@@@@@@@@@@@@@@@@...@.....@
@@@@@@@@@@@@@@@@@@@@@@@@@@@@@@@@@@@@@@@@..................@@..........@@@@@@@@@@@@@@@@@..........
@@@@@@@@@@@@@@@@@@@@@@@@@@@@@@@@@@@@@@..........@.........@..@.........@@@@@@@@@@@@@@...@@.......
@@@@@@@@@@@@@@@@@@@@@@@@@@@@@@@@@@@@@@.......@....................@.....@@.@@@@@@@@@@...@@.......
@@@@@@@@@@@@@@@@@@@@@@@@@@@@@@@@@@@@@........@.........@@@...............@.@@@..@@@@....@@.......
@@@@@@@@@@@@@@@@@@@@@@@@@@@@@@@@@@@@............@......@@.......................@@@.....@@.@.....
@@@@@@@@@@@@@@@@@@@@@@@@@@@@@@@@@@@@@@......@.........@@........@..........@.....................
@@@@@@@@@@@@@@@@@@@@@@@@@@@@@@@@@@...@............@....@........@...@......@...@@............@...
@@@@@@@@@@@@@@@@@@@@@@@@@@@@@@@@@@............@@@@@@@...............@.......@.@.....@..........@@
@@@@@@@@@@@@@@@@@@@@@@@@@@@@@@@@@@..@@@........@@@@@@...................................@........
@@@@@@@@@@@@@@@@@@@@@@@@@@@@@@@@@@@@...@.......@@@..................@...........@.......@........
@@@@@@@@@@@@@@@@@@@@@@@@@@@@@@@@@@@@...........@@@...@..............@...@.......@...@@...........
@@@@@@@@@@@@@@@@@@@@@@@@@@@@@@@@@@@@...........@@......................@........@@..@@..........@
@@@@@@@@@@@@@@@@@@@@@@@@@@@@@@@@@@@@@@@........@@....@..........@@...........@@.@...@@@@@.......@
@@@@@@@@@@@@@@@@@@@@@@@@@@@@@@@@@@@@.@@.......@@@@...@@@@.@.....@@@.@@@....@........@@@@@........
@@@@@@@@@@@@@@@@@@@@@@@@@@@@@@@@@@@..................@@@@@@.....@...@@@....@@.....@.@@...........
@@@@@@@@@@@@@@@@@@@@@@@@@@@@@@@@@@@...@...............@@@@@@@@@@....@.............@@@............
@@@@@@@@@@@@@@@@@@@@@@@@@@@@@@@@@........@@@.....@@...@@@@@@@@@@....@......@....@............@@..
@@@@@@@@@@@@@@@@@@@@@@@@@@@...@@...@....@@@@@@........@@@@@@@@@@@@@.@......@.........@...........
@@@@@@@@@@@@@@@@@@@@@@@@@@@@@...................@@@...@@@@@@@@@@@@@.......@@............@@@.....@
@@@@@@@@@@@@@@@@@@@@@@@@@@@@@.....@...........@.@@@@@...@@@@@@@@@@@...@...@@................@@@@@
@@@@@@@@@@@@@@@@@@@@@@@@@@@@@@................@@@@@@@..@@@@@@@@@@@@...@@.........@........@@@@@@@
@@@@@@@@@@@@@@@@@@@@@@@@@@@@.................@@@@@@@@..@@@@@@@@@@@@@..@@@@.......@........@@@@@@@
..@@@@@@@@@@@@@@@@@@@@@@@@@@..................@@..@@@...@@@@@@@@@@@@...@@...@......@.......@@@@@@
..@@@@@@@@@@@..@@@@@@@@@@@@@.....@...@........@@..@@@....@@@@@@@..@@...@@...@..........@@@@@@@@@@
...@@@@@@@@.@..@.@@@@@@@@@@....@@@@............@...@@....@@@@@.........@@...@...........@@@@@@@@@
@@.@@@@@@@@......@@@@@@@@@@......@@@.@..............@.....@@@@............@.............@@@@@@@@@
@@.@@@@@@@@.......@@@@@@@@@@....@@@@@@......................@@@...@...............@.....@.@@@@@@@
@@..@@@@@@........@@@@@@@@..@...@@@@.@........................@........@..................@@@@@@@
@@.@@@@@.@@.......@@@@..@...@....@@....@@@.......................@.................@@.....@@@@@@@
@...@@@@..@........@.......@...@@@@..@@@@............@@@.................................@.@@@@@@
@...@@@@.....@................@@@@@..................@@.......@.......@...@...................@@@
....@@@@....................@@@@...........@....@@.@.....@.@@......@@............@....@@......@@@
............................@@@@........................@@.........@@................@@@.......@@
.............@@@.....@......@...........@.........@................@@.......@...........@@@......
.............@@@@....@..@..............@@@@@@.........@...............@@@........................
....@.@@.....@@@...@.@...@@@@.@.......@@@@@@@.....@...@@@@....@@........@........................
..............@......@@.....@@@........@@@@@.....@@...........@@...............@.................
...........@..............@@@@@........@@@@......@@............@.....@..@........................
.........................@@@@@@........@@@@....@..@..................................@...........
..........................@@@@@....@...@@............................@@@.@...........@@..........
...@.....@................@@...........@@...............@@.......@@..@@...................@.....@
...............@........@.@@....@......@.................@@@....@@................@@.@@@..@@..@@@
.@@@...........@@...@@..........@..........@@...........@@@@......................@@@@@@..@...@@@
................@...............@...@......@@@.........@@@@@@....@...@...@.@@@@.....@@@@..@....@@
@..............@@@.@............@...........@@@@.......@@@@@@@@..............@@@.....@@........@@
@@.............@@@.@............@@........@@@@@@@@@......@@..................@@@.....@....@@...@@
@@.............@@...............@@........@@@@@..@@.@@.......................@@@.............@@@@
@@..............@@@@@.............@.......@@.....@...........@@@............@@@@@............@@@@
@...............@@@........................@...............@.@@@..@@.........@@@@..........@@@@@@
@@@@............@@....@@@........................@...........@@...............@@...........@@@@@@
@@@@...........@.....@@@@...........@@...@........@..........@@........@.......@...........@@.@@@
@@@@...@@............@@@@@.@.........@@@....@................@@@@........@...........@..........@
@@@@@...@...........@@@@@@@..........@......@@@@.............@@@......@.....@..@...............@@
..@@@...............@@@@@..........@.@......@@@@.....@@.......@............@@@@@@@@@@.@.....@....
..@@@...............@@@@@...............@.@..@@.....@@@....................@..@@@@@@@..@@........
..@@@@................@.@@.....@@@................@........................@..@@@@@@@@@@@@.......
@....@@........@....@......@@...@@.....@@@@...@.....................@.....@@..@@...@@@@@@@@......
@..............@..........@@@...@......@@@@.@...................@...@@.@..@@..@@..@@@@@@@@.......
.......@..@...........@@@@@@.......@@@@@@@@@@@@......@.......@@@@...@@@@@..@.....@@@@@@@@@.......
....@..@@..................@.......@@@@@@@@@@@@.....@.......@.@@@@...@....@......@@@@@@...@......
..@.@...@@@@.......................@@@@@@@@@@@@...............@@@......@@......@.@@@@@@.........@
.........@@@.....@@@............@@@@@@@@@@@@@@................@@@................@@@@@@..@.....@@
.........@@@....@@@@.@..........@@@@@@@@@@@@@......@@.......@..@@@@.............@..@...@........@
.......@@@......@@@..@@..@@@...@@@@@@@@@@@@@@.....@@@@@..@@....@@....@.....@....@..............@@
.......@@@......@@@..@@.......@@@@@@@@@@@@@@@@@@@@@@@@@@.......@@............@.......@.@.........
...@....@@...@@@@@@@@@.........@@@@@@@@@@@@@@@@@@@@@@@@@........@.............@..@@@...@........@
...@@....@....@@@@@@@@@........@@@@@@@@@@@@@@@@@@@@@@@@@.@.....@....@@....@@@....@@@@...........@
@@@@@........@@@@@@@@@@@..@....@@@@@@@@@@@@@@@@@@@@@@@@@@@@..............@@@..@@.................
@@@@..........@@@@@@@@@@@.@@@@.@@@@@@@@@@@@@@@@@@@@@@@@@@@@@.....................@@@....@@.......
@@@...........@@@@@@@@@@@@@@@@@@@@@@@@@@@@@@@@@@@@@@@@@@@@@@@.....................@@...@@@....@@.
@@@.@........@@@@@@@@@@@@@@@@@@@@@@@@@@@@@@@@@@@@@@@@@@@@@@@@................@.....@...@@@.....@.
@@@@.........@@@@@@@@@@@@@@@@@@@@@@@@@@@@@@@@@@@@@@@@@@@@@@@@....@...............@.....@@@.......
@@@@@......@.@@@@@@@@@@@@@@@@@@@@@@@@@@@@@@@@@@@@@@@@@@@@@@.....@@.....@..@......@@............@.
@@@@@@@....@@@@@@@@@@@@@@@@@@@@@@@@@@@@@@@@@@@@@@@@@@@@@@@@@@@.@@@.......@@....................@@
@@@@@@@@..@@@@@@@@@@@@@@@@@@@@@@@@@@@@@@@@@@@@@@@@@@@@@@.@@@@@@.........@@@@........@@...@.@..@@@
@@@@@@@@@@@@@@@@@@@@@@@@@@@@@@@@@@@@@@@@@@@@@@@@@@@@@@@....@@....@@......@....................@..
@@@@@@@@@@@@@@@@@@@@@@@@@@@@@@@@@@@@@@@@@@@@@@@@@@@@@@@@@..@@@...@@..............................
@@@@@@@@@@@@@@@@@@@@@@@@@@@@@@@@@@@@@@@@@@@@@@@@@@@@@@@.....@@...@@............@.......@........@
@@@@@@@@@@@@@@@@@@@@@@@@@@@@@@@@@@@@@@@@@@@@@@@@@@@@@@@.....@@.@.@@@@..................@@......@@
@@@@@@@@@@@@@@@@@@@@@@@@@@@@@@@@@@@@@@@@@@@@@@@@@@@@@@@@.....@@@.@@@.............@.....@@@@......
@@@@@@@@@@@@@@@@@@@@@@@@@@@@@@@@@@@@@@@@@@@@@@@@@@@@@@@@.....@...@@@....................@@@@.....
@@@@@@@@@@@@@@@@@@@@@@@@@@@@@@@@@@@@@@@@@@@@@@@@@@@@@@@@........................@@.......@.......
@@@@@@@@@@@@@@@@@@@@@@@@@@@@@@@@@@@@@@@@@@@@@@@@@@@@@@@@.@...................@..@................
@@@@@@@@@@@@@@@@@@@@@@@@@@@@@@@@@@@@@@@@@@@@@@@@@@@@@@@...........@@@...@@.......................
@@@@@@@@@@@@@@@@@@@@@@@@@@@@@@@@@@@@@@@@@@@@@@@@@@@@@@.............@@@..........@..............@@
@@@@@@@@@@@@@@@@@@@@@@@@@@@@@@@@@@@@@@@@@@@@@@@@@@@@@..............@@...........@@@@@..@@......@@
@@@@@@@@@@@@@@@@@@@@@@@@@@@@@@@@@@@@@@@@@@@@@@@@@@@@@...............@...@.@........@@@@@@@.@@..@@
@@@@@@@@@@@@@@@@@@@@@@@@@@@@@@@@@@@@@@@@@@@@@@@@@@@@@.......@....@....@.@..........@@@@@@@@@@..@@
@@@@@@@@@@@@@@@@@@@@@@@@@@@@@@@@@@@@@@@@@@@@@@@@@@@@@......@@........@@@@..........@@@@@@@@@@..@@
8
31 30 0
56 31 0
32 45 0
85 76 0
76 18 0
88 72 0
80 44 0
87 89 0

29 25 0
63 94 0
75 76 0
48 49 0
5 77 0
87 69 0
0 43 0
86 87 0
