width 97
height 97
@@@@@@@@..........@@@@@@@@@.....@@@...............@@@@@@@@@@@@@@........@@@@@@@@@@@@@@@@@@@@@@@@@
@@@@@.............@@@@@@@@@@....@.....@............@@@@@@@@@@@@@..........@@@@@@@@@@@@@@@@@@@@@@@
@@@@@@@@..........@@@@.@@@@@@.........@............@@@@@@@@@@@@@..........@@@@@@@@@@@@@@@@@@@@@@@
@@@@@@@@........@..@@@.@@...@..................@@....@@@@@@@@@............@@@@@@@@@@@@@@@@@@@@@@@
@@@@@@@@.@..........@@..@.......................@...@@@@.@@@....@.........@@@@@@@@@@@@@@@@@@@@@@@
@@@@@@@@@@...@.....@@@..@..........@................@@@...@................@@@@@@@@@@@@@@@@@@@@@@
@@@@@@@@@..@...............................@..........................@....@@@@@@@@@@@@@@@@@@@@@@
@@@@@@@.@...........................@....@@@..@.............@@.......@@@.....@@@@@@@@@@@@@@@@@@@@
@@@@@@@...........@............@@...........................@@.@.......@......@@@@@@@@@@@@@@@@@@@
@@@@@@@...................................................@.@..................@@@@@@@@@@@@@@@@@@
@@@@@@@@......@@...........@...................................................@@@@@@@@@@@@...@.@
@@@@@@........@@@@@..................@.@...@..@@@@..............................@@@@@@@@@@@...@..
@@@@@@........@@@...............@.@..@.......@@@@@...............@@@@@........@.@@@@@@@@@........
@@@@@@...@....@@@@..............@.......@@...................@......@@@.........@@@@@@@@@@...@...
@@@@@@@@@@....@.............@...................@.........@@.@....@.@@@........@@@@@@@@@@@.......
@@@@@@@@...........@........@..............@...............@..................@@@@@@@@@@@@.......
@@@@@@@@..@.@..................@@@@@@.........@.....@@............@...........@@.@@@@@@..........
@@@@........@@...........@....@@@@@@@.@...@@@.@@@...@@.@@.....................@...@@@@...........
@@@....................@.@@...@@@@@@@.....@@@...@...@..@..........................@@@@@........@.
@@@....@..................@@@@@@@@@@@@@@.@@@..........@@.@@@........@@@......@....@@@@@@@....@...
..........................@@@@@@@@@@@@@@@@@@............@@@@.........@@@.............@@@@........
.....@....................@@@@@@@@@@@@@@@@@.............@@@@......@@.@.......@@@......@.@........
...@.........@.@...........@@@@@@@@@@@@@@@@.....@@.......@...........@@....@@@@@........@......@.
.....................@........@@@@@@@@@@@@@.@............................@@@@@@@.................
...@@.............@@....@....@@@@@@@@@@@@@@.......@.....................@@@@@@@@.....@..........@
................@@@@.........@@@@@@@@@@@.@@.......@@...........@.@.....@@..@@@@@..@..............
....@@@@@@......@.@........@@@@@....@@@@.........@@@.....@..@..@.......@...@@@@...@.......@......
@@@@@@@@@@...........@@....@@@@@@@@......@....@..........@.....@@......@....@.@.............@@...
@@@@@@@@@@...........@@....@@@@@@@@.....@@..............@@@.................@...............@....
@@@@.@@..............@......@@@@@@@@......@.@..@.......@@.......@@@@@.......................@....
@@@@......@......@@....@....@@@@@@@@.@@@@.....@..@.....@@@@@..@.@@@@@...................@...@....
@@@.........................@@@@@@@@@@@@@@@......@...@.@@@@@..@@@@@@@............................
......................@.@@@.....@@@@@@@@@@@@@..........@@@@@@@@@@@@.@......@@....................
@........@@@@..@@..@..@@@@@@....@@@@@@@@@@@@@@.........@@@@@@@@@@...@@.......................@@@.
@@..@.@@................@.......@@@@@@@@@@@@.......@@.@@@@@@@@@@@...@@......@@.......@.........@@
....@....................@...@@@@@@@@@@@@@@@.......@@@@@@@@@@@@@....@@.....@.....@..@@@..........
............@@...............@.@@@@@@@@@@@@@......@@@@@@@@@@@@@@@@...@....@.........@@@.......@..
@...@@......@@@...................@@@@@@............@@@@.@@@@@@...@...@..............@@......@@..
@............@@@...................@@....@.........@@@@@..........@..@...........................
@@..........@.@@.......@...........@@@...@.........@@.@...........@@.............................
@@@.........@.....@.........@@...@@@@@@..........................................................
@@@.........@@....@@.......@@....@@@@.......@@..@.......@.................@................@@@...
@@..........@......@............@@@@@@.........@....@@..@@.....@.......@@.@.....@..@......@@@@...
@@..........@......................@@..................@@@.....@.......@........@..@.......@.@...
@@....................@...........@.....@..............@@...........@...........................@
@@@@@.......@..........@@.......@@....@......@..........@@@@@@@.@...............@......@........@
.@@@@..@..@@.........................@@..........@......@@@@@@@@@.@....@@@@...@@.....@.@........@
.@@@...@..@..........@............................@@....@@@@@@@@@@@@...@@@@@@..........@........@
.......@@@@..............@@...............@.......@@@...@@@@@@@@@@@@...@@@@..@.........@.........
.......@@@@..............@.......@......@..........@@..@@@@@@@@@@@@.....@@............@@..@......
.......@@@@@.............@@@....@@....@.@@@@@@......@@..@@@@@@@@@@@@...............@@@....@@@....
.......@@...............@@@@..........@@@@@@@@.......@..@@@@@@@@@@@@......................@@@....
.......@@..........@@...@@@@...@..@...@@@@@@@@..........@@@@@@@@@@@@.......@...@..........@.@....
.@.....@@......@...@@..@@@@@...@..@@..@@@@@@............@@@@@@@@@@@@......@@...@@..@.............
.@......@@..@@@@@@@@@@@@@@@@@.........@@@@@.........@..@@@@@@@@@@@@@@@@....................@.....
............@@@@@@@@@@@@@@@@@@@@@....@@@@@@.........@@.@@@@@@@@@@@@@@@...@......@..@............@
@.@@@........@@.@@@@@@@@@@@@@@@@@@@.@@@@@@@@@......@@@@@@@@@@@@@@@@@@..@........................@
..................@@@@@@@@@@@@@@@@@@@@@@@@@@.......@@@@@@@@@@@@@@@@@@.@@.......@@....@...........
..@.....................@@@@@@@@@@@@@@@@@@@@.......@@@@@@@@@@@@@@@....@@@......@.............@...
..@....................@@@@@@@@@@@@@@@@@@@@@@@@...@.@@@@@@@@@@@@@....@@........@........@@@......
.............@..........@@@@@@@@@@@@@@@@@@@@@@@@.....@@@@@@@@@@@@@.@.............................
.......................@@@@@@@@@@@@@@@@@@@@@@@.......@@@@@@@@@@@@@@@@.................@..........
......@..@@@@..........@@@@@@@@@@@@@@@@@@@@@@@.......@@@@@@@@@@@@@@@@........................@...
..........@@@......@....@@@@@@@@@..@@@@@..@@@..........@@@@@@@@@@.............@..................
..........@@.......@....@@@@@@@@@@.........@@@.........@@@@@@@..@...............@..........@.....
...................@...@@@@@@@@@@@...@.....@@.......@@..@...@...@.............@@@....@.....@...@.
.@@..............@.......@@@@@@@@@...@...@..........@@@@@........@@.....@.......@@.........@@@...
..@@.........................@@@@@...@...@@.............@..@.....@@.....@@...@@.............@@...
........@..@@..@......@....@.@..@@.......@@........@.......@@....@@@@....@..................@....
........@............@.............................@.......@.....................................
.....@..@....@....................@...................................................@@.........
@..@...@@.@@@@@@@@........@@...........@........@@...@.................@......@......@@@.........
@@@@..@@@@@@@@@@@@.............@@@....@@................@.............................@@@........
@@@@@@@@@.@@@@@......................@@@..@@@.....@...@@@.......................................@
@@@@@@@@@....@@...@..........@@....@@@@@@..@..@......@@@@............................@...........
@@@@@@@@@@...@@@..@.........@@@@@...@@@@@@@@........@@@@....@@@......@@@@...@....@..@@...........
@@@@@@@@@...@................@@@@..@@@@@@@@@@.............@..@@....@.@@@@..............@........@
@@@@@@@@@.......@.............@@@@@@@@@@@@@@..@@@............@@......@@@@.@@...........@......@.@
@@@@@@....@...@@@@......@@@@..@@@@@@@@@@@@@@@..@@............@@@......@@..@@...............@.....
@@@@@@@.......@.........@@@@@@@@@@@@@@@@@@@@@..@@........@................@..@...@@@..@..........
@@@@@@@..............@@@@@@@@@@@@@@@@@@@@@@@@...@...@....@..@.......@.....@...@@@@@@......@....@.
@@@@@@@..............@@@@@@@@@@@@@@@@@@@@@@@@.......@.@.............@.......@@@@@@@@@@...@@....@@
@@@@@@@@@@.........@@@@.@@@@@@@@@@@@@@@@@@@@@.......@@@.....................@@@@@@@@@@...@.....@@
@@@@@@@@@@@......@.@@@@..@@@@@@@@.@.@@@@@@@.........@@@.....................@@@@@@@@@..........@@
@@@@@@@@@@@..@........@..@@@@@@@@...@@@.@@@@.@@@...@@@@@....................@@@@@@@@....@....@@@@
@@@@@@@@@@@..@..........@@@@@@@@@.......@@@@..@@....@@@@@..............@....@@..@.@.....@.....@@@
@@@@@@@@@@@................@@@@@@.......@@@@@..@....@@@@@..........@@..@@@..@@....@............@@
@@@@@@@@@@@....@........................@@@.............@..........@@.......@.@.........@......@@
@@@@@@@@@@...............@..@.....@....@@@@@....@....@......@@@..@@@@.............@.............@
@@@@@@@@@@..@@.@........................@@@@.........@@@....@@@@@@@@@.....@.......@.......@@....@
@@@@@@@@@@@@@@@@...@.....................@@@......@..@@@....@@@@@@@@@.........@@...@.....@@@.....
@@@@@@@@@@@@@@@@...@@@........@@@..@.....@@........@........@@@@@@@@@@@.......@@...........@....@
@@@@@@@@@@@@@@@@.....@@.@...@@.@@..@.@..@@@.................@@@@@@@@@@@.....@@@.@................
@@@@@@@@@@@@@@@@.....@@............@@@............@.........@@@@@@@@@@@@@.@.@@@..................
@@@@@@@@@@@@@@@@...................@@@@@@.........@...@@...@@@@@@@@@@@@@@.@@@@@.....@.@......@...
@@@@@@@@@@@@@@@@...................@@@@@@@........@@..@@@@@@@@@@@@@@@@@@@.@@@@....@...@.@....@@..
@@@@@@@@@@@@@@@@...................@@@@@@@........@@@@@@@@@@@@@@@@@@@@@@@@@@@@...@..@@@.@....@@@@
8
38 65 0
4 67 0
87 55 0
51 76 0
48 53 0
96 64 0
72 53 0
17 79 0

87 28 0
47 90 0
63 19 0
15 2 0
5 1 0
68 75 0
75 29 0
62 85 0
