width 97
height 97
@@@@@@@@@@@@@@@@@@@@@@@@...@@@..@.....@@@..@@.....@@@@@@@@@@@@..........@@@........@@@@@...@@@@@@
@@@@@@@@@@@@@@@@@@@@@@@@@..........@@@@@@.........@@@@@@@..@@@..........@@.................@@@@@@
@@@@@@@@@@@@@@@@@@@@@..............@@@@@@.........@@@@@@@.......@............@.............@@@@@@
@@@@@@@@@@@@@@@@@@@@@.....@.......................................@.......................@@@@@@@
@@@@@@@@@@@@@@@@@@@@@@............................................@.......................@@@@@@@
@@@@@@@@@@@@@@@@@@@......@@.......@@@......@.@@@.........................................@@@@@@@@
@@@@@@@@@@@@@@@@@@@......@........@@...................@@@.......@.........@.....@..@....@@@@@..@
@@@@@@@@@@@@@@@@@......................@...........@@@@........@@@.......@........@......@@.@@...
@@@@@@@@@@@@@@@......................@..............@@.........@@@@@@...............@........@...
@@@@@@@@@@@@@@@............@@...............................@..@@@@@...............@@............
@@@@@@@@@@@@@@@............@@.....@............@...............@@@@@@..........@..@@@............
@@@@@@@@@@@@@@@@@@.........@...@.........@....@@@@.@...........@@@@@.............@@@.............
@@@@@@@@@@@@@@@@@...............................@................@.....@........@@@..............
@@@@@@@@@@@@@@@@@@...............@...............................................@@......@.......
@@@@@@@@@@@@@@@@@@................@...........................................@............@.....
@@@@@@@@@@@@@@@@@@@......@................@@.....@..........@@................@.......@..........
@@@@@@@@@@@@@@@@@.@....@.@...............@@..........@......@@@.....@....................@.......
@@@@@@@@@@@@@@@@..@................@@@...............@@......@@...........@...................@@.
@@@@@@@@@@@@@@@@...............@..@@@@@.........@@@@@@@@@@@...@@...@........@...@..........@@.@@@
@@@@@@@@@@@@@@@.....@.............@@@@@.........@@@@@@@@@@@@@@@@.........@..@...@.........@@@.@..
@@@@@@@@@@@@@@@@..................@@@@@.........@@@@@@@@@@@@..@@..@..@............@.......@@.....
@@@@@@@@@@@.@@@@....................@@.........@@@@@@@@@@@@@........@@.........@................@
@@@@@@@@@@@.......................@..........@..@@@@@@@@@@@@@.........@........@....@.@.........@
@@@@@@@@@@@.@@.........@..........@@................@@@@@@@@@@.................................@@
@@@@@@@@@@@.@..........@............................@@@@@@@@@@................................@@@
@.@@@@@@@@@........@.......@@............................@@@@@.............@@@..................@
...@@@@@@@..................@@..................@........@@@@@........@@@...@@@..........@.....@@
....@@@.@@.....@@@.......@@@@@...........................@@@...@......@@@.......................@
@@.@@@..@.....@@@@.@@....@@@@@..@.................@......@@@..@@.......@@........@@...@..@@.....@
@@.................@@.@@@@@@@........@@@@@@..@....@@.....@@.....................@@@..............
@@...............@....@@@@@@@....@@..@@.@@@..@....@.@.................@.....@...............@@...
.................@......@@@......@@..@@...@..@....@.............@................................
.....@@@....@@............@....@..@..@.......@................@..................................
.....@.@@.......................................@..........@..@..................................
..@....@@..@.........@@@@@..............................@..@................................@....
@...............@...@@@@@@..............@.........@....@...@@@@...@............@@................
..............@....@@@@@@........................@@@@@.....@@...............@...@................
.............@@....@@@@@@.......................@@.@@......@@.@@..@.................@@.......@...
.....@.....@@@@@.....@.@@@......................@@..........@@@@............@.......@@.......@...
...........@@@@@@........@@@@......................@@@...@@@@@@@.....@@.......@@.@...@@......@...
@.........@@@@@@@@@........................@.............@@@@@@.......@............@@@@@@......@@
............@@@@@@.......................................@@@@@@....................@@@@@@@.....@@
................@.......@................@..@@@@...........@@@................@....@@@@@@@@......
@..............@@..@....................@@.@@@@@@@..@......@@@@....................@@@@@@@@......
@.@...........@@@.....@...@..............@@@@@@@@@@.....@@@@@@@@.............@@@@@....@@@........
@.@............@@...@@@@@@@..............@@@@@@@@@@...@...@@........@.........@@@@@@@..@@........
..@.@....@...........@@@@@@@@.@@..............@@@...@@@@......................@@@@@@@...@........
@@...................@@@@@@@@@@.....@..........@@..@.....@@....@..@@........@@@@@@@@@...@........
@@@...@@......@...@@@@@@@@@@.@@@...@@.........@@@..@....@@......@@@@...@@@..@.@@@@@@.............
@@@@..........@...@@@@@@@..........@@...........................@@@@....@@@.@.@@@@@............@@
@@@@................@@@@@..@.....@.@@.....@.....................@@@@...@.......@@@@............@@
@@@..........@......@@@@....@@@....@..........@......@...@@....@@....@....@.@.......@........@@@@
@@@@@........@.......@..@...@.@@..@@@...............@@...@@..........@......@...............@@@@@
@@@@@................@...................@..........@@@................@.@..@.....@......@@..@.@@
@@@@@@@@@.................@@...............@@@@@...@@@@................@@.......................@
@@@@@@@@@@@................@...........@...@@@@@...@.........................@..................@
@@@@@@@@@.......@@@@.....@.................@@@@....@@@..@.....@...@...................@@........@
@@@@@@@..........@@@.......................@.....@@@@@........@@......................@@@......@@
@@@@@@@@........@@@@.......@...............@....@@@@............................@...@@@@@....@@@@
@@@@@@...........@@@..............@.@@.............@.............@@.............@...@@@@@@...@@@@
@@@@@......@.....@@@......@.......@@@..@.............@........@..@@.......@.........@@@@@...@@@@@
@@@@.....@...................@@@.............................@@..@........@.........@@@@@...@..@@
@@@@@......................@.@@@.......@....................@@@......@.............@@@@@@.......@
@..@.........................@.....@................@......@@@.....@...@...........@@@@@@.......@
@....@...............................@...@....@......@.....@@@@..............@.....@@@@@@.......@
@.........@@.............@...........@..........@@.......@@@@@@@...@.........@.@@..@@@@@@...@....
@.......@@@@@.@...................................@..@@@@@@@@@@@..@@.........@@@@..@@@@@....@....
.@......@@@@@@@................@@@@.......@.......@@@@@@@@@@@@....@@@......@..@@@...@.@@@........
.@.......@@@@@@.......@.......@@@@@................@@@@@@@@@@@................@@@......@@........
.........@@@@@@......@@.......@@@@@.@@@@...........@@@@@@@@........@...........@@@.....@@@@@.....
@@...@@@@@@@@@@.....................@@....@........@@@@@@@@.......@@@......@.@...@........@@@@...
...@@@@@@@@@@@@@@@........@@......@.@@.........@@..@@@@@@@@.......@........@................@@...
...@@@@@@@@@@@@@@@@@......@@@........@.............@@@@@@@..@@...@......@..@......@@......@......
...@@@@@@@@@@@@@@@@@........................@@@.....@@@@@@..@@....................@..............
@@@@@@@@@@@@@@@@@@@@........................@@@@....@@@@@@..@............@.......................
@@@@@@@@@@@@@@@@@@@@..@.....................@@@@@@@@@@@@@...@...@.....................@.....@.@..
@@@@@@@@@@@@@@@@@@@@..@....................@@@@@@@@@@@@@@@@......................................
@@@@@@@@@@@@@@@@@@@@@@@...@@@.......@@@....@@@@@@@@@@@@@@@@.@@................................@..
@@@@@@@@@@@@@@@@@@@@@@@...@@@...............@@@@@@@@@@@@@@@@@@@..@...............@@...@@@......@@
@@@@@@@@@@@@@@@@@@@@@@@@@..@@..............@@@@@@@@@@@@@@@@@@@@....@@........@..@@@@..@@@........
@@@@@@@@@@@@@@@@@@@@@@@@@@@@@.@....@........@@@@@@@@@@@@@@@@@@@.............@@@@@@@@..@@@........
@@@@@@@@@@@@@@@@@@@@@@@@@@@@@....@.@@.......@@@@@@@@@@@@@@@@@@@@@..........@@...@@@.....@........
@@@@@@@@@@@@@@@@@@@@@@@@@@@@@@.....@@..@....@@@@@@@@@@@@@@@@@@@@@..........@.....................
@@@@@@@@@@@@@@@@@@@@@@@@@@@@@@@.....@.@@@@@@@@@@@@@@@@@@@@@@@@@@@@@@..@.............@@@@@@....@..
@@@@@@@@@@@@@@@@@@@@@@@@@@@@@@@.....@.@@@@@@@@@@@@@@@@@@@@@@@@@@@@@@@.@@@@@@.......@@@@@@@...@@.@
@@@@@@@@@@@@@@@@@@@@@@@@@@@@@@@.........@@@@@@@@@@@@@@@@@@@@@@@@@@@@@@@@@@@@@@@@@@@@@@@@@....@@..
@@@@@@@@@@@@@@@@@@@@@@@@@@@@@@@@.@.....@@@@@@@@@@@@@@@@@@@@@@@@@@@@@@@@@@@@@@@@@@@@@@@@@@@@......
@@@@@@@@@@@@@@@@@@@@@@@@@@@@@@@........@@@@@@@@@@@@@@@@@@@@@@@@@@@@@@@@@@@@@@@@@@@@@@@@@@@.......
@@@@@@@@@@@@@@@@@@@@@@@@@@@@@@@.@......@@@@@@@@@@@@@@@@@@@@@@@@@@@@@@@@@@@@@@@@@@@@@@@@@@@......@
@@@@@@@@@@@@@@@@@@@@@@@@@@@@@@@........@@@@@@@@@@@@@@@@@@@@@@@@@@@@@@@@@@@@@@@@@@@@@@@@@@@....@..
@@@@@@@@@@@@@@@@@@@@@@@@@@@@@..........@@@@@@@@@@@@@@@@@@@@@@@@@@@@@@@@@@@@@@@@@@@@@@@@@@@.......
@@@@@@@@@@@@@@@@@@@@@@@@@@@@.....@.....@@@@@@@@@@@@@@@@@@@@@@@@@@@@@@@@@@@@@@@@@@@@@@@@@@@@......
@@@@@@@@@@@@@@@@@@@@@@@@@@@@...........@@@@@@@@@@@@@@@@@@@@@@@@@@@@@@@@@@@@@@@@@@@@@@@@@@@@@.....
@@@@@@@@@@@@@@@@@@@@@@@@@@@@@@.@@.......@@@@@@@@@@@@@@@@@@@@@@@@@@@@@@@@@@@@@@@@@@@@@@@@@@@@@....
@@@@@@@@@@@@@@@@@@@@@@@@@@@@@@@@......@..@@@@@@@@@@@@@@@@@@@@@@@@@@@@@@@@@@@@@@@@@@@@@@@@@@@@@@..
@@@@@@@@@@@@@@@@@@@@@@@@@@@@@@@@@@@...@@@@@@@@@@@@@@@@@@@@@@@@@@@@@@@@@@@@@@@@@@@@@@@@@@@@@@@@...
@@@@@@@@@@@@@@@@@@@@@@@@@@@@@@@@@@@@@@@@@@@@@@@@@@@@@@@@@@@@@@@@@@@@@@@@@@@@@@@@@@@@@@@@@@@@@@...
8
59 49 0
90 44 0
42 42 0
22 17 0
31 55 0
90 15 0
65 70 0
78 71 0

52 55 0
89 50 0
83 75 0
68 58 0
68 5 0
29 50 0
47 6 0
93 32 0
