width 97
height 97
@@@....@......@......@...@@@@.................@@....@@@@@@@...@@@@@@@@@@@@@@@@@@@@@@@@@@@@@@@@@@@
@@....@@.....@@@.....@@@....@...........@....@@@....@@@@@@@...@@@@@@@@@@@@@@@@@@@@@@@@@@@@@@@@@@@
@.............@............@@@....@@@...@....@@@....@@@@@@@@....@@@@@@@@@@@@@@@@@@@@@@@@@@@@@@@@@
@.@........................@@@.....@@..........@....@@@@@@.......@@@@@@@@@@@@@@@@@@@@@@@@@@@@@@@@
@............@..................@..@@..................@@.......@@@@@@@@@@@@@@@@@@@@@@@@@@@@@@@@@
...........@....@@........................@...@........@@.......@@@@@@@@@@@@@@@@@@@@@@@@@@@@@@@@@
..........................@..@............@@......@..................@@@@@@@@@@@@@@@@@@@@@@@@@@@@
.................@@@@@@.@@@@@@@@...........@.........................@@@@@@@@@@@@@@@@@@@@@@@@@@@@
.@@@..........@@@@@@@...@@@@@@@..............................@@.....@@@@@@@@@@@@@@@@@@@@@@@@@@@@@
.......@@.....@@@@@@@...@..@@@@.......@...........@@..@.@............@@@@@@@@@@@@@@@@@@@@@@@@@@@@
@...@..........@@@.@....@....@..@...@......@..........@@......@......@@@@@@@@@@@@@@@@@@@@@@@@@@@@
@@....@...........................@@.@@....@.@........@.@.........@....@@@@@@@@@@@@@@@@@@@@@@@@@@
....@@@.........@@...............@...@@@@..............................@@@@@@@@@@@@@@@@@@@@@@@@@@
......@@..@....@@@...................@@@@......@...........@@..........@@@@@@@@@@@@@@@@@@@@@@@@@@
..........@...@@@@@@@@@....................................@@@@...@@...@@@@@@@@@@@@@@@@@@@@@@@@@@
.......@....@.@@@@@@@@@.....@..............................@@@@@.@@@...@@@@@@@@@@@@@@@@@@@@@@@@@@
.......@....@@@@@@@@@@........................@...........@@@@.........@@@@@@@@@@@@@@@@@@@@@@@@@@
............@@@@@@@@@@@.............@........................@.....@......@@@@@@@@@@@@@@@@@@@@@@@
@..........@@@@@@@@@@@@........@....@.....@@........@.@...@@.@............@@@@@@@@@@@@@@@@@@@@@@@
@....@.@@.@@@@..@@@@@@@..................@@@@@......@.....................@@@@@@@@@@@@@@@@@@@@@@@
@@...........@...@@@@@@..@@@@@............@.@@@@@@@@@@....................@@@@@@@@@@@@@@@@@@@@@@@
@@......@......@..@@@@@..@@@@@...@..@.....@.@@@@@@@@.@....................@@@@@@@@@@@@@@@@@@@@@@@
@@@...@........@@.@@@@@@.@@@@@..@@...@@...@...............................@@@@@@@@@@@@@@@@@@@@@@@
@@@@..@@......@.@.@@@@@@@@@@@@..@..@@@@@....@.................@@..@....@@@@@@@@@@@@@@@@@@@@@@@@@@
@@@......@......@@@@@@@@@@@@@@@@...@@@@...@...............@@.@@....@.......@@@@@@@@@@@@@@@@@@@@@@
@@@@....@@......@@@@@@@@@@@@@@@.....@@@.....@.@........@@@@@.@@@......@@...@@@@@@@@@@@@@@@@@@@@@@
@@@@....@@....@..@@@@@@@@@@@@@.......@@.......@..@......@@@@.@..@@@...............@@@@@@@@@@@@@@@
.@@........@..@@@@@@@@@@@@@@@@................@....@..................................@@@@@@@@@@@
....@......@..@@@@@@@@@@@@@@@@@@....@........................@.............@@.........@@@@@@@@@@@
...........@@@@@@@@@@@@@@@@@@@@@.@............@..@@.............@......@@...........@@@@@@@@@@@@@
...@........@@@@@@@@@@@@@@@@@@.......@@@............@@@......@.@@......@@..........@@@@@@@@@@@@@@
............@@@.@@@@@@@@..@@...........@............@.@.....@@.@@@............@@..@..@@@@@@@@@@@@
............@.@..@@@@@@@..............................@.....@@.@@........@.........@.@@@@@@@@@@@@
.@........@@@....@@@@@@.......@......@..............@@@@@@...............@@@@..@.....@@@@@@@@@@@@
@@@@......@@@.........@@...@.......@.@.........@.....@@@@@...@.......@...@@.@....@...@@@@@@@@@@@@
@@@@...@..@@.....................@@@@@............@@...@@@.....@@.......@@@.@.........@@@@@@@@@@@
@@@@.......@...........@@@@@@@@...@@@@.................@@@@@@...@.....@.....@@@.@.........@@@@@@@
@@@@.@.@...............@..@@@@@..........................@@@@...@@..........@@@@....@........@@.@
@@@@......................................@.....@@..@............@..........@@@@......@.......@..
@@..............@...........@...................@...@...........@@...@.......@@@.......@@........
@@..@.................................@@@........................@.............@...........@....@
@@@.@....@.@............@@..@........@@..............@..............@...........................@
@@@...@................@@...........@............@@@@@@...@.....................................@
@@@.........@..........@@...@....................@..@@@.........@.......@@@@..........@.......@.@
@@@@@@...........@.....@@@@......@@.................@@@.........@.......@@@@........@...@......@@
@@@@@@...........@@....@@@@.........................@@@..................@@...................@@@
@.@@@..@............@@@@@@@..@........@.....@@......@@@.....@....@@.......@...............@....@@
...@@.....@..........@@@@@@..........@@....@@@....@@@.@@@@........@@@....@@@...@..............@@@
.........@@..........@@@@@@@......@@@@@...@@@@@@...@@.@.................@@.@.@..............@@@@@
..........@..........@@@@@@@.....@@@@@@@...@@@@....@........@..........@@..@.@.....@@.......@@@@@
......@@.........@...@@@...@......@..@......@......@.....@@@@......@..............@.........@@@@@
.@..............@@..@@@@@..@........................@.@@@@@@@.....@..................@@@.........
....................@@@@@......................@..@....@@@@@@................@.......@@@@@@...@..
.....@@........@....@@@@@.............................@@@@@...........@..............@@@@........
......@...........@.....@.........@@..................@@@.......................@...@@@@@........
.............@@.@.................@@.......@..........@@@.......@..................@@@@@@....@...
............@@@....................@..................@@..@........................@@@...........
..........@.@@@..............@............@...........@@@@@............@..........@@.............
............@@@......@@@....@....@....................@@@@@......................................
@.......@....@...@...@@...@....@@@.@.....@..............@@@@...........@..................@@@....
@@...............@...@@....@...@@............@......@@@@@@@......................................
@.......@..................@@..@.............@.@......@@@@@...............................@......
.......@...........@@@.....@...@............................@..@@........................@@.....@
.................@@@......@@..@@.....@..............@......@...@@.......@...@..@@@@@......@..@.@@
...........@..................@@@.@..@..................@@.@..@@......@.@....@@@@@@@....@@...@@@@
@............@@...............@@@....@.....@@.........@@@..@@.@@@@@...@......@@@@@@@....@@@@.@@@@
............@@.@@...@@..@@@@.@@@@..............................@@@@.....@.@.@@@@@@@.....@@@@.@@@@
@...........@..@@.@@@@...@@@@@@@@.@.......@@............@....@@@...@....@@@@@@@@@@@.....@@.@@@@@@
..........................@....@@.......@@@@............................@@@@@@@@@@@........@@@@@@
.......@...................................@@...@..........@....@@.......@@@@@@@@@@..........@@@@
.....@.....@@.......@.....@.........................@@@....@....@.........@@@@@@@@@............@@
....@............@........@.@............@..@@.............@..............@@@@@@@@@@@............
................@@......@.@............................@...@.@@@.......@...@@@@@@@@@.............
.@.......@.................@............@..@@.........@@@.....@............@@@@@@@@@.............
@@@@................@......@..............@@...@@@@...........@............@@@@@@@@@@.........@@.
@@@@...............@@......@.......@.....@.....@@@@.......@@.........@.......@@@@@@@@......@@@@@@
@@@@@........@...@......@....@...........@.....@@@@.@....@@@........@..@......@@@@@@@......@....@
@@@@@@..@....@....@@....@....@.................@@@@@@.................@@..@..@@@@@@@......@@....@
@@@@....@.........@.............................@@@@@...........@...........@@@@@@@..............
@@..............................................@@@.........@...@............@@@@@@..............
.........@...............@....@.@..............@@@@........@@...@@...@@@.....@@@.............@...
@..................@@..@@.......@@.............@@@@..@..........@@.....@......@@.@...............
...@..@...........@@@@@@.........@@.@..........@@@@..@...........@@.................@....@@@@@...
....@..@@.........@@@..@@........@@.....@..@...@@@@..@@@.......@@@@@........@@...........@@@@@@@@
@...@.............@@@......................@...@..@.......@@................@@............@....@@
..............@@@@.......................................@@@................@@..................@
.............@@@...................@....@......@..........@@..............@........@@@..@@.......
..@@.........@@@...................@....@......@...........@@@....................@@@@..........@
.@@@@@........@@.......@@@......@...................@.......@@@.........@.........@..@........@@@
.@@@@@........@@.......@@@.@@...@.........................@.@@@...........@@.....................
.@@@@@@@@@.............@@@@@@@..@.@.@..........@..........@...@......@....@@...@.................
@@@@@@@@@....@@......@@@@@@@@@....@@@.........@.............@@@..@@.....@@@.....................@
@@@@@@@@@....@@......@@@@@@@@@.....@@.........@@.........@.......@......@@@......@@@............@
@@@@@@@@@...@@@........@@...............@@@..@..@..............@..........@........@.............
@@@@@@@@@@@@@@@...@.....@...........@...@@@......@.@@..............................@........@...@
@@@@@@@@@@@@@@@..@@..........@.....@@@@@@@@......@.@........@@................@..................
@@@@@@@@@@@@@@@@@@..........@@.....@@@@@@@@@............@....@.........@.....@@@.@@@..@.......@..
8
81 50 0
41 62 0
10 82 0
46 56 0
66 71 0
79 84 0
35 13 0
10 37 0

58 45 0
28 47 0
51 43 0
7 2 0
8 18 0
8 8 0
34 80 0
46 58 0
