width 20
height 29
....@@..........@@..
....................
....................
....@........@......
.........@.@....@...
..................@.
....................
....................
........@..@........
....@............@..
...........@..@.....
@...@.@.............
@............@....@.
.........@.....@....
....@...@...........
..................@.
.@.@................
....................
........@..@....@@..
................@...
....................
...@.@.............@
...........@....@...
......@@@..........@
........@.........@@
@@@....@....@..@....
.........@..........
....................
....................
6
19 25 0
12 1 0
2 17 0
4 23 1
2 0 1
6 12 1

17 15 0
14 21 0
12 26 0
15 3 1
18 19 1
17 6 1
