width 20
height 29
.....@..............
....................
....................
..@.........@.......
...........@.......@
@....@......@..@.@..
@..@................
.............@......
..........@....@....
.....@.....@..@...@@
.......@............
.....@............@.
....@.@..@.....@....
@.........@..@......
...@................
........@...........
.....@.@............
....@....@..@.@.....
.................@..
..............@.....
.@...@.@.......@....
....................
......@.............
..........@....@....
............@......@
.......@........@...
@@..................
@...................
....................
6
13 20 0
13 2 0
2 17 0
14 0 1
5 14 1
18 13 1

13 19 0
13 3 0
17 6 0
12 13 1
1 14 1
6 26 1
