width 20
height 29
......@@............
@.....@@............
............@.......
.....@..............
@............@......
....@..@......@.....
.@.............@@...
..@....@......@@@...
.............@......
...@................
....................
..........@....@....
........@.......@...
....@..@.@....@.....
@@..................
@@........@......@.@
........@...@.......
.................@..
.....@..............
....@......@.......@
............@.......
@.............@.....
..@.@...............
......@..@..........
............@.@.....
.@..@.@.............
.............@......
..@.....@...........
............@.......
6
4 9 0
19 14 0
4 7 0
17 13 1
19 27 1
5 9 1

11 22 0
7 21 0
5 5 0
16 15 1
2 24 1
11 4 1
