width 20
height 29
........@..........@
.....@..............
@....@@@.........@..
.............@......
...@..@.@...........
.........@..........
@..........@...@....
@.@.@........@......
...@............@...
....@..........@....
.....@..............
....................
....................
....@.....@...@.....
.......@.@..@..@.@..
.....@..............
.......@..@...@.....
@...................
..@@................
...@.....@..@.......
.@..@.........@.....
...........@......@.
...@..........@.....
....@.@..@..........
...@...@............
....................
...@.@..............
...........@........
...............@....
6
11 13 0
10 10 0
13 18 0
8 15 1
4 19 1
4 22 1

17 28 0
18 25 0
4 0 0
19 10 1
8 5 1
6 5 1
