width 20
height 38
...........@.......@
..........@.........
..@...@.............
................@...
.........@.@.....@..
........@...........
.............@@@....
......@...........@@
....@........@......
.......@.......@....
....................
.@.@.............@..
........@..@..@.....
................@...
...................@
.......@...........@
....................
.....@........@.....
.........@..........
..............@.....
......@...@.@.......
...............@....
........@.......@@.@
...@....@.......@@..
............@...@@..
.....@..........@@..
.......@....@.....@.
..........@....@....
....@......@........
.....@..@...........
....................
.@.@.@.....@........
....................
.....@.@.........@..
...@.........@......
..............@@....
@@..@...............
@..................@
6
15 3 0
2 31 0
9 37 0
16 16 1
10 29 1
10 28 1

5 3 0
11 36 0
5 22 0
8 18 1
11 6 1
19 1 1
