width 20
height 38
....@@@.....@@......
....................
.............@......
.................@..
.......@......@.@..@
@@@.................
...................@
..@........@..@..@..
..................@.
.....@..............
.........@......@...
..@...@.............
..........@.........
..............@....@
.....@....@....@....
...@....@..@........
...@................
........@......@....
...@.......@....@...
...................@
..@................@
.......@...........@
.........@...@.....@
...........@...@.@..
...@@..............@
..........@..@......
@@............@.....
@@....@............@
...@........@......@
...@..........@.....
................@...
..@.@....@..........
...@................
....@...@@...@......
....................
...........@........
..............@.@...
....................
6
7 10 0
0 37 0
14 14 0
17 2 1
0 6 1
19 12 1

11 20 0
17 2 0
12 34 0
19 0 1
16 34 1
17 25 1
