width 33
height 33
@@@@@@.......@@...........@@@@@@@
@..@@........@@.....@.....@@@@@@@
..........................@@@@@@@
.......@@@@...............@@@@@@@
@......@@@@.@@@@........@@@@@@@@@
...@..@@@@@@@@@@.......@@@@@@@@@@
@.@...@.@@@@@@@@........@@@@@@@@@
@.....@.@@@@@@@..........@@@@@@@@
@@@.....@@@@@....@......@@@@@@@@@
@@@......@@...........@.@@@@@@@@@
@@@@.......@@@..@.....@@@@@@@@@@@
@@@@..@...@@@@..........@@@@@@@@@
@@@@......@@@...........@@@@@@@@@
@@@.......@@@...............@@@@@
@@@@.......................@@@@@@
@@@@.....................@.@@@@@@
@@@@.@.....................@@@@@@
@@...@@@@@....@@...@@......@@@.@@
@@@@@@@@@@.....@...........@@@...
@@@@@@@@@...............@........
@@@@@@@@@....@.@..........@......
@@@@@@@@.......@@.......@........
@@@@@@@@@@@.....@.....@..........
@@@@@@@@@@@.....@..@@.@@.@@@@@...
@@@@@@@@@@@@....@@..@.@@@@@@.....
@@@@@@@@@@@@@@..@@.......@@@.....
@@@@@@@@@@@@@@...............@...
@@@@@@@@@@@@@@.......@@......@...
@@@@@@@@@@@@@.......@@@......@...
@@@@@@@@@@@@........@@..@@......@
@@@@@@@@@@@@....................@
@@@@@@@@@@@....@.............@...
@@@@@@@@@@@.@.@@...@@@.....@@@...
8
11 9 0
14 2 0
23 2 0
24 2 0
25 19 0
29 20 0
5 9 0
13 15 0

13 17 0
18 17 0
16 6 0
20 7 0
22 21 0
17 32 0
30 27 0
29 30 0
