width 33
height 33
..@@@@@@@@@@@@@@@@@@@@@@@@@@@@@@@
@....@@@@@@@@@@@@@@@@@@@@@@@...@@
@....@@@..@@@@@@@@@@@@@@@@@....@.
.....@@........@@@@@@@@..@@...@..
................@@@@@@....@@.....
................@@@@@@...........
.............@@.@@@@@@.......@...
....................@@.....@.@...
@@.............@@.........@@@@...
@@...........@......@......@@....
........@.......@@@...........@.@
...@....@.................@......
........@...............@......@.
.......@.........................
..@..............................
@@@@@.......@@.......@@..........
@@...@......@@...................
.........................@@@.....
@.....@..................@.......
@@@...@.........@................
.@@@..@@........@...............@
......@..................@....@.@
..@........@@@..................@
..@@@......@.............@@@....@
..........@..............@@@@@@@@
..................@.....@@@@@@@@@
........@................@@@@@@@@
..........@............@@@@@@@@@@
@@@...@@@@@@.@..........@@@@@@@@@
@@@...@@@@@@.@......@...@@@@@@@@@
@@@..@@@@@@@@@@.........@@@@@@@@@
@@@.@@@@@@@@@@@......@@@@@@@@@@@@
@@@.@@@@@@@@@@@...@@..@@@@@@@@@@@
8
20 32 0
31 11 0
22 21 0
9 14 0
12 18 0
30 7 0
17 17 0
21 14 0

4 12 0
28 19 0
7 9 0
15 9 0
31 4 0
13 4 0
1 0 0
25 20 0
