width 33
height 33
@@@@@@@@@@@@@@@@@@@@..@@@.@@@@@@@
@@@@@@@@@@@@@@@@@@@@...@...@@@@@@
@@@@@@@@@@@@@@@@@@.....@@..@@@@@@
@@@@@@@@@@@@@@@...........@@@@@@@
@@@@@@@@@@@@@@..........@@@@@@@@@
@@@@@@@@@@@@@@@@@..@...@@@@@@@@@@
@@@@@@@@@@@@@@@@...@..@@@@@@@@@@@
@@@@@@@@@@@@@@@@......@@@@@@@@@@@
@@@@@@@@@@@@@@@@......@@@@@@@@@@@
@@@@@@@@@@@@@@@@........@@@@@@@@@
@@@@@@@@@@@@@@@@.........@@@@@.@@
@@@@@@@@@@@@@@@...@..@...@@.@....
@@@@@@@@@@@@......@@.............
@@@@@@@@@@@......@@@.............
@@@@@@@@@@@.................@...@
@@@@@@@@@@@......................
@@@@@@................@..........
@@@@@@................@..........
@@@@@@......@@@..................
.@........@@@@@...@..............
..........@@@@.........@...@...@@
@@.........@@@.........@.......@.
......@.....@@...................
......@.....@@@..@@@......@......
............@@@@.@@@.............
@@..@@.......@@..@@@.............
@...@@..........@@@@.............
@...@...@..@@@..@..............@@
....@......@@@.................@@
...........@@@.................@@
............@@.@@.........@......
...@...................@@@@@@.@..
@@.....@............@@@@@@@@@@@..
8
28 28 0
16 4 0
6 18 0
18 17 0
15 23 0
24 21 0
2 31 0
5 22 0

12 25 0
1 24 0
20 14 0
2 32 0
20 20 0
24 21 0
4 29 0
25 3 0
