width 33
height 33
@@@@@@@@@@@@@@@@@@@@@@@@@@....@@@
@@@@@@@@@@@@@@@@@@@@@@.........@@
@@@@@@@@@@@@@@@@@@@@@@.@........@
@@@@@@@@@@@@@@@@@@@@@@.........@@
@@@@@@@@@@@@@@@@@@@@@@..........@
@@@@@@@@@@@@@@@@@@@@@@......@@@@@
@@@@@@@@@@@@@@@@@@@@@......@@@@@@
@@@@@..@@@@@@@@@@@@@@@...........
@@@@@...@@@@@@@@@@@@@@.......@...
@@@@@@@...@@@@@@@@@@@.........@..
.@@@@@@...@@@@@@@@@@@............
....@@@...@@.@.@@@@@..........@@.
....@@@........@.........@.......
........................@@.......
@@@.............@................
@@@...@@@.......@................
@@@...@@@.@.....@................
@@@@@@@.....@...@@.....@........@
@@@@@@..........@@...............
@@@@@@............@..............
@@@@@@..............@@...........
@@@@@@..@...........@@...........
@@@@@@.@@..........@.@...........
@@@@@@@...........@@.@@..@@......
@@@@@@................@..@@.....@
@@@@@@.........@.........@@....@@
@@@@@@.........................@@
@@@@@@@@@@@......@...........@@@@
@@@@@@@@@@@...................@@@
@@@@@@@@@@@.......@@..........@@@
@@@@@@@@@@@@@@@...@....@.........
@@@@@@@@@@@@@@@...@..............
@@@@@@@@@@@@@@@@@@@.@..@.....@@@.
8
10 20 0
10 26 0
7 25 0
17 24 0
3 13 0
25 21 0
32 18 0
25 1 0

32 11 0
9 10 0
15 22 0
22 19 0
26 31 0
27 21 0
1 12 0
25 30 0
