width 33
height 33
@@@@@@@@.........@.......@@@@@.@.
@@@@@@@@......@......@...@.......
@@@@@@...................@@......
@@@@@@@...............@@@@.......
@@@@@@..................@........
@@@@@.....................@@.....
@@@@.....................@@@....@
@@@@.....................@.@....@
@@@@............................@
@@@...@@@@.....................@@
@@@...@@@@@....................@@
@@......@@@@@.......@.....@......
@@@@@@@@@@@@@....................
@@@@@@@@@@@@@..................@@
@@@@@@@@@@@@@@..@..............@@
@@@@@@@@@@@@@...........@..@@@@@@
@@@@@@@@@@@@@........@..@.@@@@@@@
@@@@@@@@@@@...@.........@@@@@@@@@
@@@@@@@@@@@@......@.......@@@@@@@
@@@@@@@@@@@@..........@@@@@@@@@@@
@@@@@@@@@....@@.@......@@@@@@@@@@
@@@@@@@.....@@.........@@@@@@@@@@
@@@@@@@....@@@...@.@..@@@@@@@@@@@
@@@@@@@....@@.........@@@@@@@@@@@
@@@@@@@.....@....@.@@@@@@@@@@@@@@
@@@@@@@@.........@..@@..@@@@@@@@@
@@@@@@@@............@..@@@@@@@@@@
@@@@@@@...........@....@@@@@@@@@@
@@@@@@@..........@....@@@@@@@@@@@
@@@@@.............@@...@@@@@@@@@@
@...............@@@@@@@@@@@@@@@@@
@.........@@...@@@@@@@@@@@@@@@@@@
@@@...@@@.......@@@@@@@@@@@@@@@@@
8
15 18 0
22 21 0
7 2 0
11 5 0
27 13 0
21 23 0
25 4 0
18 1 0

24 14 0
4 7 0
10 8 0
14 10 0
29 14 0
18 5 0
13 24 0
21 23 0
