width 20
height 20
.......@.....@@@@@@@
@...@@........@@@@@@
@.............@@@@@@
...............@@@@@
....................
....@.....@....@....
@.........@@.......@
@..@....@..........@
.............@......
.........@..........
......@.....@.......
@..............@.@..
.@.....@......@.....
..........@.........
....................
.@..@@.............@
....................
.@...........@.....@
@@..........@.......
@............@......
6
10 19 0
17 9 0
9 12 0
11 7 1
16 18 1
8 17 1

1 2 0
17 16 0
15 13 0
1 16 1
19 13 1
2 11 1
