width 20
height 20
..@@.........@@.....
....................
......@...........@.
......@...@.......@.
................@...
..........@.........
........@...........
@@..@.@......@..@...
@@.................@
@@......@...@......@
@......@..@.........
.........@..........
.............@......
...@....@@@.@..@..@.
........@@@.........
....@....@..........
.....@..............
.@..................
.............@.@....
.............@......
6
0 19 0
10 0 0
2 2 0
18 9 1
19 11 1
15 1 1

0 19 0
12 5 0
18 10 0
12 7 1
18 15 1
3 3 1
