width 20
height 20
..............@.....
..........@...@.....
......@.............
.................@..
..@.................
.........@..@.......
......@.......@.@...
..@.................
..............@.....
........@...@....@..
....................
.............@......
...............@....
.@...@....@.........
....@......@........
......@.............
...............@..@.
....................
...@.......@.......@
.......@@...........
6
1 9 0
8 10 0
3 19 0
3 17 1
9 11 1
12 7 1

19 0 0
10 9 0
9 9 0
17 8 1
18 19 1
17 17 1
