width 20
height 20
.....@..@@@@@@......
....................
.@..............@...
..@....@.@...@......
....................
....................
.......@.....@...@..
....@...............
.....@....@.....@...
.@...............@..
........@......@....
....@.......@....@..
................@...
........@...@.......
.....@....@....@.@..
....................
.....@..@.@..@...@..
...@..........@.....
...........@........
@...................
6
7 7 0
17 13 0
11 5 0
13 19 1
18 0 1
4 15 1

18 19 0
16 14 0
17 3 0
4 5 1
3 15 1
18 1 1
