width 20
height 20
....................
.............@.@....
.........@..........
....@..............@
..@...@.@........@..
....@...............
....................
....@.....@...@.....
.......@............
...........@.....@..
...@.........@......
.......@........@...
.....@...@.@........
..........@.........
.....@@.......@.....
........@.@.........
....................
..............@.....
......@.............
......@.............
6
10 8 0
17 8 0
11 17 0
5 19 1
18 19 1
8 0 1

1 17 0
1 0 0
15 17 0
8 17 1
17 6 1
10 14 1
