width 20
height 45
..@.@..........@@@..
....@...........@@..
.........@..........
....................
....................
......@......@.@....
.....@..........@...
.......@.@..........
....................
........@........@..
.............@.@....
........@..@........
.............@..@...
....................
..........@.........
...@....@...@.......
..............@.....
........@.@......@..
.@..@...............
.......@.....@.@....
.@...@.....@....@...
@...................
....................
....@..@......@.@.@.
....................
.....@.@.@..........
@...@.....@.@.......
................@...
.@.........@.@....@.
...............@....
...................@
@.....@.@.@.........
..............@.....
@............@@@..@.
...........@.@......
......@..@..........
....@...............
..........@.........
....................
...@........@.......
......@.........@...
.@............@.....
..................@.
@................@.@
.........@..@.......
6
6 13 0
1 22 0
3 27 0
2 31 1
4 28 1
18 6 1

19 42 0
19 44 0
6 1 0
11 26 1
11 6 1
11 31 1
