width 20
height 45
....................
.@.@....@........@..
......@.....@..@...@
................@...
.....@....@.@.......
.............@......
....................
........@...........
..@....@............
............@..@....
....@.....@..@.....@
....................
.@......@.@.........
......@..@.@..@.....
....@.......@..@.@..
.............@......
.@........@.........
...................@
..........@........@
..............@.@...
.......@.@.........@
.............@...@..
....................
....@......@@.......
.....@.....@@...@...
..@.................
...................@
.@....@.@...........
.....@.@.@........@.
...@......@....@....
.........@......@...
.............@......
...@.@..............
................@...
....................
@@..@............@..
..............@.....
....@..@............
..........@.@...@...
....@....@..........
......@.............
...................@
..@.....@...........
....................
.@...........@...@..
6
0 37 0
1 2 0
3 42 0
2 34 1
14 31 1
4 4 1

3 27 0
2 11 0
18 2 0
14 22 1
3 0 1
0 28 1
