width 20
height 45
....................
....................
.....@..............
...@......@...@.@...
.@.........@......@.
.............@..@...
.....@.@.@.@........
.................@..
....@........@......
..@.........@..@....
........@...........
@..................@
@....@............@.
............@.......
..@......@..........
.......@......@.....
....................
..@......@.@........
....@.........@.....
....................
......@.........@.@.
...@.......@@.......
........@.@@@.....@.
.@....@.............
....................
...@....@........@..
....................
............@.......
.....@..........@@..
..@.....@.....@.....
.......@.......@@...
.............@......
..@.....@...........
.@.......@.@..@.....
.....@..............
..@.@........@..@...
.@.@....@...........
............@.......
...........@........
....@.@...@.....@@@@
.......@.........@@.
........@....@..@...
.....@..............
.......@............
@...................
6
19 18 0
10 15 0
4 16 0
0 19 1
0 36 1
15 15 1

19 18 0
1 20 0
10 40 0
13 6 1
19 0 1
15 13 1
