width 20
height 45
.@...........@..@...
....................
..............@.....
.....@.@.@..........
...@.............@..
@.......@..@.....@..
........@...........
...@..........@.....
....@...............
.@..............@...
.................@..
...@....@..@@.......
.................@..
..@...@....@....@...
..........@.........
..@.................
..............@...@.
...@.......@........
....@...............
......@.............
.@............@..@..
....@.....@.........
................@...
....@@.@............
@...@...@.....@.....
...@................
.............@......
.@.@..@@.@.....@....
....................
....@.@.......@.....
....................
..@......@..........
..@............@.@..
..@.................
@.......@....@...@..
...@.....@.@........
......@.............
.....@.@........@...
.@...........@......
................@.@.
....@...@...........
..@......@..........
........@...@...@...
..................@.
....@@..............
6
2 20 0
6 11 0
10 28 0
7 42 1
9 13 1
17 41 1

17 3 0
9 21 0
5 35 0
11 37 1
17 19 1
16 16 1
