width 20
height 45
@@@.......@@@.......
....................
.@....@...@.........
....................
@.@...@.............
@...@........@.@..@.
...........@........
.....@....@.........
...............@....
.............@......
......@........@....
.....@..@...........
.................@..
....................
.@.@......@.@.......
@.....@.@..@..@.....
..@..@@..........@..
.....@.......@..@..@
.....@.............@
...@.......@@.....@@
..........@.......@@
........@.........@@
.........@.....@....
.....@..............
.........@...@.@....
@@..................
................@..@
.........@..@.....@@
...@.@..............
..........@.........
...@...........@....
......@.@...........
....................
..@.@........@.....@
...@...............@
..........@..@......
.................@..
.....@.........@....
....@.@..@..........
.@................@.
............@.......
.....@.........@...@
..................@@
.......@@@........@@
..................@@
6
19 14 0
5 30 0
10 43 0
11 42 1
0 37 1
16 18 1

6 44 0
12 12 0
10 43 0
7 10 1
3 32 1
12 6 1
