width 41
height 41
@@@@@@@@@@@@@@@@@.@...........@@..@.@@@@@
@@@@@@@@@@@@@..@..............@@.....@@@@
@..@@..@...@.........................@@@@
@.@..............................@...@@@@
@.......@...............@...@........@@@@
.....@...........@......@...@@...@...@@@@
........@.@...........@.........@@@@@@@@@
@@@............@@...............@@@@@@@@@
@@@.............................@@@@@@@@@
@@@...@.........................@@@@@@@@@
@@@..................@@..........@@@@@@@@
@@@.......@.......................@@@@@@@
@@......@........................@@...@@.
........@...........@.......@....@@......
...............@..@...@..@...............
..............@@@@@......@@@@@@@....@....
..........@....@@@@......@@@@@@@....@.@..
.........@@....@@@........@@@@@@.........
..........@...@@.@@.....@....@@@...@@....
.......@......@@.......@@.....@@...@@....
@@@@...........@.......@@..........@@@@..
..@..@.............@...@@.@@@......@.....
.....@.................@@@@@@......@@....
...........@@...........@@@@@............
.....................@..@@@.@.........@@.
..@@.........@@.........@.............@@.
............@@@@..........@............@@
@.....@@@@.@@@@@@@............@@.........
@@.@@.@@@@@@@@@@............@@@@@@.@.....
@@@@@@@@@@@@@@@@...@@.......@@@@@@.......
@@@@@@@@@@@@@@@.....@@....@@@@@@@@@...@..
@@@@@@@@@@@@@@@@@@......@@@@@@@@@@@..@@@@
@@@@@@@@@@@@@@@.......@@@@@@@@@@@@@..@@@@
@@@@@@@@@@@@@@@@.......@@@@@@@@@@@@@@@@@@
@@@@@@@@@@@@@@@@@@@@...@@@@@@@@@@@@@@@@@@
@@@@@@@@@@@@@@@@@@@@@@@@@@@@@@@@@@@@@@@@@
@@@@@@@@@@@@@@@@@@@@@@@@@@@@@@@@@@@@@@@@@
@@@@@@@@@@@@@@@@@@@@@@@@@@@@@@@@@@@@@@@@@
@@@@@@@@@@@@@@@@@@@@@@@@@@@@@@@@@@@@@@@@@
@@@@@@@@@@@@@@@@@@@@@@@@@@@@@@@@@@@@@@@@@
@@@@@@@@@@@@@@@@@@@@@@@@@@@@@@@@@@@@@@@@@
8
12 18 0
14 17 0
27 28 0
32 10 0
22 21 0
13 14 0
13 8 0
10 23 0

20 20 0
9 19 0
14 7 0
5 15 0
0 6 0
9 9 0
31 14 0
17 30 0
