width 41
height 41
@.....@@@@@@@@@@@@@@@....@@@@@@@@@@@@@@@@
......@@@@@@@@@@@@@.....@@@@@@@@@@@@@@@@@
.@...@@@@@@@@@@@@@@..........@@@@@@@@@@@@
..@..@@@@@@@@@@@@@@..........@@@@@@@@@@@@
....@@@@@@@@@@@@@@@....@@@...@@@...@@@@@@
...@@@@@@@@@@@@@@@@.........@@@@....@@@@@
..@@@@@@@@@@@@@@@@@.........@@@@.....@@@@
@.@@@@@@@@@@@@..@@............@@.....@@@@
@..@@@@@@@@@@@..@.........@..........@@@@
@..@@@@@@@@@@@@....@...........@.....@@@@
@...@@@@@@@@.@@@...@...........@.......@@
....@@...@@........@...................@@
...................@.....................
............................@.......@....
...............@.........................
....@...........@............@@..........
..........@@@............................
.........@@@@.................@...@......
...........@.............@....@@@..@@....
...@..................@@@@@........@.....
......................@@@............@..@
......................@@@..........@.@..@
.@@.............@..............@...@@@@@@
@@..............@.......@....@......@@@@@
@@....@.@..............@.......@.....@@@@
....................@...@............@@@@
............@.....................@@@@@@@
@@@.......@.@.....................@@@@@@@
@@@@.........@@..@@@.............@@@@@@@@
@@@@@........@.......@@@......@@.@@@@@@@@
@@@@..@..............@@@@@.......@@@@@@@@
@@@@.......@.........@@.@@..........@@@@@
@@@@@...@....@@..........@.....@.....@@@@
@@@@@........@@...........@@@..@.....@@@@
@@@@@.......@@@@@@........@@@@@......@@@@
@@@@@.......@@@@@..........@.@........@@@
@@@@@.......@@@@..........@@...........@@
@@@@@@.....@@@............@......@..@..@@
@@@@@@@@..@@@@......@@.................@.
@@@@@@@@@@@@@@@......@@.............@....
@@@@@@@@@@@@@@@@..@..@@@@@@@@..@.........
8
7 21 0
20 17 0
40 16 0
33 14 0
29 37 0
23 25 0
13 19 0
3 2 0

27 4 0
14 37 0
27 29 0
15 11 0
19 33 0
27 20 0
33 4 0
38 39 0
