width 41
height 41
.......................@@.....@@@@@@@@@@@
.......................@....@@@@@@@@...@@
.....@...............@.@.....@@@@@......@
..........@............@....@@@@@...@..@@
@@...........................@@@@......@@
@@@@@...........@.........@..............
@@@@@@.....@................@@@....@@....
@@@@@@@@..............@......@..........@
@@@@@@@.................@@...........@@..
@@@@@@@@@...........@....................
@@@@@@@@@........................@.......
@@@@@@@@@........@.......................
@@@@@.@..............@.............@.....
@@@@@..................@....@......@.....
@@@@@..@@...................@.@..........
@@@@@@..@................................
@@@.@@...................................
@@@..@.............@.....................
...........@........@.@@..........@......
.@.............@.......@@@...@.....@...@@
.....................@......@@.........@@
...........................@@@.........@@
@.....@................@@.@@@@...........
@...................@@.@@@@@@@@.........@
.........@@@........@....@@@@@@.......@@@
...................@@....@@@@@@@.........
....................@.....@@@@@@.........
......@......@.@@...@....@@@@@@.........@
.@....@.......@@@........@@@@@@.........@
@@..@....@.@.............@@@@@@.........@
@@@......@.@@@@....@@.@..@@@@@@....@@@@.@
@@......@@.@@@..@@........@.@......@@@@@@
................@@..................@@@@@
..........@@..................@@...@@@@@@
...@@@@...@....................@...@@@@@@
@..............@.....@@........@...@@@@@@
@@.....................@@@.....@@..@@@@@@
@@..............@@...@..@@..@@@@@@@@@@@@@
@................@@......@@@@@@@@@@@@@@@@
........@.......@@..@.....@@@@@@@@@@@@@@@
....@@..........@@@.@@....@@@@@@@@@@@@@@@
8
39 22 0
33 26 0
13 28 0
14 9 0
19 35 0
32 20 0
6 38 0
35 15 0

38 19 0
2 1 0
22 9 0
35 14 0
28 5 0
32 30 0
19 11 0
11 34 0
