width 41
height 41
@@@@@@@@@@@@@@@@@@@.@@@@@@@@.....@@..@@..
@@@@@@@@@@@@@@@@@@@....@.................
@@@@@@@@@@@@@@@@@.....................@..
@@@@@@@@@@@@@@@@@@.................@@@@..
@@@@@@@@@@@@@@@@@@..........@@@....@@@@@@
@@@@@@@@@@@@@@@@@...........@@@..@@@@@@@@
@@@@@@@@@@@@@@@@@....@@@......@@...@@@@@@
@@@@@@@@@@@@@@@@@@.................@....@
@@@@@@@@@@@@@@@@@@.................@@.@.@
@@@@@@@@@@@@.@@@@@@.....@........@.......
@@@@@@@@@@@@..@@@@............@...@......
@@@@@@@@.@@@...............@......@......
@@@@@@@................@@@.@@..........@@
@@@@@@@@.....@@........@@@..@...@..@@@@@@
@@@@@@@......@@.........@...@.@@@..@@@@@@
@@@@@@@@...................@@@@.....@....
@@@@@@@@.......@..........@@@@@..........
@@@@@@@@.................@@@@@@@.........
@@@@@@@@....................@@@@.........
.@@@@.........@........@....@@.........@@
......@................@@.....@@.........
@.....@.@..@..........@@@@@..............
@.......@@...@@.@.....@@@@@@.............
.........@@..@@@@@....@@@@@@.............
...@.....@....@@@@@@@@@@@@@..............
...@...........@@@@@@@@@@........@.......
...............@@@@@@............@.......
..............@@@@@@@@@.....@............
............@@@@@@@@@@...@...............
..........@@@@@@@@@@@@...................
.....@@.@@@@@@@@@@@@@@.@@@@......@.......
.....@@@@@@@@@@@@@@@@@@@@@...............
....@@@@@@@@@@@@@@@@@@@@@@............@..
.....@@@@@@@@@@@@@@@@@@..............@@@.
.....@@@@@@@@@@@@@@@@@@..............@@@.
@....@@@@@@@@@@@@@@@@@@....@...........@.
@@..@@@@@@@@@@@@@@@@@@@@.........@@....@.
@@..@@@@@@@@@@@@@@@@@@@@@@......@@.......
@@@@@@@@@@@@@@@@@@@@@@@@@@@.....@@.......
@@@@@@@@@@@@@@@@@@@@@@@@@@@..............
@@@@@@@@@@@@@@@@@@@@@@@@@@@@.....@@......
8
27 28 0
34 39 0
29 11 0
37 7 0
21 22 0
21 15 0
18 16 0
27 30 0

23 15 0
7 27 0
31 25 0
36 39 0
23 9 0
23 35 0
38 38 0
29 31 0
