width 70
height 70
...@@@@@@@@@....@@......@..@@@@@@@@@@@@@@@@@@@@@@@.........@..@@@@@@@@
...@..@@@@......@@....@....@@@@@@@@@@@@@@@@@@@@@@@.........@..@@@@@@@@
...@............@@...@@.@..@@@@@@@@@@@@@@@@@@@@@@@@..@.........@@@@@@@
.........@.....@@@@........@@@@@@@@@@@@@@@@@@@@@@@@...........@@@@@@@@
....@...........@@@@.......@@@@@@@@@@@@@@@@@@@@@..............@@@@@@@@
@......@.@.....@@@@@@....@@@.@@@@@@@@@@@@@@@@@@@..............@@@@@@@@
@..............@@@@.....@..@.@....@@@@@@@@@@@@@@@........@@@@@@@@@@@@@
@@.........@...@..................@@@@@@@@@@@@@@@........@@@@@@@@@@@@@
@.........@@@..@..@................@@@@@@@@@@@@@..@.....@@@@@@@@@@@@@@
..@.@@.....@......................@@@@@@@@@@@@@@@@@@@...@@@.@@@@@@..@@
@@@.................@.......@.......@@@@@@@@@@@@@@@@....@@@...@@......
@...........@..@....................@@@@@@@@@@@@@@@@...@@@@.........@@
.......@............................@@@@@@@@@@@@@@@.....@@@@@.......@@
...............................@....@@@@@@@@@@@@@@@.....@@@@@@.......@
........@...........................@@@@@@@@@@@@@@@..@..@@@@@.......@@
.@........................@.........@...@@@@@@@@.....@......@...@...@@
........................@@@................@@@@@@...........@.........
....@...................@@..................@@@.........@...@.........
....@........@@................@............@.....................@...
....@.....................................................@......@....
....@....@@....................@@.........................@...........
.........@.....................@......@@....................@...@.....
........@@............................@@...............@....@.........
........@@................................@....@......@@..............
.........@........................@...................@@@.............
..@..........................@....@.........@@.....@@.................
..@.........@@...............@.....................@@@..@.............
.@..........@@...............@......@.@............@@@..@.@....@......
............@@......@.......@@@.......@........@@@@@@.................
.@..............@@@@@.....@.@@@.................@@@@@@...@@...........
@@@.............@@..........@@@...............@@@@@@.............@@..@
@@@@.......................@@@@............@@@@@@@@@@@@..........@@..@
@..........................@@@@@.....@....@@@@@@@@@@@@..@...........@@
.............@..........@...@@@.............@@@@@@..@@.........@......
...............@............@...@@......@@..@@@@@@@...........@@......
.@.......@..@.@@@@@.............@.......@@@@@@@@@@@@@@@@......@@......
@@@@.....@@@@@@@@@@@@...................@@@@@@@@@@@@@@@......@@@....@@
@@@@.....@@@@@@@@@@@@...................@@@@@@@@@@@@.......@.....@..@@
@@@@..@....@@@@@@@@@@...................@@@@@@@@@@@.....@@..........@@
@.@@..@@...@@@@@@@@@@........@..........@@@@@@@@@@...@@@@......@.@@@@@
.........@@@@@@@@@@@..............@@@@..@@@@@@@@@@...@@@@......@@@@@@@
......@@...@@@@@@@@@....@......@..@@@@.@@@@@@@@@@@...@@@@@.@@@@@@@@@@@
.......@@....@@@@.@...............@@@@@@@@@@@@@@@@@...@@@@@@@@@@@@@@@@
@@...........@@@@.................@@@@@@@@@@@@@@@@..@@@@@@@@@@@@@@@@@@
@............@..@.................@@@@@@@@@@@@@@@@@@@@@@@@@@@@@@@@@@@@
@..........@.....@..............@@@@@@@@@@@@@@@@@@@@@@@@@@@@@@@@@@@@@@
..........................@.@...@@@@@@@@@@@@@@@@@@@@@@@@@@@@@@@@@@@@@@
.....@@.................@@@.....@@@@..@@@@@@@@@@@@@@@@@@@@@@@@@@@@@@@@
....@...........@@@.............@......@@@@@@@@@@@@@@@@@@@@@@@@@@@@@@@
@..............@.@..@.@................@@@@@@@@@@@@@@@@@@@@@@@@@@@@@@@
..........@...........@@...............@@@@@@@@@@@@@@@@@@@@@@@@@@@@@@@
................@................@@.......@@@@@@@@@@@@@@@@@@@@@@@@@@@@
.......@@....@..........@..........@.....@@@@@@@@@@@@@@@@@@@@@@@@@@@@@
................@.@......................@@@@@@@@@@@@@@@@@@@@@@@@@@@@@
....................................@..@@@@@@@@@@@@@@@@@@@@@@@@@@@@@@@
.......................................@@@@@@@@@@@@@@@@@@@@@@@@@@@@@@@
........................@.............@@@@@@@@@@@@@@@@@@@@@@@@@@@@@@@@
@....@@..@.................@..........@@@@@@@@@@@@@@@@@@@@@@@@@@@@@@@@
@..@@@...................@............@@@@@@@@@@@@@@@@@@@@@@@@@@@@@@@@
@..@@@..................@@...........@@@@@@@@@@@@@@@@@@@@@@@@@@@@@@@@@
@@@@@...............@........@@.....@@@@@@@@@@@@@@@@@@@@@@@@@@@@@@@@@@
...@@.......................@@@..@@@@@@@@@@@@@@@@@@@@@@@@@@@@@@@@@@@@@
...@@.......@..............@@@@@@@@@@@@@@@@@@@@@@@@@@@@@@@@@@@@@@@@@@@
....................@......@@@@@@@@@@@@@@@@@@@@@@@@@@@@@@@@@@@@@@@@@@@
..@............@............@@.@@@@@@@@@@@@@@@@@@@@@@@@@@@@@@@@@@@@@@@
...............@....@.......@...@@@@@@@@@@@@@@@@@@@@@@@@@@@@@@@@@@@@@@
...................@@......@@....@@@@.@@@@@@@@@@@@@@@@@@@@@@@@@@@@@@@@
.........@@@@.........@........@......@@@@@@@@@@@@@@@@@@@@@@@@@@@@@@@@
....@@@@@@@@@..........@@.........@@@.@@@@@@@@@@@@@@@@@@@@@@@@@@@@@@@@
@..@@@@@@@@@@..........@@@..@@.@@@@@..@@@@@@@@@@@@@@@@@@@@@@@@@@@@@@@@
8
1 46 0
19 13 0
11 14 0
39 31 0
29 18 0
0 17 0
25 26 0
14 68 0

32 19 0
54 32 0
25 68 0
39 31 0
26 11 0
25 41 0
25 26 0
3 17 0
