width 70
height 70
@@@@@@@@@@@@@@@@@@@@@@@@@@@@@@@@@@@@@@@@....@@@@@..@....@@@.@@.@@@@@@@
@@@@@@@@@@@@@@@@@@@@@@@@@@@@@@@@@@@@@@@.....@@@@@...@@...@@.@@..@@@@@@
@@@@@@@@@@@@@@@@@@@@@@@@@@@@@@@@@@@@@@@@..@.@@@......@@........@@@@@@@
@@@@@@@@@@@@@@@@@@@@@@@@@@@@@@@@@@@@@@@@.@.@..........@.........@@@@.@
@@@@@@@@@....@@@@@@@@@@@@.....@@@@..@@@...............................
@@@@@@@@@....@@@@@@@@@@@@.............@@@..........................@..
@@@...@@.....@@@@@@@@@@@@..................@@@@@......................
@@@..........@@@@@@@@@@@...................@@@@@.........@............
@@@.......@.@.@@@@@@@@@@...................@@...........@.............
@@@.@..@......@@@@@@@@@...........@...................@...............
@@@......@........@@@@@............@....................@@.....@..@...
@@@.....@@........@...@................@............@@................
@@@@@@..............................................@@@.........@@@.@@
@@@@@@@.....@....@@........@@.........@...@.........@@@.........@@@@@@
@@@@@@..........@@@......@.@@......@................@@.....@...@@@@@@@
@@@..@@......@..@@@....@@....@.....@......................@...@@@@@@@@
...........@.@.@@@@.....@@@..............@................@........@@@
.............@@@@@@.....@@@..........@@..........@..................@@
.............@@@@@......@@@@@.......@@@@@@....@.....@@@@..@@.......@@@
............@@@@@@....@@@@@@@.....@@@@@@@@@..........@@@@.......@.@@@@
............@@@@@@@....@..@@@@....@@@@@@@@@@@......@@@@@@............@
........@@@@@@@@@@@..@....@@@@.....@@@@@..@@@.......@@@@.......@.....@
.............@@@...........@@@.....@..@....@@@@@......@@@@.....@@.....
@@..@........@@@.....@@......@@.......................@@@.............
.@...........@@@@....@@......@...........@..@.........@@...@..........
..............@@.............@....@...................@@@@@...........
....@.@..@@@@@..........@................@...........@@@@@@.@@........
....@@@..@@@...@.............@.....@................@.@@@@@.......@@@.
..@......@@.................@...@................@@....@@@.....@@@@@@@
.......@.@@............................@...............@@......@@@@.@@
......@..@@................@@@......@.......@...................@@@...
......@...................@@@@..@........@...@.@........@.............
..@...@.......@..@@.................................@.................
......@..........................@@.....@..........................@..
@.............@...........@.......@.....................@@@...........
.........@.@......................@@.@.................@@....@....@...
@........@@@......@..............@@@@@........@........@..............
@......@@@@.......@@@..@@........@@@@...@............@................
@.................@@..@@@.........@@@@.....................@....@.....
@...........@.@........@@...........@@@@..........@....@..............
..............@.....................@@@@..........@@@..@..............
.....................................@@@.....@................@@.....@
......................................@@........@@..........@..@.....@
@..@@@....@....................@......@@..................@@@....@....
@..@@@...........@@............@......@@.........@...............@....
@..@@@............@....@..............@...........@@............@@@...
@..........@...........@...@..@....................@..@.........@@@...
..........@@...............@.............@............@@.........@@@@.
........................@..@@.........................@........@@@@@@@
@...@.....@@@@.................@.................................@@@@@
@@.@......@.....@....@@..............@...........@.................@@@
@@@@...........@@...............@.......................@..........@@@
@@@@@..@....@........@.@.....................@...@...............@@@@@
@@@@@@.......................@................@.@@..........@....@@@@@
@@@.....@................@.......................@..........@@@..@@@@@
@@@.......@.....@........@.....@....................@.......@@@...@@@@
@@@@.....@.......@.................@@.......@......@@@@@.@@.@@@@@@@@@@
@@@...........@@@@.@@..........@....@........@....@@@@........@@@@@@@@
@@...........@@@@@.@@...............@............@@@@@........@@@@@@@@
@.........@..@@@@@@@..............@@@............@@@@@........@@@@@@@@
@@...........@@@@@@@.@@.......@@..............@@@@@@@@@.......@@@@@@@@
.............@@@@@@@.@@@@@@............@@@....@@@@@@@@@@.@...@@@@@@@@@
....@.....@..@@@@@@@@@@@@.....@........@@@.....@@@@@@@@@@@@@@@@@@@@@@@
@............@.....@@@@@@@....@@................@@@@@@@@@@@@@@@@@@@@@@
.....@@.@.........@@@@@@@@....@@.....@@...........@@@@@@@@@@@@@@@@@@@@
.......@@..............@@@..@@@@..................@@@@@@@@@@@@@@@@@@@@
.......@..............@@@......@@...................@@@@@@@@@@@@@@@@@@
@.....@....................................@........@@@@@@@@@@@@@@@@@@
@.....@....@@@@@.@@.....@.................@@@.......@@@@@@@@@@@@@@@@@@
@@@@@@@..@@@@@@@.@@@........@@..@@@.......@@@@.......@@@@@@@@@@@@@@@@@
8
43 41 0
68 45 0
38 37 0
16 44 0
18 33 0
22 45 0
9 33 0
43 1 0

10 56 0
60 13 0
45 34 0
44 38 0
32 46 0
44 34 0
27 32 0
41 1 0
