width 70
height 70
@@@.@@@@@...@@@@@@@@@@@@@@@@@@@@@@@@@@@@@@@@@@@@@@@@@@@@@@@@@@@@@@@@@@
@@...@.@@....@@@@@@@@@@@@@@@@@@@@@@@@@@@@@@@@@@@@@@@@@@@@@@@@@@@@@@@@@
@.......@......@@@@@@@@@@@@@@@@@@@@@@@@@@@@@@@@@@@@@@@@@@@@@@@@@@@@@@@
......@.........@@@@@@@@@@@@@@@@@@@@@@@@@@@@@@@@@@@@@@@@@@@@@@@@@@@@@@
......@..........@@@@@@@@@@@@@@@@@@@@@@@@@@@@@@@@@@@@@@@@@@@@@@@@@@@@@
......@...........@@@@@@@@@@@@@@.@@@@@@@@@@@@@@@@@@@@@@@@@@@@@@@@@@@@@
.@..............@...@.@@@@.....@..@@@@@@@@@@@@@@@@@@@@@@@@@@@@@@@@@@@@
.@.........@@....................@@@@@@@@@@@@@@@@@@@@@@@@@@@@@@@@@@@@@
.....@@@.........................@@@@@@@@@@@@@@@@@@@@@@@@@@@@@@@@@@@@@
...........@..@.......@@@.......@@@@@@@@@@@@@@@@@@@@@@@@@@@@@@@@@@@@@@
...@.....@...@..........@.......@@@@@@@@@@@@@@@@@@@@@@@@@@@@@@@@@@@@@@
...@.....@.....................@@@@@@@@@@@@@@@@@@.@@@@@@@@@@@@@@@@@@@@
.............................@@@@@@@@@@@@@@@@@@@..@@@@.@@@@@@..@@@@@@@
@@@...............@@@@.......@@@@@@@@@@@@@@@@@@...@@@@.@@@@@@..@@@@@@@
@@@@@.............@@@@......@@@@@@@@@@@@@@@@@@@......@...@@....@@@@@@@
@@@@...@..........@@@@@..@.@@@@@@@@@@@@@@@@@@@@...................@@@@
@@@@.............@@.@@@..@@@@@@@@@@@@@@@@@@@@@.....................@@@
@@@@......@.............@@@@@@@@@@@@@@@@@@@@.........@..........@@.@@@
.@@.......@...................@@@@@@@@@@@@@@@....@@@@@.@........@..@@@
..........@..@@@.............@@@@@@@@@@@@@@@...@@@@@@@@............@@@
@........@@..@@@......@......@@@@@@@@@@@@@@..@@@@@@@@................@
@@...................@@......@@@@@@@@@@@@@@...@@@@@@@......@.......@@@
@...........@.......@@@....@@@@@@@@@@@@@@@@.@@@@@@@.........@....@.@@@
@..@..........@@@@.@@@@@....@@@@@@@@@@@@@@..@@@@@@@...@@@..@@..@..@@@@
...@..........@@@@@@...@@...@@@@@....@...@......@@.....@@..@@.....@@@@
.......@......@@@@@@@.......@@@@@........@@....@...@...@@@@.......@@@@
..................@@@....@@..@@@.........@...........@@@@@@.......@@@@
...............@..@@..@....@..@@.....................@@@@@@.........@@
.@...........................@@....................@@@@@@@@...........
...........@..@.........................@........@@@@@@@@@@...........
..............@...@..........@...................@@@@@@@@@............
.......@..............@.....@@................@@.....@..@@............
......@@@...@.........@..@..@@...@@@.@...................@.......@...@
..................................@@...........@.................@@...
@......@.........................................................@....
....@......................................@@@..................@.....
....@.@...@..................@@@@...........@@..................@.....
........@@@.........@.@.....@@@......................................@
........@@@......@..@@@....................@@.........................
...............@....@......@....@.....@@..........@.@.............@...
............@..@...........@...........@..........@...............@...
............@.......................................@.................
@@@.@@@@@.......@@...........................@......@@@...@...........
@@..@@@@@@.@........@...@...........@.....@....@....@.@...............
@@@@@@@@@@@@........@.....................@...@...@..................@
@@@@@@@@@@@@.............@.........@..........@........@@@@@.@@@......
@@@@@@@@@@@@........@...........@...........@@..@.......@@@@.@@@@@@..@
@@@@@@@@@@@@...................@@........@..@...........@@@@@@@@@@@@@@
@@@@@@@@@@@@@@@..........................@@............@..@@@@@@@@@@@@
@@@@@@@@@@@@@@@@.....................@...........@........@@@@@@@@@@@@
@@@@@@@@@@@@@@@@.........@.@@@..........@.....@@..........@@@@@@@@@@@@
@@@@@@@@@@@@@@@@@............@..@@...@........@@@.........@@@@@@@@@@@@
@@@@@@@@@@@@@@@@.............@..@@..........@@@@@.........@...@@@@@@@@
@@@@@@@@@@@@@@@@@....................@@@@..@@@..@..@..@@......@@@@@@@@
@@@@@@@@@@@@@@@@@@.....................@@@..@@.@......@@.......@@@@@@@
@@@@@@@@@@@@@@@@@@@.........................@@......@....@......@@@@@@
@@@@@@@@@@@@@@@@@@@.....@@........@@@@..........................@@@@@@
@@@@@@@@@@@@@@@@@@@.....@@@......@@@@@@....@................@...@@@@@@
@@@@@@@@@@@@@@@@@@@.....@@@.........@@@................@@......@@@@@@@
@@@@@@@@@@@@@@@@@................@..@@@@......@@@.........@...@@@@@@@@
@@@@@@@@@@@@@@@@..............................................@@@@@@@@
@@@@@@@@@@@@@@@@.....@@@.................................@....@@@@@@@@
@@@@@@@@@@@@@@@..@...@@@.@@@@........@.................@.@..@@@@@@@@@@
@@@@@@@@@@@@@....@.....@.@@@@.........@.....................@@@@@@@@@@
@@@@@@@@@@@@@.@@.....@...@@@@.........@........@............@@@@@@@@@@
@@@@@@@@@@@@@@@@......@.@@@@@....@....@..@....................@@@@@@@@
@@@@@@@@@@@@@@.........@@@@@@............@....................@@@@@@@@
@@@@@@@@@@@@..........@@@@@@@..@............................@@@@@@@@@@
@@@@@@@@@@@@..........@@@@@@@@@@..@....................@@@@@@@@@@@@@@@
@@@@@@@@@@@@@.@...@@@@@@@@@@@@@@@@@@............@....@@@@@@@@@@@@@@@@@
8
53 46 0
49 31 0
42 29 0
27 57 0
6 28 0
13 45 0
16 39 0
25 27 0

7 3 0
7 2 0
34 58 0
27 58 0
26 18 0
46 48 0
54 25 0
1 19 0
