width 70
height 70
@@@@@@@@@@@@@@@@............@........@@@@@@@@@......@@.............@@@
@@@@@@@@@@@@@@@..................@...@@@....@@....................@..@
@@@@@@@@....@@@...........@@....@....@@...............................
@@@@@@@@...........................@.......................@..........
@@@@@@@@@@@..........@.............@...@..............................
@@@@@@@@@@@.........@...@@.........@..........@.........@@............
@@@@@@@@@@@.........@@..@@@...@@......................@..@@...........
@@@@@@@@@@........@@@@................@.....@.............@.....@.....
@@@@@@@@@@.........@.@@................................@......@.......
@@.@@@@@@@...........@.......................@........................
...@@@@@@@....@......................@@@.....................@........
...@@@@@@@@..@........@..........@@..@..................@@............
...@@@@@@@@....@@...................@@.........@.........@............
..@@@@@@@@@@...@...............................@.........@@@..........
..@@@@@@@..@.........................@.@..................@@..........
....@@@@...@@.@.............@@@@@@@@@@@@@.@@@....@............@@....@.
....@@@@....@@.......@@.......@@@@@@@@@@@@@@@@@...............@@...@@@
@@@.@@@@......................@@@@@@@@@@@@@@@.......@@........@@.....@
@@.....@......................@@@@@@@@@@@@@@@....@@@...........@..@@.@
@@.....@.......................@@@@@@@@@@@@@@...@..@.....@@....@.....@
@@@....@........@@.............@@@@@@@@@@@@@....@...@...@@@.....@@....
@@@....@....@..@@..............@@@@@@@@@@@@@....@.....................
@@@@..@........@@...............@@@@@@@@@@......@............@........
@@@@..@......@@@......@........@@@@@@@@@@@..........@@@.........@.....
@............@@@................@@@@@@@@@@...........@................
..@....@@@........................@@.@@@@..@..@.......................
..@........@..................@....@..@....@..........................
.......@..............@...............@...@@................@.........
@................@@.....@@..................................@@.....@..
.................@...@@@@@..............@.......@....@......@@.....@.@
.............@@.....@@@@@@..........@....................@.........@@@
....@.@.........@...@@@@@@....................@.....@@............@@@@
@...........@.......@@@@.........................@..@@..........@@@@@@
@....@.....@@.......@@..............................@....@......@@@@@@
.@..@@...@@@........@@....@@.......@....@@........................@@@@
........@@@.@........@@.@..........@@....@............@..............@
............@.........@.........................@@@.......@...........
......@....@.............................@......@@...@@........@@....@
......@.............@...@.@.........@...@@............@.............@@
........................................@@......@@................@@@@
@@.....@........@@...@@........@@............@....................@@@@
@.....@........@@@@.....@...............................@.........@@@@
..........@.....@.@@...@......................@............@.....@@@@@
........@@@.....@..@........@@..@.......................@@@@.....@@@@@
.....@..@@......@.........@@@............................@@......@@@@@
........@@.................@@.......@.................@@..@..@.....@@@
@@.@..@@@@.................@@...........@@............@@.....@.....@@@
@@@@..@@@................................@...................@...@@@@@
@@@...@@@........@...............@@..........................@...@@@@@
@@@...@@@........@..@............@.....@@@......@................@@@@@
@@@....@@@.@@@@..@@...@@...........@...@@.........@...............@@@@
@@@@@...@..@@@@....@......................@......................@@@@@
@@.............@....@............................................@@@@@
@........................@..........................@............@@@@@
..................@..............................................@@@@@
...@@@............@...@.@@@@@@........................@......@@..@@@@@
...@@..........@......@.@@@@@@@@@...................@@@.....@@@@.@@@@@
...@...........@..........@@@..@@..@.........................@@@@@@@@@
@.......@@...........@.@.................@....@@.@..........@@@@@@@@@@
.................................@@@..........@@.................@@@@@
..........@..............@......@.............@..@@....@..@...@..@@@@@
@.........@................@.@...................@...@...........@@@@@
......@..@@..........................................@@........@@@@@@@
.........@....@@@...........@........................@@........@@@@@@@
....@..............@..@@...@@...........................@......@@@@@@@
....@.............@@@@@@...@....@.................................@@@@
@@................@@@@@@.......................@@..................@@@
@@@@@......@....@..@@@@.....@.@..................@.................@@@
@@@@.......@.......@@@....@............@@....@...@@@@@.......@.@...@@@
@@@@..@.@@.........@@@..@....@@@........@........@@@@@@.@..........@@@
8
63 33 0
25 48 0
63 50 0
31 61 0
23 41 0
63 28 0
65 10 0
8 16 0

9 2 0
14 3 0
62 62 0
60 68 0
44 58 0
53 45 0
10 66 0
62 66 0
