width 70
height 70
@@@@@@@@@@@@@@@@@@@@@@@@@@@@@@@@@@@@@@@@@@@@@@@@@@@@@@@@@@@@@@@@@@@@@@
@@@@@@@@@@@@@@@@@@@@@@@@@@@@@@@@@@@@@@@@@@@@@@@@@@@@@@@@@@@@@@@@@@@@@@
@@@@@@@@@@@@@@@@@@@@@@@@@@@@@@@@@@@@@@@@@@@@@@@@@@@@@@@@@@@@@@@@@@@@@@
@@@@@@@@@@@@@@@@@@@@@@@@@@@@@@@@@@@@@@@@@@@@@@@@@@@@@@@@@@@@@@@@@@@@@@
@@@@@@@@@@@@@@@@@@@@@@@@@@@@@@@@@@@@@@@@@@@@@@@@@@@@@@@@@@@@@@@@@@@@@@
@@@@@@@@@@@@@@@@@@@@@@@@@@@@@@@@@@@@@@@@@@@@@@@@@@@@@@@@@@@@@@@@@@@@@@
@@@@@@@@@@@@@@@@@@@@@@@@@@@@@@@@@@@@@@@@@@@@@@@@@@@@@@@@@@@@@@@@@@@@@@
@@@@@@@@@@@@@@@@@@@@@@@@@@@@@@...@@@@@@@@@@@@@@@@@@@@@@@@@@@@@@@@@@@@@
@@@@@@@@@@@@@@@@@@@@@..@@.@@@@....@@@@@@@@@@@@@@@@@@@@@@@@@@@@@@@@@@@@
@@@@@@@@@@@@@@@@@@@@.............@@@@@@@@@@@@@@@@@@@@.@@@@@@@@@@@@@@@@
@@@@@@@@@@@@@@@@@@@.................@@@@@@@@@@@@@@@...@@@@@@@@@@@@@@@@
@@@@@@@@@@@@@@@@@@@................@@@@@@@@@@@@@@@....@@@@@@@@@@@@@@@@
@@@@@@@@@@@@@@@@....@@..@@@@.......@@@@@@@@@@@@@@.....@@@@@@@@@@@@@@@@
@@@@@@@@@@@@@@@......@...@@........@@@@@@@.....@@.....@@@@@@@@@@@@@@@@
@@@@@@@@@@@@@@@......@....@........@@@@@@@......@.....@@@@@@@@@@@@@@@@
@@@@@@@@@@@@@@@@..@@.............@.@@@@@@@@.....@......@@@@@@@@@@@@@@@
@@@@@..@.....@@..@.................@@@@@........@@.......@@@@@@@@@@@@@
@@@@@........@@@@@@.................@@..........@@........@@@@@@@@@@@@
@@@@@........@@@@....................@...........@......@@@@@@@@@@@@@@
@@@..........@@@@............@@.................@@......@@@@@@@@@@@@@@
@@.......@.@.@...............@........@@@.......@.......@@@@@@@@@@@@@@
@@@@@.................................@@...@@@..........@@@@@@@@@@@@@@
@@@@@@....................@.........@..........@....@..@@@@@@@@@@@@@@@
@@@@@@@@..........@@@@@@..@......@......................@@@@@@@@@@@@@@
@@@@@@@.............@@@@@................@@..@@.......@.@.@@@@@@@@@@@@
@@@@@@@...........@@@@@@@...@............@@@.@@...........@@@@@@@@@@@@
@@@@@@@@..........@@@@@@@........@.......@...@@................@@@@@@@
@@@@@@@@.........@@...@@...@@............@......................@@@@@@
@@@@@@@...................@@@....@@@................@...........@@@@@@
@@@@@@@.......@........@...........@.......@........@............@@@@@
@@@@@@@......@@@.....@@...........................................@@@@
@@@@@@@..........................................@@@.......@....@@@@@@
@@@@@@@@................@..........@.@...@.......@@@...........@@@@@@@
@@@@@@@@@.....@@........@......................................@@@@@@@
@@@@@@@@@@@..@@...................@..................@........@@@@@@@@
@@@@@@@@........................@@@............................@@@@@@@
@@@@@@@@@.....@.................@@....@.........................@@@@@@
@@@@@@@...@...@@@........................................@@@......@@@@
@@@@@@@.....@..@@...@......................................@........@@
@@@@@@@...................@@......................@.......@@........@@
@@@@@@@.......................@@@..@................@@@.............@@
@@@@@@@..................@@.......................@..@@...............
@@@@@@@..........@@..........@.@......@....@......@..@@...............
@@@@@@@...........................@@@@@@...@......@...................
@@@@@@@..@.........@..............@@@@@@..@.....@@@@..................
@@@@@@@...........@..............@@@@@@@........@.......@@.@@@..@@....
@@@@@@..............................@@@@........@...@.......@@@@@@....
@@@@@@@............................@@@@@.................@@@@@@@@@....
@@@@@@@........@....................@@@@.@.............@@@@@..........
@@@@@@@....................@@.......@@@@@@.............@@@@@@@@@@.....
@@@@@@@....@..........@............@@@@@@@.............@@@@@@@@@@.....
@@@@@@@@.......................@@..@@@@@...............@@@@@@@@@@.....
@@@@@@@@@.@@....@..@@................@@@.............@.@@@@@@@@@@....@
@@@@@@@@@@@@...............@...@....................@@.@@@@@@@@@@.....
@@@@@@@@@@@@......................................@.@@.@@@@@@@@@@.....
@@@@@@@@@@@@@@@@..................@....................@@@@@@@@@@@....
@@@@@@@@@@@@@@@@..................@.........@..........@@@@@@@@@@@..@.
@@@@@@@@@@@@@@@@........................................@@@@@@@@@@@@@@
@@@@@@@@@@@@@@@@@...................@.................@@@@@@@@@@@@@@@@
@@@@@@@@@@@@@@@@@............................@@@@.....@@@@@@@@@@@@@@@@
@@@@@@@@@@@@@@@@@.@............@...@.........@@@@......@@@@@@@@@@@@@@@
@@@@@@@@@@@@@@@@@@@@.........@@.............@@@@@@......@@@@@@@@@@@@@@
@@@@@@@@@@@@@@@@@@@@@@.....................@@@@@@@@......@@@@@@@@@@@@@
@@@@@@@@@@@@@@@@@@@@@......................@@@@@@@@......@@@@@@@@@@@@@
@@@@@@@@@@@@@@@@@@@.........@..............@@@@@@@.....@@@@@@@@@@@@@@@
@@@@@@@@@@@@@@@@@@@.......@...........@.@@@@@@@@@@@@@@@@@@@@@@@@@@@@@@
@@@@@@@@@@@@@@@@@@@@@....................@@@@@@@@@@@@@@@@@@@@@@@@@@@@@
@@@@@@@@@@@@@@@@@@@...................@..@@@@@@@@@@@@@@@@@@@@@@@@@@@@@
@@@@@@@@@@@@@@@@@@@@....................@@@@@@@@@@@@@@@@@@@@@@@@@@@@@@
@@@@@@@@@@@@@@@@@@@@....................@@@@@@@@@@@@@@@@@@@@@@@@@@@@@@
8
18 48 0
27 65 0
59 42 0
21 49 0
62 35 0
30 32 0
12 17 0
44 38 0

18 48 0
37 65 0
16 24 0
20 18 0
44 19 0
29 24 0
41 53 0
21 66 0
