width 20
height 24
....................
....................
....................
..........@.@.@.....
.................@..
......@...@.........
..............@.....
@..@..@...@@........
...........@........
..@....@..........@.
@.....@....@...@.@..
....@.....@.@@......
......@.............
....................
.................@..
....@......@........
..................@@
@.@...@...@.........
...................@
.............@......
..@.............@.@.
...................@
.....@..@..........@
........@..........@
6
2 4 0
9 12 0
15 16 0
13 21 1
11 0 1
3 22 1

8 2 0
18 5 0
4 1 0
11 0 1
2 22 1
8 7 1
