width 20
height 24
...................@
@.......@...........
@@...@.....@........
......@..@..........
............@.......
......@...@.........
.....@..@..........@
....................
......@...@.....@.@.
.............@......
@...@...............
...........@...@....
......@......@......
..@..@.@............
.@...............@..
..@.....@...........
...@....@......@....
....................
......@.........@...
..@.......@.@.@.....
....................
..@................@
..............@@...@
............@@@@....
6
13 6 0
16 5 0
11 10 0
1 10 1
19 3 1
18 10 1

10 11 0
7 21 0
1 11 0
17 17 1
18 4 1
19 18 1
