width 20
height 24
.......@...........@
......@..@..........
..................@.
...@................
......@.............
.............@...@..
@..............@....
......@...@...@.....
....@...@...........
...............@...@
...........@@.......
..@.................
....................
....@.......@.......
..@.............@...
......@..@...@......
........@...........
....@@...@....@....@
............@@...@.@
...@..@.@...........
...........@........
..............@.....
.....@..............
@@@@................
6
10 15 0
10 18 0
6 10 0
9 6 1
17 6 1
7 10 1

18 19 0
12 3 0
5 7 0
18 23 1
5 9 1
16 21 1
