width 20
height 24
.....@..............
.................@@.
.@..................
...................@
............@..@....
...@..@....@.......@
..............@.@...
....................
....................
@......@.....@......
........@...........
................@...
....@...............
..........@.@.......
...@.......@........
......@.............
......@.............
.................@..
...@....@...@.......
.............@.@....
............@.@.....
....................
....@..@............
........@...........
6
9 16 0
5 10 0
3 9 0
19 4 1
6 21 1
9 22 1

16 2 0
18 2 0
6 11 0
17 5 1
0 13 1
12 11 1
