width 15
height 15
.@@@@@.........
..@@@@@........
...@@@.........
.....@..@......
@......@@......
.......@@....@@
.............@@
............@@@
...@..........@
...............
....@..........
....@@.........
....@.........@
@@@.....@@@@..@
@@......@@@@@@@
8
12 8 0
8 6 0
14 3 0
3 7 0
6 8 0
13 4 0
6 0 0
12 13 0

0 1 0
14 11 0
12 6 0
14 1 0
12 0 0
12 1 0
7 0 0
13 13 0
