width 15
height 15
@@@@....@@@@@@@
@@@......@@@@@@
@@.@....@@@@@@@
@..@.....@@@@@@
@..@.......@@@@
@.........@@@@@
@.........@@@@@
@........@@@@@@
..........@@@@.
...........@@..
....@@.....@@.@
....@.........@
.............@@
@............@@
@@@..........@@
8
0 9 0
10 9 0
8 1 0
9 8 0
2 3 0
7 11 0
7 4 0
6 1 0

0 10 0
8 5 0
12 12 0
10 13 0
8 11 0
7 3 0
7 4 0
14 8 0
