width 15
height 15
@@@@..@..@...@@
@@@@.......@...
@@@@..@..@.....
@@@@..@..@..@@@
..........@@.@@
...............
..@............
...............
@@..@...@......
@@.............
@@...@@......@.
@...@@@.@....@@
@@@@@@@@@....@@
@@@@@@@@.....@@
@@@@@@@@@....@@
8
12 13 0
2 10 0
11 11 0
4 6 0
12 11 0
9 8 0
9 4 0
4 7 0

0 5 0
5 0 0
10 7 0
12 14 0
11 5 0
9 8 0
9 12 0
4 6 0
