width 15
height 15
@@@.......@@@@@
..@........@@@@
.....@.....@@@@
@.......@..@@@@
@..........@@@@
...........@@@@
...........@@@@
...@.........@@
...@..@......@@
.....@@......@@
@.........@..@@
.............@@
@............@@
....@@@.....@@@
@@..........@@@
8
0 1 0
4 4 0
11 7 0
3 12 0
8 11 0
9 8 0
10 1 0
3 1 0

12 12 0
6 11 0
3 12 0
4 14 0
11 11 0
9 8 0
2 14 0
7 12 0
