width 15
height 15
@@@...@@@@@@@@@
@@@..@.@@...@@@
@@@.....@...@@@
............@@@
............@@@
...@@.....@...@
..@............
...............
....@....@.....
....@@@@..@@@..
...@@@@@@@.....
...@@@@@@@.....
...@@@@@@@....@
@..@@@@@@@@@@..
...@@@@@@@@@@@@
8
1 10 0
11 7 0
2 10 0
14 13 0
9 4 0
12 10 0
1 9 0
1 11 0

7 2 0
3 9 0
10 1 0
3 2 0
11 10 0
13 9 0
2 7 0
0 8 0
