width 15
height 15
@.....@........
@..............
..........@....
....@.....@....
@@@.@........@@
@@@@....@@..@@@
@@@@...........
@.@@........@..
...............
...............
@..............
@....@.........
@@.@@@.........
.............@.
...............
8
5 14 0
4 11 0
14 2 0
1 8 0
11 9 0
6 3 0
13 0 0
8 8 0

5 9 0
10 4 0
0 13 0
1 3 0
3 14 0
8 12 0
8 3 0
1 11 0
