width 81
height 81
@@@@@@@@@@@@@@@@@@@@@@@@@@@@@@@@@@@@@@@@@@@@@@@@@@@@@@@@@@@@@@@@@@@@@@@@@@@@@@@@@
@@@@@@@@@@@@@@@@@@@@@@@@@@@@@@@@@@@@@@@@@@@@@@@@@@@@@@@@@@@@@@@@@@@@@@@@@@@@@@@@@
@@@@@@@@@@@@@@@@@@@@@@@@@@@@@@@@@@@@@@@@@@@@@@@@@@@@@@@@@@@@@@@@@@@@@@@@@@@@@@@@@
@@@@@@@@@@@@@@@@@@@@@@@@@@@@@@@@@@@@@@@@@@@@@@@@@@@@@@@@@@@@@@@@@@@@@@@@@@@@@@@@@
@@@@@@@@@@@@.@@@@@@@@@@@@@@@@@@@@@@@@@@@@@@@@@@@@@@@@@@@@@@@@@@@@@@@@@@@@@@@@@@@@
@@@@@@@@......@...@@@@@@@@@@@@@@@@@@@@@@@@@@@@@@@@@@@@@@@@@@@@@@@@@@@@@@@@@@@@@@@
@@@@@@@@@.........@@@@@@@@@@@@@@@@@@@@@@@@@@@@@@@@@@@@@@@@@@@@@@@@@@@@@@@@@@@@@@@
@@@@@@@@@@........@@....@@@@@@@@@@@@@@@@@@@@@@@@@@@@@@@@@@@@@@@@@@@@@@@@@@@@@@@@@
@@@@@@@@@@...@....@....@@@@@@@@@@@@@@@@@@@@@@@@@@@@@@@@@@@@@@@@@@@@@@@@@@@@@@@@@@
@@.@@.@@@..............@@@@@@@..@....@@@@@@@@@@@@@@@@@@@@@@@@@@@@@@@@@@@@@@@@@@@@
.......@@.........@.....@@@@@........@@@@@@@@@@@@@@@@@@@@@@@@@@@@@@@@@@@@@@@@@@@@
........@.........@....@@@@@@........@@.@@@@@@@@@@@@@@@@@@@@@@@@@@@@@@@@@@@@@@@@@
....@........@.......@.@@@@@@@...........@@@@@@@@@@@@@@@@@@@@@@@@@@@@@@@@@@@@@@@@
........@@........@@...@@@@@...........@.@@@@@@@@@@@@@@@@@@@@@@@@@@@@@@@@@@@@@@@@
...@....@@@@............@@.............@@@@@@@@@@@@@@@@@@@@@@@@@@@@@@.@@@@@@@@@@@
......@.@........@..@@...@.............@@@@@@@@@@@@@@@@@@@@@@@@@@@@.....@.@@@@@@@
.....@.................................@@@@@@@@@@@@@@@@@@@@@@@@@@@@@.......@@@@@@
@@.........................@.......@...@@@@@@@@@@@@@@@@@@@@@@@@@@@.........@@@@@@
@@.......................@.......@@@....@@@@@@@@@@@@@@@@@@@@@@@@...........@@@@@@
@@............@....@...@.......@@@@@....@@@@@@@@@@@@@@@@@@@@@@@@..............@@@
@@...........@...........@@....@@@@@@....@@@@@@@@@@@@@@@@@@@@@@@..@.........@@@@@
@..................@.....@....@@@@@......@@@@@@@@@@@@@@@@@@@@@@@@@@.@.....@@@@@@@
@.....@............@@..........@@@@@.....@@@@@@@@@@@@@@@@@@@@@@@@.........@@@@@@@
@..................@@@.@.......@@@@......@@@@@@@@@@@@@@@...@@.@@@....@....@@@@@@@
..........@@.......@@...............@...@@@@@@@@@@@@@@@@@@.................@@@@@@
..@.@.....@@.......@..........@...@@@....@@@@@@@@@@@@@@@@@..............@@..@@@..
...........@.@@..................@........@@@@@.@@@@@@@@@@.......................
..@@................@.....@......@.........@.....@@@@..@@@@......................
....................@@......@....@..@@@.@@@@@@@@.@.@@...@........................
.......................@@...@...@@..@@@.@@@@@@@@............................@....
......................@@@...........@@@@@@@@@@@........@@..@.........@@.........@
.....................@@@@...........@@@@@@@@@@........@@@.@@......@...@.........@
.......@.@..........@.@@............@@@@@@@@...............@...@@@@@@@@..........
.......@@@@@@......@.....@....@.....@@@@@@@...........@@........@..@@@@......@...
@@@@@@@@@@@@@...@......@@@..@.........@@@@@........@@.......@........@@......@@@@
@@@@@.........@...@.....@@@.......@....@@@@........@@................@.@...@@@@@@
@@@@...@......@@@.......@@....@@..........@@....@......................@..@@@@@@@
@.@@..@@.....@@@@...@.......@...................@......@...@@..........@@@@@@@@@@
......@@@@...@@@@@..@...@.......................@.......................@@@@@@@@@
..@....@@@@@@@@@@@..@...........................@..@....................@@@@@@@@@
@..........@@@@@.@.......@....@@@@......@@..................@...@.........@@@@@@@
@....@.......................@@@@@@.@...@@@..........@............@.......@@@@@@@
@@...............@........@..@@..@@.....@@@.@.............................@@@@@@@
@@...............@@@.@@@.@...@@.........@@@@.....@@....@.............@......@@@@@
............@@@@...@.@@...........................................@@.@......@@@@@
.............@@@.....@.@.@...........@......................@@@@.@@........@@@@@@
.............@@@.@.........@.@......@@..................@@..@@@.@.............@@@
.......................@@........@............@@.........@....@...@@@...........@
........@@...........@.@@............@@@.......................@@.@@@..........@@
@@@.@@..@@@@.........@..........@@@..@@@@@...........@....@.....@................
@@@@@@@@@@@@@....@..@..........@@@@..@@@@@@@...............@..................@@.
@@@@@@@@@@@@@.@@@@@.....@@.......@...@@@@@@@.......@..@....@@....................
@@@@@@@@@@@@@@@@@@..@..............@@@@@@..................@@..........@..@@.@@..
@@@@@@@@@@@@@@@@@@...@@..............@@@@@@...............................@@@@@.@
@@@@@@@@@@@@@@@@@@.....@...@@........@@@@@@@........@.......@.............@@@@@..
@@@@@@@@@@@@@@@@@.............@......@@@@@@@.......@......................@@@@...
@@@@@@@@@@@@@@@@@...........@@@......@@@@@@@@..................@.........@@..@..@
@@@@@@@@@@@@@@@@@.............@@.....@@@@@@@@....@.........@..@@..........@.@....
@@@@@@@@@@@@@@@@@.............@......@@@@@@@@.................@@.........@@......
@@@@@@@@@@@@@@@@@.....@............@@@@@@@@@@@...............@@@@@...@@..@@.@@...
@@@@@@@@@@@@@@@.......@@..@........@@@@@@@@@@@@.....@@@..@@..@@@@@.@@@@..........
@@@@@@@@@@@@@@@...........@........@@@@@@@@@@@@@....@@@@@@@.......@@@@@..........
@@@@@@@@@@@@@@.......@..@.@@@....@@@@@@@@@@@@@@@....@@@@@@@.......@@............@
@@@@@@@@@@@@@@@@.....@....@@@@@@@@@@@@@@@@@@@@@@@....@@.@@@.....@.@@@............
@@@@@@@@@@@@@@@@...@.....@@@@@@@@@@@@@@@@@@@@@@@@.@.............@@@@@@..........@
@@@@@@@@@@@@@@@@.......@@@@@@@@@@@@@@@@@@@@@@...........@.@.............@.....@@@
@@@@@@@@@@@@@@@@.......@..@@@@@@@@@@@@@@@@@@@.............@...........@@@......@@
@@@@@@@@@@@@@@@@@@........@@@@@@@@@@@@@@@@@............................@...@....@
@@@@@@@@@@@@@@@@@..........@@@@@@@@@@@@@@@............................@@.....@@..
@@@@@@@@@@@@@@@@@....@.@...@@@@@@@@@@@@@......@....................@.........@@..
@@@@@@@@@@@@@@@@@....@.....@@@@@@@@@@@@@@......................@@@...............
@@@@@@@@@@@@@@@@@.@........@@@@...@@.@@...@.....@..........@........@@@@.........
@@@@@@@@@@@@@@@@@@@...................@................@.....@......@@.......@@@@
@@@@@@@@@@@@@@@@@@..........@.........@......@@..............@@..........@@..@@@@
@@@@@@@@@@@@@@@@@@...........................................................@@@@
@@@@@@@@@@@@@@@@@@....@@@..........@....@@@...@...............................@@.
@@@@@@@@@@@@@@@@@@@..@@@@@...............@@@@@@@....@...@.............@..........
@@@@@@@@@@@@@@@@@@..@@@@@@@............@@@@@@@@..................................
@@@@@@@@@@@@@@@@@@@@@@@@@@@..@.@@......@@@@@@@@.....@....................@.......
@@@@@@@@@@@@@@@@@@@@@@@@@@@@.@.@@@..@@@@@@@@@@@.............@....@@@@..@.........
@@@@@@@@@@@@@@@@@@@@@@@@@@@@@@@@@@@@@@@@@@@@@@@......@@..........@@@@.......@@...
8
43 42 0
32 34 0
23 41 0
24 22 0
18 39 0
49 68 0
14 17 0
75 76 0

45 42 0
12 48 0
34 32 0
46 71 0
72 80 0
48 49 0
18 16 0
4 46 0
