width 81
height 81
@@@@@@@@@@@@@.@.......@@@@@@@@...@@@@@@@@@@@@@@@@@@...........@....@@@@@@@@@@@@@@
@@@@@@@@@@@@@...@@....@@................@@@@@@@@@@@@..@....@@......@@@@@@@@@@@@@@
@@@@@@@@@@@@@@@.....@.@@..@............@@@@@@@@@.................@@@@@@@@@@@@@@@@
@@@@@@@@@@@............@..@...........@@@@@@@@@@..@.........@...@@@@@@@@@@@@@@@@@
@@@@@@@@@@.......................@@.@@@@..@@@@@@@...........@@....@@@@@.@@@@@@@@@
@@@@@@@@@........................@@.......@@@@@....@@@............@.@@..@@@@@@@@@
@@@@@@@@@..@@@@........@.@...............@@.@....@@@@@@@................@@@@@@@@@
@@@@@@@@@@@@@@@@.........@@..............@@......@@@@.@@................@@@@@@@@@
@@@@@@@@@@@@@@@@......@..........................@@@..@.............@@@.@@@@@@@@@
@@@@@@@@@@@@@@@@@@@@@@@...............@@................................@@@@@@@@@
@@@@@@@@@@@@@@@@@@@@@@@.............@@@@..........@.......................@@@@@@@
@@@@@@@@@@@@@@@@@@@@@@@@@@.......@@@@@@@.........@@......@....@...........@@@@@@@
@@@@@@@@@@@@@@@@@@@@@@@@@@@......@@@@@@@......@.@@@@@.........@..........@@@@@@@@
@@@@@@@@@@@@@@@@@@@@@@@@@@@.......@@@@@@.....@@@@@@@@....@@..@...........@@@@@@@@
@@@@@@@@@@@@@@@@@@@@@@@@@........@@@@@@.......@.@@..................@....@@...@@@
@@@@@@@@@@@@@@@@@@@@@@@@@........@@@@@@......................................@@@@
@@@@@@@@@@@@@@@@@@@@@@@@@........@@@@@@@@........@.@..................@......@@@@
@@@@@@@@@@@@@@@@@@@@@@@@@@......@@@@@@@..........@....................@...@@@@@@@
@@@@@@@@@@@@@@@@@@@@@@@@@@.@.....@@@@@@.............@@..................@@@@@@@@@
@@@@@@@@@@@@@@@@@@@@@@@@@@@.......@@@@@.............................@.@@@@@@@@@@@
@@@@@@@@@@@@@@@@@@@@@@@@@@@@.........@@...............................@@@@@@@@@@@
@@@@@@@@@@@@@@@@@@@@@@@@@@@@@.......................................@@@@@@@@@@@@@
@@@@@@@@@@@@@@@@@@@@@@@@@@@@@..........@....................@.......@..@@@@@@@@@@
@@@@@@@@@@@@@@@@@@@@@@@@@@@............................................@..@@@@@@@
@@@@@@@@@@@@@@@@@@@@@@@@@.................................@...............@@@@@@@
@@@@@@@@@@@@@@@@@@@@@@@@@@.....@@@.....@..................................@@@@@@@
@@@@@@@@@@@@@@@@@@@@@@@@@@@....@@@............@...@..@...................@.@@@@@@
...@@@@@@@@@@@@@@.....@@@@@@...............@@@@@.....................@.....@@@@@@
...@@@@@@@@@@@@@@@@....@@@@@...............@@@@............................@@@...
....@@@@.@@@@@@@@@@@.....@@@...............@@...............................@@...
.........@@@@..@@@@@.....@...@@..........@@@@..........@.........................
@@........@.....@@@@@@...@...@@..........@@@..@@..@..............@.@@....@@......
@.........@.@...@@@@@@.......@@@..............@@..@.................@....@@@.....
@.......@.@.@..@@@@@@@@@......@@.........................................@.......
@@........@....@.@@@@@@@...@.....................................................
@@........@....@...@@@@@........@@...............................@@@...........@@
....@@.........@.....@@@........@@@@..........@@@............@..@@@@@@@@......@@@
....@@.....@......................@@..........@@.@...........@..@@@@@@@........@@
@......@.......................................@........@@@@@@@.@@@@@@@....@.....
@......................@.......................@........@@@@@@@@@@@@@@@..........
@.....................................@......@@@@..@@..@@@@@@@@@@@@@@@@...@@.@@@@
@@@.......@...................................@@@...@..@@@@@@@@@@@@@@@@.@.@@@@@@@
@@@...........................@...............@.........@@@@@@@@@@@@@@@@@.@@@@@@@
@@...@............@..@........@@@@............@...@@...@@@@@@@@@@@@@@@@@@@@@@@@@@
........@.@@..................................@@@..@.@@@@@@@@@@@@@@@@@@@@@@@@@@@@
........@@@@...@........@@@............@......@@@....@@@@@@@@@@@@@@@@@@@@@@@@@@@@
@@..@....@@........@....@@@@..................@@@......@@@@@@@@@@@@@@@@@@@@@@@@@@
.......................@@@@@...................@@......@@@@@@@@@@@@@@@@@@@@@@@@@@
...........@.............@@@@..........................@@@@@@@@@@@@@@@@@@@@@@@@@@
....................@..@.@@@........@.....@@@..........@@@@@@@@@@@@@@@@@@@@@@@@@@
.....@@.............@@@@@@@..........@@@@.@@...@@....@@@@@@@@@@@@@@@@@@@@@@@@@@@@
.....@@@@..........@@@@@@@@......@.@@@@@.......@......@@@@....@@@@@@@@@@@@@@@@@@@
.....@@@..@..........@@@@@.........@@@@@......@@@.....@@......@@@@@@@@@@@@@@@@@@@
@...@.@@.............@@@...........@@@@..............@......@@@@@@@@@@@@@@@@@@@@@
@...@....@@@.@.......@@@@@@@.......@@@@@....................@@@@@@@@@@@@@@@@@@@@@
@.....@..@@@...........@@@@@@@.....@@@@@@@..................@@@@@@@@@@@@@@@@@@@@@
@@@@......@.........@..@@@@@@......@@@@@@@.....................@@@@@@@@@@@@@@@@@@
@@@@..@............@...@@@@@@....@..@@@@@@.............@.@@....@@@@@@@@@@@@@@@@@@
@@@.........@.@........@@@@@@@@......@@@@..............@.......@@@@@@@@@@@@@@@@@@
@@@.......@@@.........@@@@@@@......@@@@@..........@...........@@@@@@@@@@@@@@@@@@@
..........@@@@........@@@@@@.......@@@@@..................@...@@@@@@@@@@@@@@@@@@@
............@@.........@@@@....@..@@@@@@@@................@@@.@@@@@@@@@@@@@@@@@@@
............@@.........@@@@....@.....@.@..@..............@@@@@@@@@@@@@@@@@@@@@@@@
.......................@@....@.............@@........@...@@@@@@@@@@@@@@@@@@@@@@@@
...@..@................@@...............................@@@@@@@@@@@@@@@@@@@@@@@@@
...@@@@@@....@..........@@@......@....@......@.........@@@@@@@@@@@@@@@@@@@@@@@@@@
...@@@@@@@...@.@@.@..@@@@@@@..@......@..@...@@@........@@@@@@@@@@@@@@@@@@@@@@@@@@
..@@@@@@.......@.....@@@@@@..................@......@@@@@@@@@@@@@@@@@@@@@@@@@@@@@
.@@@@@@@@............@@@@@@.......@.........@.......@@@@@@@@@@@@@@@@@@@@@@@@@@@@@
@@@@@@@@.......@@...@@............@@.......@@........@@@@@@@@@@@@@@@@@@@@@@@@@@@@
@@@@@@@@@..@@.@@@.........@...............@@.......@@@@@@@@@@@@@@@@@@@@@@@@@@@@@@
@@@@@@@@@@@@@@@@............................@......@@@@@@@@@@@@@@@@@@@@@@@@@@@@@@
@@@@@@@@@@@@@@@@.................................@...@@@@@@@@@@@@@@@@@@@@@@@@@@@@
@@@@@@@@@@@@@@@@......@.........@@@...@@..............@@@@@@@@@@@@@@@@@@@@@@@@@@@
@@@@@@@@@@@@@@@@.......................@.....@@.......@@@@@@@@@@@@@@@@@@@@@@@@@@@
@@@@@@@@@@@@@@@@@........@.............@....@@@......@@@@@@@@@@@@@@@@@@@@@@@@@@@@
@@@@@@@@@@@@@@...........@.............@.@...@......@@@@@@@@@@@@@@@@@@@@@@@@@@@@@
@@@@@@@@@@@@............@@............@@...........@@@@@@@@@@@@@@@@@@@@@@@@@@@@@@
@@@@@@@@@@@@.@@@......@@@@@@....@@@....@..............@@@@@@@@@@@@@@@@@@@@@@@@@@@
@@@@@@@@@@@@@@@@@.....@@@@@@..@.@@@.@....@.............@@@@@@@@@@@@@@@@@@@@@@@@@@
@@@@@@@@@@@@@@@@@..@@@@@@@@@..@.@@@@@...................@@@@@@@@@@@@@@@@@@@@@@@@@
8
2 66 0
53 36 0
57 56 0
42 26 0
16 0 0
21 39 0
20 38 0
76 39 0

6 38 0
2 63 0
44 42 0
42 14 0
29 21 0
54 31 0
53 27 0
51 55 0
