width 81
height 81
@@@@@@@......@..@@@@@@@@@@@@@@@@@@@@@@@@@@@@@@@@@@@@@@.@..............@@@@@@@@@@@
@@@@@@@.........@@@@@@@@@@@@@@@@@@@@@@@@@@@@@@@@@@@@@@.........@............@@@@@
@@@@@@@....@....@@@@@@@@@@@..@@@@@@@@@@@@@@@@@@@@@@@@................@....@@@@@@@
@@@@@@.....@....@@@@@@@@@.....@@@@@@@@@@@@@@@@@@@@@........@...........@...@@@@@@
@@@@.............@@@@@@@@......@@@@@@@@@@@@@@@@@@@@...@.............@......@@@@@@
@@@@@..........@.......@..@@@@.@@@@@@@@@@@@@@@@@@@.........................@@@@@@
@@@.@................@.........@@@@@@@@@@@@@@@@@@@@@@@@@.......@.............@@@@
@@..............................@@@@@@@@@@@@@@@@@@@@@@@@.....................@@@@
@......@@@.....@.....@...........@@@@@@@@@@@@@@@@@@@@@@@.............@.........@@
........@@.....@.............@...@@@@@@@@@@@@@@@@@@@@@...........................
.......@@@.....@.................@@@@@@@@@@@@@@@@@@@..@............@...@.....@@..
......@@@@...............@.......@@@@@@@@@@@@@@@@@@@....................@....@..@
@.....@@@.........................@@@@@@@@@@@@@@@@@@.....@@...@...............@..
...@..@............................@@@@@@@@@@@@@@@@@..........@...@..............
..@.........@....@.....@....@@.....@@@..@@@@@@..@@@@......................@...@..
.........@@@.....@.@......@........@@...@.......@@@@.@..@...............@@@.....@
..........@@@....@@@......@........@............@@@.....................@@@..@..@
..........@@...@@........@@....................@@@@.........@@@@@..@....@........
....@...@@@@....@@...@......@......@.......@.@.@@@............@..................
...............@@@@...........@.........................@........................
.........@......@@..................@............................................
......@........@...............@.@.........@..@.....@.....@............@.....@@.@
.........@........@..@@.....@@...............@@@............@@@@@.............@..
.............................................@@.............@@@..................
...............@@@..........................................@@...................
...............................................@..@..........@.........@.........
....................@...................@....@...............@.........@.........
....................@@...................@@@...........@@@.@.....@.........@..@..
..@@................@@@...@..........@...@@@@@....@@@@@@@@@@...........@@..@@@@.@
@...................@@@..................@@@@@.......@@@@@@............@@..@@@@@@
@...................@@@..@...@@@........@@@@@@.......@@@@@.............@@...@@@@@
@@@.....@......@@.@@@@@@.@...@@@.@.....@@@@@@@@.@@@..@@@@@.............@@..@@@@@@
@@@@....@.......@.@@@@@@.@....@@..........@@@@..@@.......@..............@@..@@@@@
@@@@....@.............@.......@...........@@@@@.......@..........@..........@@@@@
@@.........................................@@@@@.....@@@@@..................@@@@@
..........@..@.............................@@@@@..@..............................
@@.........@...............@..@.@..............@.@@@.................@...........
@@.........@........@@@..@@.....@@.....@@@....@@.@@.....................@........
@@....................................@@@@@....@.@........@..........@..........@
.....................@.............@@@@@@...............@@@....@..@.@@..........@
.......................@.........@@@@@@.................@@@..@........@..........
.......................@.........@@@@@@..................@@@.....@...............
.................@.................@@@@.@..@.............@@.....@@@....@@........
......@@......@..@...@@@@.....@@@..@@@@@@..........@@..........@@@@@@@@@@.....@..
.........@....@@.......@@@....@@@...@@@@@@....................@@@@@@@@@@@@...@@..
...............@.@..@@.@@@.@@..@@.....@@@@....................@@@@@@@@@@@@...@@..
@@@@@@....@@........@@.....@@.@@@....@@@@@................@@@@@@@@@@@@@@@........
@@@................@..........@@@.....@@@@................@@....@@@@@@@@@.@..@...
@@@.........@.........@@@....@..@@.....@@@@..@@@......@.@@@......@@@@@@@@@@@@@...
@...........@@.......@@@@.....@..@@....@@....@@@..@.....@.......@@@@@@@@@@@@@@@@@
.@.@.@....@..@..@....@@@@........@..........@@@.....@...........@@@@@@@@@@@@@@@@@
.....................@@@@..................@@@......@@.........@@@@@@@@@@@@@@@@@@
.....@@@..........@...............@@.....@...@......@@.............@@@@@@@@@@@@@@
.......@.@.............@...........@.@@@@@...........@@.............@@@@@@@@@@@..
........@.@...@............@...@........@@@........@@@@.....@........@@@@@@@@....
@..@@..........@...@@........@@@...........@..........@..............@@@@@@@@@...
....@.@@@..............@@@@@@@@@@@@......@@@...@......@@..@.........@@@@@@@@@@...
.......@@............@@@@@@@@@@@@@@............@....@@@..@@...@..@....@@@@@..@...
.......@@....@@@@@....@@@@@@@@@@@@@.................@@@@@@@@@.@@@@.....@@@@......
....@.....@..@@@@@....@@@@@@@@@@@@@@.....@.......@@@@@@@@@@@@@@@.......@.........
........@@@@.@@@@@@@..@@@@@@@@@@@@@@........@....@@@@@@@@@@@@@@@@.............@..
........@@@@@@@@@@@@...@@@@@@@@@@@@...@.....@....@@@@@@@@@@@@@@@@................
.....@@.@@@@@@@@@@@..@..@@@@@@@@@@@........@@.@.@@@@@@@@@@@@@@@..@.........@@....
@..@@@@@@@@@@@@@@@@@.....@@@@@@@@@@@.......@@.@@@@@@@@@@@@@@@@.............@@@...
......@@@@@@@@@@@@@@@@.@@@@@@@@@@@@@@......@@.@@@@@@@@@@@@@@@@......@@@...@@@@@@@
.......@@@@@@@@@@@@@@@@@@@@@@@@@@@@@@......@@@@@@@@@@@@@@@@@@@.....@@@@..@@@@@@@@
@@@...@@@@@@@@@@@@@@@@@@@@@@@@@@@@@@@@@@...@@@@@@@@@@@@@@@@@@@.@@@.@@@@@@@@@@@@@@
@@@@@@@@@@@@@@@@@@@@@@@@@@@@@@@@@@@@@@@@@@@@@@@@@@@@@@@@@@@@@@@@@@.@@@@@@@@@@@@@@
@@@@@@@@@@@@@@@@@@@@@@@@@@@@@@@@@@@@@@@@@@@@@@@@@@@@@@@@@@@@@@@@@@@@@@@@@@@@@@@@@
@@@@@@@@@@@@@@@@@@@@@@@@@@@@@@@@@@@@@@@@@@@@@@@@@@@@@@@@@@@@@@@@@@@@@@@@@@@@@@@@@
@@@@@@@@@@@@@@@@@@@@@@@@@@@@@@@@@@@@@@@@@@@@@@@@@@@@@@@@@@@@@@@@@@@@@@@@@@@@@@@@@
@@@@@@@@@@@@@@@@@@@@@@@@@@@@@@@@@@@@@@@@@@@@@@@@@@@@@@@@@@@@@@@@@@@@@@@@@@@@@@@@@
@@@@@@@@@@@@@@@@@@@@@@@@@@@@@@@@@@@@@@@@@@@@@@@@@@@@@@@@@@@@@@@@@@@@@@@@@@@@@@@@@
@@@@@@@@@@@@@@@@@@@@@@@@@@@@@@@@@@@@@@@@@@@@@@@@@@@@@@@@@@@@@@@@@@@@@@@@@@@@@@@@@
@@@@@@@@@@@@@@@@@@@@@@@@@@@@@@@@@@@@@@@@@@@@@@@@@@@@@@@@@@@@@@@@@@@@@@@@@@@@@@@@@
@@@@@@@@@@@@@@@@@@@@@@@@@@@@@@@@@@@@@@@@@@@@@@@@@@@@@@@@@@@@@@@@@@@@@@@@@@@@@@@@@
@@@@@@@@@@@@@@@@@@@@@@@@@@@@@@@@@@@@@@@@@@@@@@@@@@@@@@@@@@@@@@@@@@@@@@@@@@@@@@@@@
@@@@@@@@@@@@@@@@@@@@@@@@@@@@@@@@@@@@@@@@@@@@@@@@@@@@@@@@@@@@@@@@@@@@@@@@@@@@@@@@@
@@@@@@@@@@@@@@@@@@@@@@@@@@@@@@@@@@@@@@@@@@@@@@@@@@@@@@@@@@@@@@@@@@@@@@@@@@@@@@@@@
@@@@@@@@@@@@@@@@@@@@@@@@@@@@@@@@@@@@@@@@@@@@@@@@@@@@@@@@@@@@@@@@@@@@@@@@@@@@@@@@@
@@@@@@@@@@@@@@@@@@@@@@@@@@@@@@@@@@@@@@@@@@@@@@@@@@@@@@@@@@@@@@@@@@@@@@@@@@@@@@@@@
8
47 31 0
13 44 0
60 39 0
69 35 0
69 20 0
18 23 0
44 36 0
75 11 0

50 34 0
11 0 0
4 4 0
60 29 0
1 59 0
52 10 0
25 27 0
0 42 0
