width 81
height 81
@@@@@.....@@.....@@@@@@@@...@@@......@@@@@.............@@@@@...........@@@@@@@@@@
@@@@@@....@.....@@@@@@@@@@............@................@@@@@@....@@....@@@@@@@@@@
@@@@@@@@...@....@@@@@@@@@@........@.@@@.@................@@........@....@@@@@@@@@
@@@@@@@@...@.....@@@@@@@@@..........@.@.@.............@..@@..............@@@@@@@@
@@@@@@@@@@...........@@@@@.....................@.........@.................@.@@@@
@@@@@@@@@...........@@@@@@.@...@........@@....@..........@@....................@@
@@@@@@@@@....@.......@@@@@@@.......@...@@@....@....@@.....@..@.................@@
@@@@@@@@@.......@....@@@@@@@.........@....................@.....................@
@@@@@@@@@.........@..@@@@@@@........@@.........@.......@..@.....@..@............@
@@@@@@@@@@...........@@@@@@@@.....................................@@............@
@@@@.@@@@@...........@@@@@@@@@............................@..@....@..............
@@@@................@@@@@@@@@.................@..........@@......................
@@@@................@@@@@@@@@..........@....@............@@@.....................
@@@@@................@@@@@@@.........................@...@......@........@.......
@@@@@...............@@@@@@@@.@.@............@...@....@......@@..........@@.....@@
@@@@@@....@@@.......@@@.@@@@@@@@@@@@.......@@..@@@@@.........@@...............@@@
@@@.......@@@...@@.......@@@@@@@@@@@.......@@..@@@@@..@@....................@....
@@@..........@...........@@@@@@@@@.........@...@@@@@@@@@@@@@@...............@@..@
@@@......................@@@@@@@@@@............@@@@@@@@@@@@@@....@......@@.......
@@@................@@.....@@@@@@@@@............@@@@@@@@@@..@........@...@@......@
@@................@@@.....@@@@@@@@@............@@@@@@@@@@@.@@................@.@@
@@................@@@....@@@@@@@@@....@@.....@@@@@@@@@@@@@.........@...@...@@@.@@
..........................@@@@@@@@......@.....@@@@@@@@@@@@....@....@...@@@@@@@@@@
@.............@@...........@@@@@@....@@.@@....@@@@@@@@@@@.........@@..@@@@@@@@@@@
@@.............@........@..@@@@@@....@@@@@....@@@@@@@.............@@.@@@@@@@@@@@@
@@@@@........................@.......@@.@@...@@@@@@@..............@@.@@@@@@@@@@@@
@@@@@............@....@@.@..@@..@....@@.@@.....@@@...................@@@@@@@@@@@@
@@@@@........................................@..@@..............@......@@@@@@@@@@
@@@@@@@......@..........................@@.....@@@..@...........@.....@@@@@@@@@@@
@@@@@@......@@.............@@...........@@..@..@@@@.@@@.........@@....@@@@@@@@@@@
@@@@@@@..@.@@.....@..@.....@@@..........@.....@@@@@......@@.@...........@@@@@@@@@
@@@@@@@@....@@..@.......@.@@@@...............@@@@........@..@...........@@@@@@@@@
@@@@@@@@@.@@@@..............@@...............@@@@............@..@.......@@@@@@@@@
@@@@@@@@@@@@@@...........@@@@@.........@.....@@@@@@@................@.@@@@@@@@@@@
@@@@@@@@@@@@@@.........@.......@@.......@....@@@@@@@@...........@...@.@@.@@@@@@@@
@@@@@@@@@@@@@@@........@..@.......@@@@@.@....@@@@..@......................@@@@@@@
@@@@@@@@@@@@@@@..........@@@@@@..@.@..........@.@....@@..............@.....@@@@@@
@@@@@@@@@@@@@@@@@@.......@@@@@@......@...@....@.........@@@.@........@......@@@@@
@@@@@@@@@@@@@@@@@@@.@....@@@@@...............@..........@@..................@@@@@
@@@@@@@@@@@@@@@@@@@.....@@@@@@@.@..........................................@@@@@@
@@@@@@@@@@@@@@@@@@@...@@@@@@@@@.@..............@...@......................@@@@@@@
@@@@@@@@@@@@@@@@@@@@..@@@@@@@@..@..................................@@@@@@@@@@@@@@
@@@@@@@@@@@@@@@@@@@@.@@@@@@@@@...........................@.........@@@@@@@@@@@@@@
@@@@@@@@@@@@@@@@@@@@@@@@@@@@@@@...@@.....@@......@@.................@@@@@@@@@@@@@
@@@@@@@@@@@@@@@@@@@@@@@@@@@@@@@@...@....@@@@@....@@...@.............@@@@@@@@@@@@@
@@@@@@@@@@@@@@@@@@@@@@@@@@@@@@@@..@@....@@@@....@...@.............@@@@@@@@@@@@@@@
@@@@@@@@@@@@@@@@@@@@@@@@@@@@@@@@@.........@..@....................@@..@@@@@@@@@@@
@@@@@@@@@@@@@@@@@@@@@@@@@@@@@@@@@....@@@.....@@..@.....@@............@@@@@@@@@@@@
@@@@@@@@@@@@@@@@@@@@@@@@@@@@@@@......@@.................@@............@@@@@@@@@@@
@@@@@@@@@@@@@@@@@@@@@@@@@@@@@@@@..@@............@@.....@@@...........@@@@@@@@@@@@
@@@@@@@@@@@@@@@@@@@@@@@@@@@@@@@.................@...@..@@............@@@@@@@@@@@@
@@@@@@@@@@@@@@@@@@@@@@@@@@@@@@..........................@.............@@@@@@@@@@@
@@@@@@@@@@@@@@@@@@@@@@@@@@@...@......................@@@..............@@@@@@@@@@@
@@@@@@@@@@@@@@@@@@@@@@@@@@................@@@@@.................@......@@@@@@@@@@
@@@@@@@@@@@@@@@@@@@@@@@...@...@@..........@@@@@.......@...@.@..........@@@@@@@@@@
@@@@@@@@@@@@@@@@@@@@.@@........@@..........@@@@..@.....................@@@@@@@@@@
@@@@@@@@@@@@@@@@@@@@...........@.@@@.@.....@@@@..@...@@@@@....@.........@@@@@@@@@
@@@@@@@@@@@@@@@@@@@@@.............@@..........@......@@..@.@...............@@@@@@
@@@@@@@@@@@@@@@@@@@@.....@.........................@@@@.....@......@....@..@@@@@@
@@@@@@@@@@@@@@@@@@@.......@@.......@............@..@@@@...............@....@@@@@@
@@@@@@@@@@@@@@@@@@@@........@................@........................@@@@@@@@@@@
@@@@@@@@@@@@@@@@@@@@@.......@..........................@@@....................@@@
@@@@@@@@@@@@@@@@@@@@@............@..........@@@.......@@@@.......................
@@@@@@@@@@@@@@@@@@@@@@@......@..............@@@.......@@@@...@...........@@......
@@@@@@@@@@@@@@@@@@@@@@...................@..........@..@@@..@@......@..@@....@...
@@@@@@@@@@@@@@@@@@@@@@.....@..................@.........@@...@......@............
@@@@@@@@@@@@@@@@@.@@@...@@@@@@@...............@@........@@@.........@..........@.
@@@@@@@@@@@@@@@@@.@@.....@@@@@@@@...........@@@...@@....@@@@.....@..@............
@@@@@@@@@@@@@@@@@........@@@@@@....................................@......@.....@
@@@@@@@@@@@@@@@@@@.....@@@@@@@@.....@............................................
@@@@@@@@@@@@@@@@@@.@..@@@@@@@@@...........@......@@..@...@.......................
@@@@@@@@@@@@@@@@@..@...@@@@@@@@...@.....@@......@@@..@@@@..@...........@....@@...
@@@@@@@@@@@@@@.@@@....@@@@@@@@@@.....@.....@..@.@@@...@@@....@...................
@@@@@@@@@@@@@@.......@@@@@@@@@@@.....@...@@@@.@..@@@..@@@@..@@@..............@..@
@@@@@@@@@@@@@@.....@.@@@@@@@@@@..........@@@@....@@@...@@@@@@@@.@...@@@......@...
@@@@@@@@@@@@@......@@@@@@@@@@@@....@@...@@@@@@.@@@@@@@@@@@@@@@@@@.....@@.........
@@@@@@@@@@@@....@@@@@@@@@@@@@@@....@@...@@@@@@@@@@@@@@@@@@@@@@@@.....@@..........
@@@@@@@@.......@@@@@@@@@@@@@@...@.@@@@@@@@@@@@@@@@@@@@@@@@@@@@@@@..@@@...........
@@@@@@@@....@..@@@@@@@@@@@@@@.....@@@@@@@@@@@@@@@@@@@@@@@@@@@@@@@@@@....@........
@@@@@@@@........@@@@@@@@@@@@@...@.@@@@@@@@@@@@@@@@@@@@@@@@@@@@@@@@@@.........@.@.
@@@@@@@@@....@....@@@@@@@@@@@@@@@.@@@@@@@@@@@@@@@@@@@@@@@@@@@@@@@@@@.@.......@.@.
8
31 51 0
44 5 0
45 5 0
35 25 0
60 5 0
27 57 0
74 80 0
58 43 0

71 16 0
76 18 0
76 67 0
41 48 0
54 46 0
47 70 0
23 24 0
46 44 0
