width 81
height 81
......@........@@@@.......@@.......@..............@@@@@.......@@@@.@....@@@@@@@@@
......@.......@@@@@.................................@@@........@@@......@@@@@@@@@
..............@@@@......@....@.....@...............@@@@.@@.....@@@@@....@@@@.@@@@
..............@...................@@...............@@@@@@..@.....@@@....@....@@@.
.........@............@...........@@................@@@@.........@@@@...@@...@...
...............@................@.@@................@@@................@@@...@...
.............@@....@@....@@@.................@.......@@........@.......@@@.......
.....@.......@@....@.....@@......@...........@.......@.......@@@......@@@@..@@..@
@@@..@..@@...@...........@@@...............@.......@..........@@......@@@@@.@@..@
@@...@@..................@@@..@..........@.........@@..........@........@........
@@@..@....@..............@@@@.@...@..........................@...................
@@@.@................@.@.@@@@@@.....@........@.........@@@...............@.......
@....................@...@@@@@@.........................@@...............@@....@.
@........................@@@@@@.........................@........................
...................@.....@..@@@.................@@...........@..................@
@.................@@@........@.......@.@@...................@@.............@...@@
.......@....@.....@@@........@........@@.............@@.@...@@...@.............@@
......@@..........@.@...............@@@@..........@..@@@@@@..@.................@@
.......@............................@.....@..........@@@@@@...........@.........@
......@@............................@@@@............@@@@........................@
....@.@............................@@@....@..........@@@.........................
....@.........@.....@@@..........@@@@@@@@@@................@@.............@..@@..
..............@...@@@@@@@@@......@@@@@@@@@............@....@@...................@
..........@@.....@@@@@@@@@......@@@@@@@@@@...........@@....@.....................
..........@@.......@@@@@........@@@@@@@@@@@@...................................@.
@................@.@@@@.......@@..@@@@@@@@@@...........@..@...@@....@..@@....@@@@
@................@@@@@.............@@@@@@@.@....@........@@......@..............@
@..@@..................................@...@....@@@@@.................@........@@
@@@@.......@...@....@.........@@.......@...@.....@@@.................@@.....@@@@@
@@@@....@.................@...@...@@@....@.......@@@..........@...@@.@.@....@@@@@
@@@......@@....@.@.@@.............@@@.@..@.......@@@.......@..@................@@
@@@......@.....@@@@@@@@@@.@.......@...@...........@@................@...@@.....@@
@@.............@@@@@@@@@@.@@...................@.@@@.........................@.@@
@.................@@@@@@@@@@.....@@...........@@@@@@..@..........@@@........@@@@@
..........@.......@@@@@@@@@.................@..@@.@@@@@@........@@@@.......@@@@@@
.......@@@@...@@@@@@@@@@@@@@...........................@........@@@..@@....@@@@@@
.......@@@....@@@@@@@@@@@@@@@......@........@.............@.@@@@@@@........@@@@@@
.@..@.@.......@@@@@@@@@@@@@@@@@@.........@..@@@..@......@....@@@@@@.......@@@@@@@
...........@@@@@@@@@@@@@@@@@@@@@@.@......@@@@@@.........@@..@@@@@@@...........@@@
...@.......@@@@@@@@@@@@@@@@@@@@@@@@@.....@@@@@@.............@@@@@@@...........@@@
...........@@@@@@@@@@@@@@@@@@@@@@@@@....@@@@@@@......@.........@@...........@@@@@
...@.......@@@@@@@@@@@@@@@@@@@@@@@@@@@.@@@@@@@@................@@...@.@...@....@@
@...........@@@@@@@@@@@@@@@@@@@@@@@@@@@@@@@@@@@..........@.....................@@
@.@@...@....@@@@.@@@@@@@@@@@@@@@@@@@@@@@@@@@@@@.........@.......@@..@@@.........@
@.@@.....@.......@@@@@@@@@@@@@@@@@@@@@@@@..@@@@.....................@@@....@.....
@..@...............@..@@@@@@@@@@@@@@@@@@@@.@@@@.....................@@@@.........
@..@...............@....@@@@@@@@@@@@@@@@@..@@@@..............@..@...@@@@...@....@
@@@@.@@@..@@.......@.....@@@@@@@@@@@@@@@@....@@......@@@.....@..@...@@.@@@.......
@@@@@@@@..@@@...............@@@@@@@@@@@@.....@...@.........@.......@@...@@@...@.@
@@@@@@@@@@@@@.........@.....@@@@@@@@@@@............................@@...........@
@@@@@@@@@@@@@...............@@@@@@@@@@@..........@@............@..@@..@@@@......@
@@@@@@@@@@@@@...............@@@@@@@.......@............@@@@....@......@@@@.......
@@@@@@@@@@@@@..............@@@@@@@......................@@...........@@@@@@......
@@@@@@@@@@@@.....@@@....@@@@@@@@@@@.@.......................@@.......@@@@@@@.....
@@@@@@@@@@@@@@....@@..@.@@@@@@@@@@@@.....@@@.....@....@..@............@@@@@@.....
@@@@@@@@@@@@@@@@..@@..@....@@@@@@@@@..@..@@..............@............@@@@@......
@@@@@@@@@@@@@@@@.@@@@.@.....@@@@@@@@...@@@@.............@@.......................
@@@@@@@@@@@@@@@@.@@@@.......@@@@@@@....@@@@.@@........@@@@@@.....................
@@@@@@@@@@@@@@...@@........@@@@@@@@@@@@@@@@@@@@........@@@@@.....................
@@@@@@@@@@@@@@...@@......@@@@@@@@@@@@@@@@@@@@@@.......@@@@@.....................@
@@@@@@@@@@@@@@............@@@@@@@@@@@@@@@@@@@@@@@@...............@..@@..........@
@@@@@@@@@@@@@......@......@@@@@@@@@@@@@@@@@@@@@@@@@..@....................@@..@@@
@@@@@@@@@@@@@....@.@......@@@@@@@@@@@@@@@@@@@@@@@@...@....................@@..@@@
@@@@@@@@@@@@@@@............@@@@@@@@@@@@@@@@@@@@@@....@.@@@.............@@@@@@@@@@
@@@@@@@@@@@@@@.........@..@@@@@@@@@@@@@@@@@@@@@@@.@@@@@@@@@...........@@@@@@@@@@@
@@@@@@@@@@@@@@............@@@@@@@@@@@@@@@@@@@@@@@@@@@@@@@@...@........@.@@@@@@@@@
@@@@@@@@@@@@@@.........@..@@@@@@@@@@@@@@@@@@@@@@@@@@@@@@@..@............@@@@@@@@@
@@@@@@@@@@.@@@@.......@@@..@@@@@@@@@@@@@@@@@@@@@@@....@@@...............@@@@@@@@@
@@@.@@@@@...........@...@.@@@@@@@@@@@@@@@@@@@@@.........................@@@@@@@@@
@@@...@@@.................@@@@@@@@@@@@@@@@@@@@@.............@...........@@@@@@@@@
@@@..............@@.......@@@@@@@@@@@@@@@@@@@...........................@@@@@@@@@
@@@@........@@...@@.@...@@@.@@@@@@@@@@@@@@@@..........@........@..@@.@.@@@@@@@@@@
@@........@@@@....@@........@@@@@@@@@@@@@@@@.....@@......@.@..@@@...@@@@@@@@@@@@@
@@@.........................@@@@@@@@@@@@@@@@@@@............@@@@@@@@@@@@@@@@@@@@@@
@@@@@.............@........@@@@@@@@@@@@@@@@@@@@.............@@@@@@@@@@@@@@@@@@@@@
@@@@@......@@.............@@@@@@@@@@@@@@@@@@@@...@..........@@@@@@@@@@@@@@@@@@@@@
@@@@@..@@.@@@..@@@@........@@@@@@@@@@@@@@@@@@@............@@@.@@@@@@@@@@@@@@@@@@@
@@@@@@@@....@@@@@@@@.....@@@@@@@@@@@@@@@@@@@@@.................@@@@@@@@@@@@@@@@@@
@@@@@@@@.....@@@@@@@..@@@@@@@@@@@@@@@@@@@@@@@@@@@@@..............@@@@@@@@@@@@@@@@
@@@@@@@@....@@@@@@@@....@@@@@@@@@@@@@@@@@@@@@@@@@@@.....@.@...@..@@@@@@@@@@@@@@@@
@@@@@@@@@....@@@@@@@....@@@@@@@@@@@@@@@@@@@@@@@@@@@......@@.@@@@@@@@@@@@@@@@@@@@@
8
49 76 0
23 9 0
22 66 0
64 52 0
67 54 0
52 33 0
43 16 0
14 69 0

7 73 0
8 23 0
6 28 0
16 43 0
25 61 0
25 74 0
44 26 0
9 3 0
