width 81
height 81
@@@@@@@......@@@@@@@@@@@......@@........@@@............@@@@@@@@@@@@@@@@@@@@@@@@@@
@@@@@@.......@@...@@@@@.....@@...............@......@...@@@@@@@@@@@@@@@@@@@@@@@@@
@@@@@@..........@..@........@.......................@@...@@@@@@@@@@@@@@@@@@@@@@@@
@@@@@@@.............................@..@.....@@.............@@@@@@@@@@@@@@@@@@@@@
@@@@@@@..@........@.............@............@@.............@@@@@@@@@@@@@@@@@@@@@
@@@@@@@................@...............................@.....@@@@@@@@@@@@@@@@@@@@
@@@@@@..............@.................@@@...@@.........@....@@@@@@@@@@@@@@@@@@@@@
@@@@@@@@...@.@.........................@@@@.@..@.............@@@@@@@@@@@@@@@@@@@@
@@@@@@@@@.@@.........................@@@@@.............@......@@@@@@@@@@@@@@@@@@@
@@@@@@@@@@@@...........@......@.@.....@@@@...........@@...@...@@@@@@@@@@@@@@@@@@@
@@@@@@@@@@@@@@.........@.....@.....@@@@@@...@@....@.@.........@@@@@@@@@@@@@@@@@@@
@@@@@@@@@@@@@@....@@.......@@@......@@@@@@@.@@..............@@@@@@@@@@@@@@@@@@@@@
@@@@@@@@@@@@@@@@@@.@......@@@@..........@@@@....@...........@@@..@@@@@@@@@@@@@@@@
@@@@@@@@@@@@@@@@@@.........@@@@@.....@......................@@....@@@@@.@@@@@@@@@
@@@@@@@@@@@@@@@@@@........@@@@@@.....@.......@.@..........@.......@@@...@@@@@@@@@
@@@@@@@@@@@@@@@@@@......@@@@@@@@..........@..@@@....@@............@@@..@@@@@@@@..
@@@@@@@@@@@@@@@@@@.....@@@@@@@@@...@...@@.....@...@.@@@@.@@.......@@@....@@@@@@..
@@@@@@@@@@@@@@@@@@...@....@@@.@....@..........@@..@........@......@@.....@@@@@..@
@@@@@@@@@@@@@@@@@@........@.................@@@@.............@...........@@......
@@@@@@@@@@@@@@@@@@........@..............@...@@@.................................
@@@@@@@@@@@@@@@@@@.....................@.....@@@@..................@.............
@@@@@@@@@@@@@@@@@@@@@.@.......................@@@....@@................@.........
@@@@@@@@@@@@@@@@@@@@@@@......@....@..@.@......@@@@.@......@...@@@.........@.....@
@@@@@@@@@@@@@@@@@@@@@@@.....@....@@@@@@........@@@@@......@..@@@@................
@@@@@@@@@@@@@@@@@@@@@@...........@@@@@@..@......@.@@.....@@...@@.................
@@@@@@@@@@@@@@@@@@@@@@.......@.....@@@@@@@....................@@.........@....@..
@@@@@@@@@@@@@@@@@@@@@@.......@...@@@@@@@@@@@.@.........@@@........@@........@@@..
@@@@@@@@@@@@@@@@@@@@@..@........@@@@@@@@@@@@...@...@...@@@..................@@@..
@@@@@@@@@@@@@@@@@@@@..@...@@....@@@@@@@@@......@..........................@@@@@.@
@@@@@@@@@@@..@@@@@@.......@@....@@@@@@@@@.@@@@...............@........@@@@@@@@@@@
@@@@@@@@@@@....@@........@.....@@@@@@@@@@..@@@.@.............@@.......@@@@@@..@@@
@@@@@@@@@@@..............@@....@@@@@@@@@@.@@@@.....@..@.......@@......@@@@....@@@
@@@@@@@@@@@....................@@@@@@@@@@...@@@.@.............@@.@@@@..@........@
@@@@@@@@@@@@..................@@@@@@@@.@@....@@@@........@.....@@@...........@..@
@@@@@@@@@@.....@........@.@...@@@@@@..........@@@................................
@@@@@@@@@@@................@.@@@@@@@...@.................................@...@...
@@@@@@@@@@@@@............@@..@@@@@@@...@.................................@.......
@@@@@@@@@@@@@.......@.@@.@@...@@@@@@@.@@@............@....@......................
@@@@@@@@@@@@@.....@....@......@..@@@@@@@@...........@@..................@........
@@@@.@@@@@@@@@..............@....@@@@@@@@.........@@@@...........@.........@@....
@@@@.@@@.@@@@@..............@...@.....@@@@.@@.@.....@@@...................@@@....
@@.........@........................@@.....@@.............................@@@....
@..........@................................@@..@.........@......@@..............
@......@...@..@.@.@@..@@........@@@........@@@............@@.@@@@..@..........@..
...........@@@.........@....@..............@@.....@........@.@.....@...@...@..@@.
............@@..............@...@...........................@@.....@.@.....@..@@@
....@.@...@......@...........................@@@............@@.....@...@@.....@@@
.........................................@...@@@@...@..............@............@
@@@..@@@@...........@@.....@...........@.....@@@..................@@.............
....@@@@...................@..@......@.......@@@.@............@.........@@.......
.....@.............@.........@@..............@@.........@..@.@@@.........@@......
................@@@..........@@...........@.@@@@...@......................@.@...@
.............@@@@@@........@@@@.............@@@......................@@...@.....@
..............@@@...........@@.........@....@@@......................@@.....@..@@
..............@@@...........@@..............@@@@@...@...@..@....@....@......@@.@@
............@@@@@@..........@...............@@@@@...........................@...@
....@.....@..@@@@@@@@....................@...@@@@@@.............................@
.............@@@@@@@.......@............@@@..@@@@@@...@@@..............@.........
......@@.....@@@@@@@....................@@@@.@@@@@@@...@@..........@.............
@.....@@..........@@.........................@@@@@@@......@@...@...@............@
@@.....@@...@........@.....@.@...............@@@@@@@......@@.....@........@.....@
@@@....@@.....................@............@@@@@@@@@.............................
@@@.@..@@@@........@.......@..@....@....@..@@@@@@@@@.@...................@.....@.
@@.....@@@@.........@@..@..@.......@@@......@.........................@.@@@......
.......@@@@.@@..........@.......@@.@@@...@@@@@........@@@.@@@.@.........@@@@@....
@.....@@@@@@@@@.........@@.........@.....@@@@..@@.....@@@@@@@............@@@.....
@....@@@@@@@@@@....@@..@@..........@....@@@....@@......@@..............@.........
@@@..@@@@@@@@@@@............@..........@@@.@....@@.@@@.......@.....@.........@@..
@@@@@@@@@@@@@@..............@..............@@.....@@@@@.............@......@@@...
@@@@@@@@@@@@@@............@.@.......@@@...........@@@@@......@..................@
@@@@@@@@@@@@@@....................................@@@@..@@...@...@........@@@...@
@@@@@@@@@@@@@@.......................@.......@@@....@@@@@@...@.@@.........@.....@
..@@@@@@@@@@@@......@......................@.........@@@@@...............@......@
..@..@@@@@..@@...@@.@@@..............................@@@@.......................@
.....@@@@@......@@@..@@@..............@@@....@.....@@@@@@@@............@@@......@
.....@@@@........@@..@@@.....................@...@@@@@@@@@@@...........@@@......@
..........@......@@@@@@@.........................@@@@@@@@@@@.........@.@@@@@...@@
@@@....@@@@@@@@...@@@@@@....................@....@@@@@@@@@@@.........@@@@@@@..@@@
@.......@@@@@@....@@@@@@........................@@@@@@@@@@@@..@....@@@@@@@@@@@@@@
@......@@@@@@@@@..@@@@@@@.........@...........@@@@@@@@@@@@@@@.@.@@.@@@@@@@@@@@@@@
@......@@@@@@@@@@@@@@@@@...@@@...@@.@......@..@@@@@@@@@@@@@@@....@@@@@@@@@@@@@@@@
8
71 56 0
57 17 0
56 5 0
29 7 0
60 18 0
63 75 0
62 69 0
55 63 0

44 73 0
53 20 0
37 40 0
29 20 0
0 72 0
31 12 0
63 78 0
52 62 0
