width 81
height 81
@@@@@@@@@@@@@@@@@@@@@@@@@@@..........@@@.......@@@@@@@....@......@@@@@@@@@@@@@@@@
@@@@@@@@@@@@@@@@@@@@@@@@.@@@.........@@.........@@@.@@@......@...@@@@@@@@@@@@@@@@
@@@@@@@@@@@@@@@@@@@@@@@.......@......@@.........@@..........@@......@@@@@@@@@@@@@
@@@@@@@@@@@@@@@@@@@@@@@@.....@@.........@..@.@...............@.......@@@@@@@@@@@@
@@@@@@@@@@@@@@@@@@@@@@@@.@.........................@@..@@............@@@@@@@@@@@@
@@@@@@@@@@@@@@@@@@@@@@@@@@.......@...@.........................@@....@@@@@@@@@@@@
@@@@@@@@@@@@@@@@@@@@@@@@@@.....@.@@............................@@...@@@@@@@@@@@@@
@@@@@@@@@@@@@@@@@@@@@@@@@@...@@@........@..........@.......@..@@@@..@@@@@@@@@@@@@
@@@@@@@@@@@@@@@@@@@@@@@@@@.........................@@..........@@@@...@@@@@@@@@@@
@@@@@@@@@@@@@@@@@@@@@@@@@@..........................@........@..@@......@@@@@@@@@
@@@@@@@@@@@@@@@@@@@@@@@@................@@...@......@.......................@@@@@
@@@@@@@@@@@@@@@@@@@@@@.@@.@........@.........@............@.....@..........@@@@@@
@@@@@@@@@@@@@@@@@@@@@...@........@...................@.....................@@@@@@
@@@@@@@@@@@@@@@@@@@.......................................@.........@.....@@@@@@@
@@@@@@@@@@@@@@@@@@@.........................@@@..........@@...............@@@@@@@
@@@@@@@@@@@@@@@@@@.......@.@...@@..@................................@@.@..@@@@@@@
@@@@@@@@@@@@@@@@@@@...@@..@...............@.........@............@@@@@....@@@@@@@
@@@@@@@@@@@@@@@.....................@@@@.......................@@@@@@@@@..@@@@@@@
@@@@@@@@@@@@@@@.........@..........@@@@@@@.@.................@@@@@@@@@@@..@@@@@@@
@@@@@@@@@@@@@@@@@..@@@...............@@@@.....................@@@@@@@@@@@@@@@@@@@
@@@@@@@@@@@@@@@@...@@@................@@@......................@@@@@@@@@@@@@@@@@@
@@@@@@@@@@@@@@@@@....@..@@@@.........@@.@.....@@.........@.....@@@@@@@@@@@@@@@@@@
@@@@@@@@@@@@@@@@@@@......@..@........@@.....@.....@@@@.@.......@@@@@@@@@@@@@@@@@@
@@@@@@@@@@@@@@@@@@@@@@...............@@...........@@@@.......@.@@@@@@@@@@@@@@@@@@
@@@@@@@@@@@@@@@@@@@@@@.@.................@........@@@@.........@@@@@@@@@@@@@@@@@@
@@@@@@@@@@@@@@@@@@@@@@..........................@@@..@........@@@@@@@@@@@@@@@@@@@
@@@@@@@@@@@@@@@@@@@@@@@..........@..............@@@..........@@@@@@@@@@@@@@@@@@@@
@@@@@@@@@@@@@@@@@@@@@@@...@.....@@..........@....@@............@@@@@@@@@@@@@@@@@@
@@@@@@@@@@@@@@@@@@@@@@@....................@@..................@@@@@@@@@@@@@@@@@@
@@@@@@@@@@@@@@@@@@@@@@@@@......................................@@@@@@@@@@@@@@@@@@
@@@@@@@@@@@@@@@@@@@@@@@@@..@...@....@...........................@@@@@@@@@@@@@@@@@
@@@@@@@@@@@@@@@@@@@@@@@@@......@@@..........@.......@...@......@@@@@@@@@@@@@@@@@@
@@@@@@@@@@@@@@@@@@@@@@@@@.......@@..........@@@..............@.@@@@@@@@@@@@@@@@@@
@@@@@@@@@@@@@@@@@@@@@@@@@@@@@..@@@.........@@@@@@.....@@@...@....@@@@@@@@@@@@@@@@
@@@@@@@@@@@@@@@@@@@@@@@@@@.....@..@........@@@@@@.................@@@@@@@@@@@@@@@
@@@@@@@@@@@@@@@@@@@@@@@@@@..@@....@.@....@.@@@@@@........@.......@@@@@@@@@@@@@@@@
@@@@@@@@@@@@@@@@@@@@@@@@@@.@@@..@@@@@...@..@@@@@@@.@........@@@@..@@@@@@@@@@@@@@@
@@@@@@@@@@@@@@@@@@@@@@@@@@@@@@@@@@@.....@..@@@@@............@@@@@@@@@@@@@@@@@@@@@
@@@@@@@@@@@@@@@@@@@@@@@@@@@@@@@@........@..@.@@@............@@@@@@@@@@@@@@@@@@@@@
@@@@@@@@@@@@@@@@@@@@@@@@@@@@@@@@.@......@..@..............@@@@@@@@@@@@@@@@@@@@@@@
@@@@@@@@@@@@@@@@.....@@@@@@@@@.@......................@@@@@@@@@@@@@@@@@@@@@@@@@@@
@@@@@@@@@@@.........@@@@@@@@@@........................@@@@@@@@@@@@@@@@@@@@@@@@@@@
@@@@@@@@@@@..........@@@@@@@@..........@...............@@....@@@@@@@@@@@@@@@@@@@@
@@@@@@@@@............@@@@@@@....@@....@.........................@@@@@@@@@@@@@@@@@
@@@@@@@@@......@......@@@@@.....@@...................@...........@@@@@@@@@@@@@@@@
@@@@@@@@@@@...@@......@..............................@............@@@@@@@@@@@@@@@
@@@@@@@@@@@..@..................@@@...........................@...@@@@@@@@@@@@@@@
@@@@@@@..@@@@@..................@@@.........@....@@.............@..@@@@@@@@@@@@@@
@@@@@@@...@@@...........@.......@@@@@............@@................@@@@@@@@@@@@@@
@@@@@.....@@@@.....@............@.@@@....................@..........@@@.@...@@@@@
@@@@@@....@.@@.....@...............@@..........@...............@@...@@@...@..@@@@
@@@@@@@..........@....@.........@.......@........................@..@@@.....@@@@@
@@@@@@@@......@..@....@...........@....@@@.......................@..@.......@@@@@
@@@@@.........................@........@........@..............@.............@@@@
@@@@@.........................@.......@............@@@@........@@@.........@@@@@@
@......@............@@........@...................@.@@.........@.......@...@@@@@@
@.........@.......@@@@........@.......@....................................@@@@@@
@@.................@.....@....@......................................@.....@@@@@@
@..............@@........................@............@.@...@@...@@........@@@@@@
@..................@..........@...@.@.................@@@@.@.@............@@@@@@@
...................@..................@@@........@...@@@@@..........@.....@@@@@@@
.@..........@@@@...............................@@@.....@.@................@@@@@@@
...........@@.................@..@...@@........@@.............@.........@@@@@@@@@
.......................................@.@......@.......@..........@.....@@@@@@@@
......@...............@.@........@.......@......@.......................@@@@@@@@@
..@.............@...@.@@@..........@....................................@@@@@@@@@
@..@..........@@@...@@@@@@@@.......@.......@@...............@..........@@...@@@@@
@...@@........@@....@@@@@@@@...@................@@................@@........@.@@@
@@@...........@@@..@@@@..@@@@...................@.....@.......................@@@
@............@@@@@.@@@@...@................@......@.........@@@@@@..........@...@
....@.@......@@@@..@@@@...@.................@.....@.....@@@@@@@@@@....@@@..@@....
....@@@.....@@@@@....@@@..............@@.@..@...@.@@..@@@@@@@@@@.@....@@@.....@@@
......@..@..@@@.....@@@@.........@.......@...........@@@@@@@@@@@......@@@.....@@@
........@@..@@@.......@@.............@......@..@.....@@@@@@@@@@.......@@@....@@@@
@@....@@@@..@@@........@@...........................@@@@@@@@@@@@.......@...@..@@@
@@.@@@@@@@..@@@........@@.............@......@.....@@@@@@@@@@@@@...............@@
@@@@@@@@@@...@@...............@..@@@@.@............@@@@@@@@@@@@@.............@.@@
@@@@@@@@@@....@@@@@@.......@..@..@@@@@@...@.........@@@@@@@@@@@@@.......@@@@.@@@@
@@@@@@@@.......@@@@@@.@@...@@@@..@@@@@@@@@..........@@@@@@@@@@@@@....@@@@@@@@@@@@
@@@@@@@@........@@@@@@@@@@@@@@@@@@@@@@@@@@@@......@@@@@@@@@@@@@@@@@@@@@@@@@@@@@@@
@@@@@@@@@@@.....@@@@@@@@@@@@@@@@@@@@@@@@@@@......@@@@@@@@@@@@@@@@@@@@@@@@@@@@@@@@
8
16 20 0
6 61 0
36 69 0
57 24 0
47 29 0
35 62 0
55 36 0
9 56 0

76 76 0
5 62 0
48 66 0
37 76 0
10 76 0
47 12 0
25 19 0
2 57 0
