width 20
height 33
.............@@..@@@
.@.................@
.......@......@.....
...........@........
......@........@....
......@.......@.@...
........@..@........
.....@..............
...@................
....@...@....@.@...@
.......@...@......@@
...................@
.@....@....@.......@
...................@
....@...........@.@@
....................
..@......@......@...
....................
......@.............
...@......@......@..
..................@.
......@........@....
....@....@.@........
............@....@..
....@.........@.....
....................
................@...
......@..@..........
.@.@........@.......
....@....@....@.....
................@...
..........@.........
...............@....
6
7 26 0
8 26 0
9 14 0
0 23 1
0 2 1
18 13 1

9 3 0
8 27 0
5 31 0
18 8 1
5 2 1
17 7 1
