width 20
height 33
@@....@@...........@
@@....@@............
....................
...............@....
....@....@..@....@..
.@..................
......@.............
........@...@.@.@...
.....@..............
.@......@.@.@.@.....
....................
....................
..@..@.....@..@.....
.......@............
..@.................
......@....@....@...
@.@...........@.....
.@........@.........
.............@..@...
........@..........@
.......@.........@.@
...@...............@
....@.......@......@
.................@..
.......@..@....@....
..@................@
.........@.@..@.@..@
.@....@.@...........
...@................
....................
.@.........@...@.@..
@...............@...
@..........@........
6
10 31 0
11 20 0
13 27 0
17 11 1
1 31 1
5 25 1

10 32 0
1 3 0
3 19 0
17 11 1
12 0 1
12 2 1
