width 20
height 33
@@@@....@...........
..@@...........@....
....................
.@.....@............
..@.....@......@....
...@...@......@.....
..........@@........
...@...@..@.........
....@.........@.....
....................
........@......@...@
......@@@.@.@..@.@..
.....@@@@...........
...@@@..........@@..
.............@.@....
@........@....@.....
............@.......
......@..@.....@@...
...@................
............@.......
@..@................
..@.....@...........
......@........@....
............@.......
........@@..........
.....@..............
..@...........@.....
.............@.@....
....@..@............
..@...............@@
...@.....@.@..@....@
@...................
@...................
6
5 4 0
15 31 0
0 13 0
16 1 1
18 7 1
18 14 1

6 31 0
4 29 0
6 24 0
13 21 1
18 32 1
0 29 1
