width 20
height 33
....................
.....@..............
.......@.....@......
...@................
@...................
@....@.........@....
@........@...@....@.
.....@..@....@......
....@....@...@......
................@...
.........@.......@..
..@..........@.....@
..................@.
..............@.....
............@....@.@
...@.@..............
....@...@.@....@.@..
....................
....................
..@.................
...........@...@....
.......@.....@......
.....@..@.@.........
....................
..@.................
......@.............
...@.....@..........
..............@@...@
........@.@...@@....
.....@..............
.@............@....@
............@......@
....................
6
18 10 0
15 6 0
10 25 0
9 17 1
11 14 1
5 28 1

2 5 0
1 32 0
11 31 0
16 32 1
0 32 1
4 28 1
