width 14
height 14
@@@@@@@@......
@@@@@@@@..@...
@@@@@@@.......
@@@@@@@.......
@@@@@@@@......
@@@@@@@.......
@@@...........
@@@......@....
@........@@..@
..............
..............
..............
..............
.......@...@@@
8
5 7 0
13 0 0
13 3 0
13 5 0
11 11 0
13 4 0
10 5 0
12 2 0

6 7 0
2 8 0
11 2 0
9 4 0
9 12 0
13 4 0
4 10 0
1 9 0
