width 14
height 14
@@..@@........
@@............
@@............
@@............
..............
..............
..............
..............
..............
..............
@.............
...@..@@@@....
......@.@.....
@@......@@@...
8
3 4 0
6 2 0
9 3 0
11 2 0
1 11 0
8 3 0
2 9 0
4 8 0

0 11 0
13 13 0
1 5 0
0 12 0
5 4 0
4 10 0
5 9 0
2 5 0
