width 14
height 14
@@@@..@@@@@@@@
@@@@..@@@.@@@@
..........@@@@
..........@@@@
@........@@@@@
@........@@@@@
...........@@@
@......@...@@@
@...@......@@@
...@.......@@@
...........@@@
.@@.@..@.....@
....@..@@@....
@@...........@
8
12 13 0
2 2 0
2 3 0
4 1 0
11 11 0
3 13 0
8 11 0
12 11 0

1 10 0
1 9 0
10 10 0
5 0 0
1 5 0
4 1 0
7 10 0
9 9 0
