width 53
height 53
@@@@@@@@@@@@@@@@@@@@@@@@@@@@@@@@@@@@..........@@.@@@@
@@@@@@@@@@@@@@@@@@@@@@@@@@@@@@@@@@@...............@.@
@@@@@@@@@@@@@@@@@@@@@@@@@@@@@..@@@..........@@....@.@
@@@@@@@@@@@@@@@@@@@@@@@@@@@@@@...............@..@....
@@@@@@@@@@@@@@@@@@@@@@@@@.@@@@..................@@@@.
@@@@@@@@@@@@@@@@@@@@@@@@@.........@.............@@@@@
@@@@@@@@@@@@@@@@@@.@@@@@...@..........@........@@..@@
@@@@@@@@@@@@@@@@@..@@@@@..............@@........@..@@
@@@@@@@@@@@@@@@@@...@@@............................@@
@@@@@@@@@@@@@@@@...........@...................@....@
@@@@@@@@@@@@@@@@..................................@.@
@@@@@@@@@@@@@@@................@.................@@.@
@@@@@@@@@@@@@@@@.............................@...@@@@
@@@@@@@@@@@@..@@..............@..@...........@@..@@@@
@@@@@@@@@@@@...@.........@@.......@..@@..@....@@.@@@@
@@@@@@@@@@@..............@@@.....@@@@@@@@....@@@@@@@@
@@@@@@@@@@@.....@........@.......@@@@@@........@@@@@@
@@@@@@@@@.......@.....@..@.......@@@@@@.........@@@@@
@@@@@@@@@.............@...........@@@@@............@@
@@@@@@@@@...@.........@...........@@@@@@...........@@
@@@@@@@@@.@...@...................@@@@....@..@......@
@@@@@@@@@@@..........@............@@@@.............@@
@@@@@@@@@@@@@..@...@.....@........@@@@.....@.......@@
@@@@@@@@@@@@..................@.@..@@@...@@@.......@@
@@@@@@@@.@.........................@@@.@@@@@.......@@
@@@@@@@@...........................@@@@@@@@@.@@....@.
@@@@@..@......@......@@...@@.......@@@@@@@@..........
@@@@................@@@@@@@@......@@@@@@@@@@.....@@..
@.@.......@..........@@@@@@@.......@@@@@@@@@.........
@....................@@@@@@@.......@@@@@@@@@.........
.....................@@@@@@@.......@@@@@@@@@.........
....................@@@@@@@@@......@@@@@@@@..........
......@...........@@@@@@@.@@@@.....@@@@@@@@.@........
...@..@...@.......@@@@@......@.@...@@@@@@@..@...@....
...@.........@....@@@@@........@@@@@@@@@@..@@@..@....
.................@@@@..........@@@@@@@@@@..@@@@@@.@..
..@@@.......@....@@..........@@@@@@@@@@@@@@@@@@@@.@@.
@...........@...@@@..........@@@@@@@@@@@@@@@@@@@@@@@@
@...........@@..@............@@@@@@@@@@@@@@@@@@@@@@@@
@@.....@...............@@.....@@@@@@@@@@@@@@@@@@@@@@@
@@@....@@.......@.............@@@@@@@@@@@@@@@@@@@@@@@
@@@........@....@@.............@@@@@@@@@@@@@@@@@@@@@@
@@@@..............@...............@@@@@@@@@@@@@@@@@@@
@@@@.......@......................@@@@@@@@@@@@@@@@@@@
@@@.@.....@......@...............@@@@@@@@@@@@@@@@@@@@
@@@.@..................@.........@@@@@@@@@@@@@@@@@@@@
.@........@.......@....@.....@@@@@@@@@@@@@@@@@@@@@@@@
.......@.....@@......@@@@@.@@@@@@@@@@@@@@@@@@@@@@@@@@
.......@.......@@@...@@@@@@@@@@@@@@@@@@@@@@@@@@@@@@@@
....@@@@@@@.....@@...@@@@@@@@@@@@@@@@@@@@@@@@@@@@@@@@
.@@@@@@@@@@@..@@@@@.@@@@@@@@@@@@@@@@@@@@@@@@@@@@@@@@@
@@@@@@@@@@@@@@@@@@@@@@@@@@@@@@@@@@@@@@@@@@@@@@@@@@@@@
@@@@@@@@@@@@@@@@@@@@@@@@@@@@@@@@@@@@@@@@@@@@@@@@@@@@@
8
6 39 0
41 22 0
24 41 0
6 45 0
18 44 0
25 20 0
9 33 0
7 31 0

41 35 0
2 31 0
52 33 0
48 26 0
24 46 0
21 23 0
32 12 0
5 30 0
