width 53
height 53
@@@@@@@@@@@@@@@@@@@@@@@@@@.....@@@..........@@.....@@
@@@@@@@@@@@@........@@@@@@................@@.........
@..@@@@............@@@@@@@............@@........@...@
@......@@..........@@@@@@@@......@.....@@@....@.....@
............@......@....@@@.....................@@@@@
.......@.......@@......@@@@..@@..................@@@@
.........................@@..@@@@......@............@
@........@...............@@.....@....@..............@
@........@@@...@..........@..@.......................
@@@......@@..................@....@..@............@..
@@@....@@............................@...............
@@@....@@@..............@......@.....@....@@@.......@
@@@.......@.@@..........@.................@.@.......@
@@..........@@@@@........@...........................
@@@@@...................@@@......@@.................@
@@@@@....@..................@@.......@@..............
@@@@@....@@@.............@..@........@@..............
@@@@@@...@......@@@@.....@.......@..@@@@...........@@
@@@@...........@@................@@@@..........@@@.@@
@@........@@.....................@@......@.@.........
@@.......@@@@@...........................@........@..
@..........@....@.....@.......@.........@@........@@.
@..@......@@..@.@@@......@@@@@@.........@@.....@...@.
.....@.......@@.........@@@@@@@..@....@@@............
...@...@.....@......@..@@@@@@@@@@@...@@@@@@..........
...........................@@@@@@@@..@@.@@@..........
........@..................@@@@@@@@...............@@.
@@.@....@........@.....@@...@@@@@.................@@@
@@.............@.....@@@@..........@....@........@@@@
.@..@................@@@@.......@..@....@......@@@@@@
....@......@@.........@@.................@..@@@@@@@@@
.......@..@@@........@.@@..@@..............@@@@@@@@@@
.....@@.....@..........@@..@@@..........@..@@@@@@@@@@
@.....@.........@.......@..@@@@.......@....@@@@@@@@@@
@.....@....................@@@@@@@@.........@@@@@@@@@
@.........@............@...@@@@@@@@........@@@@@@@@@@
@@@..@..................@..@@@@@@@@.......@@@@@@@@@@@
@@.........@@@..@..........@@@@@@@......@@@@@@@@@@@@@
@@...@@..@@@@@@@@......@@....@@@@@.....@@@@@@@@@@@@@@
.........@@@@@@@@.@@@@@@@@@@.@@@@@......@@@@@@@@@@@@@
@.......@@@@@@@@@@@@@@@@@@@@@@@@@.......@@@@@@@@@@@@@
@@......@@@@@@@@@@@@@@@@@@@@@@@@@@@@@@@@@@@@@@@@@@@@@
@@@.....@@@@@@@@@@@@@@@@@@@@@@@@@@@@@@@@@@@@@@@@@@@@@
@........@@@@@@@@@@@@@@@@@@@@@@@@@@@@@@@@@@@@@@@@@@@@
...@@.@@@@@@@@@@@@@@@@@@@@@@@@@@@@@@@@@@@@@@@@@@@@@@@
.@..@@@@@@@@@@@@@@@@@@@@@@@@@@@@@@@@@@@@@@@@@@@@@@@@@
@@@@@@@@@@@@@@@@@@@@@@@@@@@@@@@@@@@@@@@@@@@@@@@@@@@@@
@@@@@@@@@@@@@@@@@@@@@@@@@@@@@@@@@@@@@@@@@@@@@@@@@@@@@
@@@@@@@@@@@@@@@@@@@@@@@@@@@@@@@@@@@@@@@@@@@@@@@@@@@@@
@@@@@@@@@@@@@@@@@@@@@@@@@@@@@@@@@@@@@@@@@@@@@@@@@@@@@
@@@@@@@@@@@@@@@@@@@@@@@@@@@@@@@@@@@@@@@@@@@@@@@@@@@@@
@@@@@@@@@@@@@@@@@@@@@@@@@@@@@@@@@@@@@@@@@@@@@@@@@@@@@
@@@@@@@@@@@@@@@@@@@@@@@@@@@@@@@@@@@@@@@@@@@@@@@@@@@@@
8
2 41 0
49 8 0
21 4 0
15 11 0
8 37 0
27 12 0
36 35 0
24 20 0

5 37 0
31 23 0
35 1 0
20 34 0
11 34 0
1 43 0
3 7 0
8 20 0
