width 53
height 53
......@.......@@@@@@@@@@@@@@@@@@@@@@@@@@@@@@@@@@@@@@@
..............@@@@@@.@@@@@@@@@@@@@@@@@@@@@@@@@@@@@@@@
@.@..@@........@@@....@@@@@@@@@@@@@@@@@@@@@@@@@@@@@@@
@.@..@........@@@@....@@@@@@@@@@@@@@@@@@@@@@@@@@@@@@@
@......................@@@@@@@@@@@@@@@@@@@@@@@@@@@@@@
@...@@...@@............@@@@@@@@@@@@@@@@@@@@@@@@@@@@@@
.........@@@@.@........@@@@@@@@@@@@@@@@@@@@@@@@@@@@@@
.........@@@@.............@@@...@@@@@@@@@@@@@@@@@@@@@
...@..@..@@@..............@...@@@@@@@@@@@@@@@@@@@@@@@
..........@@....@..@.........@@@@@@@@@@@@@@@@@@@@@@@@
.....@....@@@@@@.....@@......@@@@@@@@@@@@@@@@@@@@@@@@
...@.......@@@@@..@...@......@@@@@@@@@@@@@@@@@@@@@@@@
@@@@..@....@@@@@@@@@..........@@@@@@@@@@@@@@@@@@@@@@@
@@@........@@@.@@@@...........@@.@...@@@@@@@@@@@@@@@@
@@@.........@............@..@@@........@@@@@@@@@@@@@@
.......@@...@........@.....@@......@@..@.@@@@@@@@@@@@
......@@@@..@@............@@@............@@@@@@@@@@@@
@........@@@@@@...........@@@@...........@@@@@@@@@@@@
@@.......@@@@@....@....@@@..@@....@@@@@@@@@@@@@@@@@@@
..........@@@............@...@....@@..@@@@@@@@@@@@@@@
..........@............@...@...........@@@@@@@@@@@@@@
.......................................@@@@@@@@@@@@@@
.........@@...........................@@@@@@...@@@@@@
..@......@@@@@.......................@@@@@@.......@@@
........@@@@@...................@...@@@@@@@.......@@@
..@.....@@@@@@...........@...@..@@@..@@@..........@@@
..@@....@@@@@@...........@.....@@@.....@...@.....@@@@
..@.....@@@..........@..@@....@@@@....@..........@@@@
.........@@@.........@..@@@...@.@@................@@@
.........@@@....................@@.........@@......@.
......@.@@@@@@@@...........@@...@...@..@@@...........
....@.@...@@@@@........................@@@...........
.@........@@@@@@.....................@@..............
.........@@@@@@.......@.@............@@.@@...@@......
.........@@@@@..@@@@..@@@...........@.@.@....@.......
.........@@@@@@@@@@@@..@@........@..@.......@@.......
@........@@@@@@@@@@@@@@@@............................
@...@....@@@@@@@@@@@@@@@@...@......................@.
@@...........@@.@@@@@@@@@@@@@........................
@@@.............@@@@@@@@@@@@@.@......................
@@@@...@@.......@@@@@@@@@@.@@........@...............
@@@.....@......@@@@@@@@@@..@@........@@@............@
@@@.......@.@..@@@@@@@@@.............@@@@...@........
@..............@@@@@@@.@...........@@@@@@...@.....@@@
@@....@@@@.....@@@@@@@.............@@@@@@@..@......@@
@@......@@@..@@@.@@@@@@@.@........@@@@@@@@..........@
@@.@@..@@@@......@@@@@@@@@..........@@@@@@@.......@@@
@@@@@@.@@@@......@@@@@@@@@@@...@....@@@@@@@.......@@@
@@@@@@@@@@@......@@@@@@@@@@@.........@@@@@@.......@@@
@@@@@@@@@@@@@..@@@@@@@@@@@@@........@@@@@@@@@.....@@@
@@@@@@@@@@@@@..@@@@@@@@@@@@@.@........@@@@@.....@@@@@
@@@@@@@@@@@@...@@@@@@@@@@@@@@@........@@@@@....@@@@@@
@@@@@@@@@@@@....@@@@@@@@@@@@@@@@..@@@@@@@@@....@@@@@@
8
42 43 0
20 19 0
30 43 0
16 31 0
15 47 0
28 22 0
15 16 0
50 39 0

17 23 0
49 47 0
31 17 0
16 31 0
35 34 0
33 30 0
40 37 0
46 29 0
