width 53
height 53
@@@@@@@@@@@@..........@...@.....@..@@@@..........@@@@
@.@@@@@@@@@@......@................@@@@.....@.......@
@...@@.@@@@@.........................................
@..........................@.........................
....@@@............@.............@.............@.@...
.@.....................@@@...........@...@@@.........
.......................@@@@@.@@...........@@.@.......
.............@..........@@@..@@............@.........
.............@..........@@@.@@@......................
.....@@@.@...@...@......@@@.@@@......................
@@@....@@@@............@@@@.@@@.........@............
@@.....@@@@..........@..@@@.@@@@.....@........@@@....
@@.......@@..............@@@@@@@@@@@.....@@..@@@.....
.........@@..............@@@@.@@@@@..........@@......
.........@@.........@....@@@@..@@@.....@......@@@@@.@
.........@@....@@.........@@.....@...........@@@@@@..
............@.........@@@....................@@@@@...
@...........@@@..................@..@.......@@@@.....
@@..........@@@.......................@...@@@@@@...@.
@@........@@@@............@...........@........@...@.
@@...@....@@@@............@@@@@................@....@
@....@...@@@@@@@@...@......@@@@@...................@@
.........@@@@@@@@@..........@@@.....................@
...@@@@@@@@@.@@@@...@......@@@@....@@@..............@
@..@@@@@@@..................@......@...@@@......@..@@
@..@@@@@@@..........@..................@@@..........@
@...@@@@@@.............................@@@@.........@
....@@@@................@...........@..@@............
@....@....@........@................@................
..@......@@......................@...................
....@@@..@............@.......@.............@........
...@@@..........@.....@..............................
...@@@.........@@@..................................@
.....@...@......@@....@....@................@@......@
................@@@.............@@.@......@....@...@@
@...@..............@@................................
@.................@@@.@@...........@@.....@@@........
..........@.........@@@.....@@.....@......@@@@.......
...................@@@......@@@...@......@@@@@@....@@
....................@@..@..................@.......@@
.....@.....@...........@@...........@@..........@....
.........@@@...........@..........................@@@
..........@.......................................@@@
@.@.......@..@...@.....................@....@@....@@@
@.@.@.......@@...............@...............@@...@@@
@@.........@@........................@@....@@@@.@@@@@
@@@........@@...........@@............@.....@@@@@@@@@
@@@.....@@@.............@@............@@@@@@@@@@@@@@@
@@@.....@@@@.........@.@@@...@...@.@@@@@@@@@@@@@@@@@@
@@@@@...@@@@@.@........@@..........@@@@@@@@@@@@@@@@@@
@@@@...@@@@@@.........@@@..........@@@@@@@@@@@@@@@@@@
@@@@@.@@@@@@@@@@@@@@@@@@@@..........@@@@@@@@@@@@@@@@@
@@@@@@@@@@@@@@@@@@@@@@@@@..@@@@@@@.@@@@@@@@@@@@@@@@@@
8
2 5 0
40 18 0
10 30 0
23 9 0
8 21 0
15 6 0
39 7 0
16 48 0

2 5 0
41 18 0
23 15 0
21 5 0
48 44 0
46 2 0
0 33 0
20 6 0
