width 53
height 53
@..@@@@@@.@@@@@@@@@@..@@...@.............@@@@@@@@@@@@
@.....@.......@@@@@@.......@.............@@@@@@@@@@@@
.............@@@@....................@....@@@@@@@@@@@
..........@...@@@@..............@....@..@@@@@@@@@@@@@
@.........@@..............@.............@@@@@@@@@@@@@
..........@@...........................@@@@@@@@@@@@@@
......@..................................@@@@@@@@@@@@
@@....@.........@@......@.......@...........@.@@@@@@@
@@..............@@...@.............@..........@.@@@@@
@@@.............@@@...........@....@............@@@@@
@@@.@............@@@.@............@@...@.........@@@@
@@@........@.....@@@@@..........@.@....@..........@@@
@@@@@@..@..@.....@@@@@@@..@@@.@..@@@...@....@.....@@.
@@@@@@@....@....@@@@@@@@@@@@..@@.@@@.................
@@@@@@@@@@@@@@@@@@@@@@@@@@@@.@@@@@@@................@
@@@@@@@@@@@@@@@@@@@@@@@@@@@@@@@@@@@@@................
@@@@@@@@@@@@@@@@@@@@@@@@@@@@@@@@@@@@@...........@....
@@@@@@@@@@@@@@@@@@@@@@@@@@@@@@@@@@@@@.@@...........@@
@@@@@@@@@@@@@@@@@@@@@@@@@@@@@@@@@@@@@@@@@.........@@@
@@@@@@@@@@@@@@@@@@@@@@@@@@@@@@@@@@@@@@@@@@@@......@@@
@@@@@@@@@@@@@@@@@@@@@@@@@@@@@@@@@@@@@@@@@@@@...@@...@
@@@@@@@@@@@@@@@@@@@@@@@@@@@@@@@@@@@@@@@@@@@.........@
@@@@@@@@@@@@@@@@@@@@@@@@@@@@@@@@@@@@@@@@@@@.........@
@@@@@@@@@@@@@@@@@..@@@@@@@@@@@@@@@@@@@@@@@@......@@..
@@@@@@@@@@@@@......@@@@@@@@@@@@@@@@@@@@@@@@..@.......
@@@@@@@@@@@@@......@@@@@@@@@@@@@@@@@@@@@@@@..........
.@@@@@@@@@@@.......@@@@@@@@@@@@@@@@@@@@@@....@@.@@...
.@@@@@@@@@@.....@..@@@@@@@@@@@@@@@@@@@@.@....@@@.....
..@@@@@@@@@@@......@@@@@@@@@@@@@@@@@.@..@@@..@@@...@.
..@@@@@@@@@......@.@...@@@@...@@@@@.......@..........
..@..@@@@@@........@..........@@@.......@@@@.@.......
.....@...@@.@@@@...............@@@......@@@@......@@.
............@@@@.@.......@@.....@@@.....@@@@......@..
.............@@@...@...@...........@.@...@...........
.@.....@......@@...@....................@@..........@
...@@@@@@@@...@@........................@@...........
..@@@@@...@@.......@....................@............
@@@@@@@....@.........................................
@@@@@@@....@.................@@@@.......@@.....@.@...
@@@@@@@......................@@@.......@@@@@.@.......
@@@@@@@@@@.....@............@@@@....@@@@@.@@...@.....
@@@@@@@@.......@............@@@.......@.......@@....@
@@@@@@@@@@..........@....@....@@@.............@@@@@@@
@@@@@@@@@....@@@.........@.................@@.@@@@@@@
@@@@@@@@@.....@@....@.....................@...@@@@@@@
@@@@@@@@......@@@............@...@@.@..@.@@....@@@@@@
@@@@@@@@...@.................@@@@@.......@.....@@@@@@
@@@@@..@@@......@..............@@@.............@@@@@@
@@@@...@@.......@..............@@@...@............@@@
@@...@..........@...@@@.@..........@...........@@@@@@
@@..............@@@@@@@@@@@@...................@@@@@@
@..............@@@@@@@@@@@@@.........@@.....@@@@@@@@@
@........@@@@@@@@@@@@@@@@@@@........@@@.....@@@@@@@@@
8
41 8 0
18 43 0
17 25 0
3 34 0
42 33 0
8 9 0
21 32 0
45 14 0

28 49 0
19 9 0
37 43 0
17 41 0
20 0 0
31 7 0
26 5 0
23 30 0
