width 53
height 53
@@@@@@@@@@@@@@@@@@@@@@@@@@@@@@@@@@....@@@@@@@@@@@@@@@
@@@@@@@@@@@@@@@@@@@@@@@@@@@@@@@@@@.......@@@@@@@@@@@@
@@@@@@@@@@@@@@@@@@@@@@@@@@@@@@@@@@@.......@@@@@@@@@@@
@@@@@@@@@@@@@@@@@@@@@@@@@@@@@@@@@@@@......@@@@@@@...@
@@@@@@@@@@@@@@@@@@@@@@@..@@@@@@@@@@@..@@..@@@@@@@....
@@@@@@@@@@@@@@@@@@@......@@@@@@@@@@.......@@@@@@@....
@@@@@@@@@@@@@@@@@@@......@@@@@@@@@.......@@@@@@@@....
@@@@@@@@@@@@@@@@@@@......@@@@@@@@@.......@@..........
@@@@@@@@@@@@@@@@@@@......@@@@@.@........@@@.....@....
@@@@@@@@@@@@@@@@@@@.......@@@@...........@@.@...@@...
@@@@@@@@@@@@@@@@@@@.......@@@@..................@@@..
@@@@@@@@@@@@@@@@@@.....@...........@............@....
@@@@@@@@@@@@@@@@@@.....@@@.....@@@@@@...............@
@@@@@@@@@@@@@@@@@@......@.......@@@@@@..............@
@@@@@@@@@@@@@@@@@@@....@@.......@@@@@.............@..
..@@@@@@@@@@@@@@@......@@.......@@..........@...@....
..@@@@@@@@@@@@@@.........................@@....@@....
...@@.@@@@@@@@@................@.@......@@@.........@
......@@@@@@@@@...............@@@@......@........@.@@
@.....@..@@@@@@@...............@.....@..@......@.....
@.....@.......@@.@.@@......@......@...@..............
...........@...@...........@.........@@..............
.............@....@@@....@...........@@...........@@@
..................@@@@...............@.....@......@@@
..................@@................@@..........@@@@@
................@.@.................@@............@@@
..@@.......................@........@.........@@...@@
...@@@@............................@@.....@@@........
...@@@..............@@@@@................@@....@@....
.....@.....@@.......@@@@@......@..........@.....@....
.....................@@@@......@@@..............@....
................................@@.@..............@@.
....@@.......@...................@..........@........
....@......@@@@@.@..............................@...@
@...@....@.....@...@@..............@............@....
@.@@@@............@@@@......@.......@.@.....@...@....
@.@@@@............@@@.@@@..@@.........@@@............
@@@@@@@@....................@.........@............@@
@@@@@@@@.......@..........@........@............@@.@@
@@@@@@@@@@................@@........@......@@....@.@@
@@@@@@@@@@................@@@@@.....@@..@..@@.....@@@
@@@@@@@@@@@@..............@@@@@....@@...@@.@......@@@
@@@@@@@@@@@...............@.@@.....@@....@@@......@@@
@@@@@@@@@@@@...@@@..@.@..@@..............@@@@@@@...@@
@@@@@@@@@@@@...@@@.........................@@@@@....@
@@@@@@@@@@@@....@@@.........................@@@@....@
@@@@@@@@@@@@................@........@......@@@@@@@@@
@@@@@@@@@@@@..............@@........@@@@@@@.@@@@@@@@@
@@@@@@@@@@@@...@@........@@@@@@@@..@@..@@@@.@@@@@@@@@
@@@@@@@@@@@................@@@@..@..@..@@@@@@@@@@@@@@
@@@@@@@@@@@@.....@@.......@@@@..........@@@@@@@@@@@@@
@@@@@@@@@@@@....@@@.......@@@@.........@@@@@@@@@@@@@@
@@@@@@@@@@@@.....@@@.....@@@@@........@@@@@@@@@@@@@@@
8
21 46 0
10 40 0
14 43 0
1 23 0
42 10 0
40 11 0
16 46 0
9 30 0

35 44 0
37 18 0
13 37 0
2 21 0
22 32 0
22 47 0
48 7 0
34 9 0
