width 53
height 53
@@@@@@@@@@@....@@...@@@.......@@@@@@@@@......@@@@@@@@
@@@@@@@@@@@............@......@@@@@@@@@........@@@@@@
@@@@@@@@@@@...................@@@@@@@@@@.........@...
@@@@@@@.............@...........@@@@@@@@@@...........
@@@@@@@............@.....@......@@@@@@@@@@@....@.....
@@@@@@@..@...............@......@@@@@@@@@.....@......
@@@@@@@..@...............@....@@@@@@@@@@@...@......@.
@@@@@@@....@..@..........@....@@@@@@@@.@....@@@......
@@@@@@@.......@..........@......@@@@@................
..@@@@@.@.....@........@.@..........................@
.....................@.@@@...........@@.@.......@@..@
..................@@@@...@@@@@..@...................@
..........@.........@....@@@@@......................@
@.@.......@@...........@@@@@@@@............@@@.......
@@@...@@.@@@........@@@@@@@@@@@...........@@@@.......
@@@@@@..............@@@@@@@@@@@......................
@@@@@@........@......@@.@@@................@@........
@@@@@@..@.................................@@@........
@@@@....@@....@.......@.....................@@.......
@@@......@.........@..@..............................
..........................@......@.....@........@....
....@@@..@..............@@...........@@@@.......@....
......@......@....................@..@@@@.......@....
........................@@...........@@@...........@@
........................@@@@.........@@@...........@@
.................@...@..@@@......@@..@@@@@.@@@.....@@
........@........@@@....@........@@..@@@@@@@.....@@@@
............@@@....@....@..........@.@@@@@@@@..@@@@@@
...@.@@..............@..@.........@@.@@@@@@@@..@@@@@@
...@@.....@.................@@...@@@@@@@@@@@...@@@@@@
...@@......................@@@@@@@@@@@@@@@@@@@@@@@@@@
........................@.@@@@@@@@@@@@@@@@@@@@@@@@@@@
......................@@@.@@@@@@@@@@@@@@@@@@@@@@@@@@@
.@......................@@@@@@@@@@@@@@@@@@@@@@@@@@@@@
@@.........@............@@@@@@@@@@@@@@@@@@@@@@@@@@@@@
@@@...@....@@...........@@@@@@@@@@@@@@@@@@@@@@@@@@@@@
@@@@@.@@@@@@@............@@@@@@@@@@@@@@@@@@@@@@@@@@@@
@@@....@@@@@@.......@@@...@@@@@@@@@@@@@@@@@@@@@@@@@@@
@@@..@@@@@@@@@......@......@@@@@@@@@@@@@@@@@@@@@@@@@@
@@@@@@@@@@@@@@....@...@.@..@@@@@@@@@@@@@@@@@@@@@@@@@@
@@@@@@@@@@@@@.....@@......@@@@@@@@@@@@@@@@@@@@@@@@@@@
@@@@@@@@@@@@......@@.......@@@@@@@@@@@@@@@@@@@@@@@@@@
@@@@@@@@@@@@..@....@.......@@@@@@@@@@@@@@@@@@@@@@@@@@
@@@@@@@@@@@@.........@....@@@@@@@@@@@@@@@@@@@@@@@@@@@
@@@@@@@@@...................@@@@@@@@@@@@@@@@@@@@@@@@@
@@@@@@@@@@........@@@....@..@@@..@@@@@@@@@@@@@@@@@@@@
@@@@@@@@@.........@@@.......@@...@@@@@@@@@@@@@@@@@@@@
@@@@@@@@@........@@@............@@@@@@@@@@@@@@@@@@@@@
@@@@@@@@@@.....................@@@@@@@@@@@@@@@@@@@@@@
@@@@@@@@@...@................@.@@@@@@@@@@@@@@@@@@@@@@
@@@@@@@@@......@@@...........@@@@@@@@@@@@@@@@@@@@@@@@
@@@@@@@@@......@@@...........@@@@@@@@@@@@@@@@@@@@@@@@
@@@@@@@@@..@.@..@@........@@....@@@@@@@@@@@@@@@@@@@@@
8
50 2 0
8 31 0
15 31 0
23 20 0
7 29 0
23 29 0
11 20 0
16 1 0

11 51 0
45 5 0
48 2 0
24 11 0
50 19 0
27 5 0
38 18 0
22 24 0
