width 53
height 53
@@@@@@@@@@@@@@@@@@...@@@......@@@.......@@@@@@@@@@@@@
@@@@@@@@@@@@@@@@@@@..@..................@@@@@@@@@@@@@
...@@@@@@@@@@@@@@@@..@...................@@@@@@@@@@@@
....@@@@@@@@@@@@@@@@......@...............@@@@@@@@@@@
....@@@@@@@@@@@@@@@.......@...............@@@@@@@@@@@
..@.@@@@@@@@@@@@@@@.......@@......@@@...@@@@@@@@@@@@@
....@@@@@@@@@@@@@@@.@.....@...@...@.@@@@@@@@@@@@@@@@@
....@@..@@@@@@@@@@@.@.....@...........@@@@@@@@@@@@@@@
....@@..@@@@@@@@@@@.@......@@.......@.@@@@@@@@@@@@@@@
@...@........@@@@@@@@.....@...........@@@@@@@@@@@@@@@
@.............@@@@@..@.@@.@.........@@@@@@@@@@@@@@@@@
@@@.......@....@@@@.......@@........@@@@@@@@@@@@@@@@@
@@@.........@@@@@@@.@@.....@.......@@@@@@@@@@@@@@@@@@
@@@...........@..@................@@@@@@@@@@@@@@@@@@@
@@@@..............................@@@@@@@@@@@@@@@@@@@
@@@@.....................@....@.@.@@@@@@@@@@@@@@@@@@@
@@......................@@.@....@@@@@@@@@@@@@@@@@@@@@
@@...................@.....@...@@@@@@@@@@@@@@@@@@@@@@
@.............@......@.....@@...@@@@@@@@@@@@@@@@@@@@@
@@......@.....@.....@@@@@.......@@@@@@@@@@@@@@@@@@@@@
@............@.......@@@@.........@@@@@@@@@@@@@@@@@@@
.............@.......@@@..........@@@@@@@@@@@@@@@@@@@
@...........@@......@@@@@.....@....@@@@@@@@@@@@@@@@@@
.....................@@@@.........@@@@@@@@@@@@@@@@@@@
..........@@@........@............@@@@@@@@@@@@@@@@@@@
...@......@@.....@.@..@...@........@@..@@@@@@@@@@@@@@
................................@..@...@@@@@@@@.@@@@@
....@@..........................@@.@.@@@@@@@@...@@@@@
@@..@@@.....@....................@.......@.@....@@@@@
@@@..@@.......@............................@....@@@@@
.....@.......@@............@@...........@......@@@@@@
....@........@................@..@@@...@@...@....@@@.
........@....................@@...@@@........@...@...
.............@.......@.......@@...@@@........@.....@.
............................@......@@................
....@.......................@..@@............@.......
...@.....@...@.............................@...@...@@
@@@.......@@........................................@
@.........@..........................................
............................@........................
......@.......................@@@............@......@
@@@@@@@@....@@@@...@....@............................
@@@@@@@@@.@@@@@@.....................@..............@
@@@@@@@@@@@@@@@@@....@@@@............@.........@@....
@@@@@@@@@@@@@@@@@....@@@@.@.@@@@@....@..........@....
@@@@@@@@@@@@@@@@@@@..@@@.............................
@@@@@@@@@@@@@@@@@@@@@@@@@.......@.........@..........
@@@@@@@@@@@@@@@@@@@@@@@@........@....................
@@@@@@@@@@@@@@@@@@@@@@@....................@.......@@
@@@@@@@@@@@@@@@@@@@@@@@.....@.....@.......@..........
@@@@@@@@@@@@@@@@@@@@@@@...@@@....@@.....@............
@@@@@@@@@@@@@@@@@@@@@.....@@@...@@@@..@..........@@..
@@@@@@@@@@@@@@@@@@@@@@@@@@@@@@.@@@@@@.@@@............
8
32 34 0
5 36 0
35 45 0
26 20 0
5 24 0
24 31 0
38 32 0
20 35 0

8 21 0
20 2 0
30 27 0
45 42 0
37 51 0
0 4 0
36 31 0
18 35 0
