width 20
height 18
....................
...@..@.......@.....
................@...
.............@......
...@................
.....@.@............
................@...
..@.......@..@@.....
....@.@.@...........
............@.....@.
.@...@..@...........
....@@......@..@..@.
.....@..............
.@..................
.......@............
..@..@..............
.........@.......@@@
...................@
6
18 14 0
14 10 0
15 4 0
2 8 1
13 12 1
6 0 1

9 1 0
18 2 0
0 17 0
5 7 1
3 3 1
9 3 1
