width 20
height 18
...........@...@@...
....@...............
............@....@..
....................
....................
.........@.@........
.@....@.........@...
.@.@...........@...@
....@....@.......@..
......@....@........
.............@......
...@....@...........
.................@..
.........@.....@....
.....@..............
....................
.....@........@.....
.....@@............@
6
19 16 0
15 5 0
16 14 0
6 7 1
10 13 1
0 13 1

12 17 0
1 8 0
1 1 0
9 11 1
0 0 1
4 2 1
