width 20
height 18
..@.................
..@@........@.......
..........@..@.@.@..
.....@...@..........
.....@@......@.@....
...@..@....@........
....................
....................
.....@........@..@..
....................
......@........@....
...............@....
....@..........@....
............@.....@.
...@..@.............
..............@.....
............@.......
....................
6
16 13 0
16 6 0
18 9 0
4 7 1
18 16 1
4 0 1

15 5 0
2 6 0
0 17 0
19 16 1
13 9 1
0 11 1
