width 20
height 18
..................@@
....@...............
...@..............@.
.....@..@.@.@..@....
........@...........
.@..@...@...........
...@................
...........@.@...@..
....@..............@
..@..@.@............
..............@...@.
........@...........
......@......@......
.........@..........
....@..@............
....................
....................
.........@..........
6
1 7 0
2 13 0
1 15 0
5 16 1
3 5 1
12 12 1

8 17 0
17 0 0
8 8 0
8 10 1
4 9 1
12 12 1
