width 20
height 18
@..@@@@.............
....@@@.............
.........@..........
..............@.....
..@.......@.........
.....@.......@......
........@.......@...
..@..............@..
...............@....
.....@.@......@.....
.........@.......@..
.......@....@.......
....................
.....@.@.@...@......
....................
.......@............
............@......@
...@...............@
6
19 1 0
8 7 0
18 17 0
0 6 1
12 3 1
13 6 1

6 4 0
9 6 0
7 3 0
13 12 1
4 17 1
5 16 1
