width 20
height 18
@@.....@...........@
@@.......@.......@..
@@...@........@.....
@@.......@...@...@@.
@@........@....@.@..
@@...@.@....@.......
@@..................
..........@....@....
......@.............
.....@.@.......@....
.........@........@.
.@..@..@.....@......
................@...
...........@...@....
....@....@..........
@......@............
..............@..@..
...@................
6
12 0 0
19 7 0
8 5 0
2 15 1
2 5 1
8 3 1

3 15 0
1 10 0
9 5 0
18 1 1
14 17 1
18 17 1
