width 20
height 18
....................
......@.............
....................
...........@........
........@.@...@.....
..@.................
.@.....@@...........
.......@..@.@.......
@...@...........@...
....................
..........@.........
.....@....@.@.....@.
......@.@......@....
....................
...............@....
........@........@..
............@.......
@...................
6
14 3 0
1 9 0
3 0 0
11 8 1
14 6 1
17 3 1

16 6 0
1 8 0
10 12 0
8 16 1
1 2 1
6 14 1
