width 20
height 18
..@@@...@@..........
....................
............@.@.....
................@...
...@....@...........
...........@........
....................
......@.....@...@...
.....@.@............
........@...........
...........@.......@
...................@
...@......@.....@...
..................@.
..................@@
@......@..@.......@@
@@................@@
@@................@@
6
15 11 0
0 4 0
1 8 0
19 3 1
0 6 1
7 17 1

8 6 0
9 14 0
17 9 0
7 0 1
2 13 1
18 5 1
