width 20
height 22
....................
..........@.........
...@.............@..
...............@....
....@...@...........
......@...@....@....
................@...
.@........@.@.....@@
...........@..@.....
......@.............
...............@....
.......@.....@...@..
....................
..........@.....@...
@...........@.......
@...................
...@..@.............
....@...........@...
......@.@...........
.........@.@........
...............@....
..@.................
6
19 21 0
0 5 0
19 8 0
4 9 1
10 10 1
0 6 1

0 3 0
19 21 0
1 21 0
2 4 1
4 10 1
9 4 1
