width 72
height 72
@........@@@@@.....@@@@....@@@....@@@@@@..@@@@@@@@@@@@@@@@@@@@@@@@@@@@@@
@@........@@@@...........@..@@....@@@@@...@@@@@@@@@@@@@@@@@@@@@@@@@@@@@@
@@.@..@.................@@........@@.......@@@@@@@@@@@@@@@@@@@@@@@@@@@@@
@@....@@@@@@...........@@@...@.............@@@@@@@@@@@@@@@@@@@@@@@@@@@@@
@.....@@@@........@@@@@@@@.......@@.......@@@@@@@@@@@@@@@@@@@@@@@@@@@@@@
@.................@@@@@@@@................@@@@@@@@@@@@@@@@@@@@@@@@@@@@@@
@..............@@@@@@@@@@@.@..............@@@@@@@@@@@@@@@@@@@@@@@@@@@@@@
...............@@@...@@@@@@@..@.........@@@@@@@@@@@..@@@@@@@@@@@@@@@@@@@
...............@@.....@.@@@@............@@@@@@@@@.....@@@@@@@@@@@@@@@@@@
...............@@.......@@@.....@.......@..@@..@@...@@@@@@@@@@@@@@@@@@@@
@.@.....................@@@@..............@@........@@@@@@@.@@@@@@@@@@@@
@.....@.............@...@@@..@@@..........@@.....@..@@.......@@@@@@@@@@@
.........................@..@@@...@.......@@@@...............@@@@@.@@@@@
.@@@..............................@.@......@.......................@@@@@
@@.........@........@@@@..........@@@...@..........................@@.@@
.@...........@...@...@.@..........@@@@....@......................@....@@
.............@................@@@@@@@@...........................@@@@..@
...........@.......@...@@.....@@@@@@@@.............................@@...
..............................@@@@@@@@@@............@@@.......@...@@@@..
@.............................@@@@@@@@@@@@.........@@@@............@@...
....................@.........@@@@@@@@@@@@@@..........@............@@...
............@@..............@@@@@@@@@@@@@@@@@@.......@@.......@.......@.
...@.......@@@............@@@@@@@@@@@@@@@@@@@@....@@....................
....@@..@@@@@@...........@@@@@@@@@@@@@@@@@@@@@....@@@@..................
....@@...@.@@@..@@.......@@@@@@@@@@@@@@@@@@@@....@@@....................
.........@.@@...@@....@@..@@@@@@@@@@@@@@@@@@@@@@........................
............@@..@@....@@...@@@@@@..@.@@@@@@@@@@..@@..............@@..@..
............@@......@@@@.....@@@......@@@@@@@..........@.............@@@
@..........@@...@.........@..@@........@@@@@@.....@@..............@@@@@@
..........@@@..............@.@@........@@@@@.......@..............@@@@@@
@@........@@@..@.......................@@@@@@@@...................@@@@@@
@@...@@.......@@@......@...@...@......@@@@@....@.........@........@@@@@@
@@............@@@@.....@...@..........@@@@@....@@......@.@........@@@@@@
@@.....@...@..@@@@.....................@@@......@...........@@@..@@@@@@@
@@.............@@....................@@@........@...@.......@@...@@@@@@@
...@..@.........@@.....@.@@..........@@@.......@@.....@@@...@.......@@@@
@...@..@..@..........@.................@.....@.@@..@@...............@@@@
@@..@........................@............@.....@.......@@@.........@@@@
@@@@@@@.............@..............................@...@@@........@@@@@@
@@@@........@.....@.............@.............@@@..@....@@@........@@@@@
@@@@...................................................@@....@@@@..@@@@@
@@@@.............@@.........................@...........@....@@@@@@@@@@@
@@@..@@....@@............................@..................@@@@@@@@@@@@
@@@@@@...................................@@..@...............@@@@@@@@@@@
...@@@.......................@.......@...@@.@...@@......@@..@@@@@@@@@@@@
....@@..@@.......@.......@...........@............@.....@...@..@@@@@@@@@
...@@....@.................................@....................@@@@@@@@
................@@@@......@....@..........@@.@.........@....@..@@@@@@@@@
@@.........@..@@..@@@........@@@@....@....@@@@@........@@@..@.@@@@@@@@@@
@...@@..@@....@...@@..............@..@....@@@@@.............@@@@@@@@@@@@
....@@.@....@.....@@@...........@.........@@@@@@....@..@..@.@@@@@@@@@@@@
@@@@@@......@@....@@@@@............@@.....@@@@@@....@..........@@@@@@@@@
@@@@@@.....@@.@..@@@@@@......@.....@@.....@@@@@@@@.............@@@@@@@@@
@@@@.@@@....@....@@@@@....@....@....@@..@@@..@@@@@@...........@@@@@@@@@@
@@@@.........@...@@@@@.....@@..@@@......@@@....@@@@@.@@....@@@@@@@@@@@@@
@@@@@@@....................@@..@.................@@@@@@@...@@@@@@@@@@@@@
@@@@@@.@............@@@...@......@................@@@@@@..@@@@@@@@@@@@@@
.@@.@..@.............@@......@..@.................@........@@@@@@@@@@@@@
...................@@@.......@..............@..............@@@@@@@@@@@@@
.................@..@......@.@@.........@.@............@@..@@@@@@@@@@@@@
....@..................................................@@@@@@@@@@@@@@@@@
...@@.@.....@.......@@.........@...@@@.@..@.@.........@@@@@@@@@@@@@@@@@@
...@@........@@................@.....@................@@@@@@@@@@@@@@@@@@
...@@............@......@.............................@@@@@@@@@@@@@@@@@@
...@@@@@.......@..........@@@.@@......@.............@@@@@@@@@@@@@@@@@@@@
....@@@...........@.......@@@@@.......@.............@@@@@@@@@@@@@@@@@@@@
.....@.........@..........@@..............@.........@@@@@@@@@@@@@@@@@@@@
......@.....@@.@........@..@..@@..................@@@@@@@@@@@@@@@@@@@@@@
............@@@@@@.........@@@@@.................@@@@@@@@@@@@@@@@@@@@@@@
.....@....@.@@@@@@@.......@@@@@@@@@@@...........@@@@@@@@@@@@@@@@@@@@@@@@
@@..@@....@@@@@@@@@......@@@@@@@@@@@@...........@@@@@@@@@@@@@@@@@@@@@@@@
@@@@@@@...@@@@@@@@......@@@@@@@@@@@@@...........@@@@@@@@@@@@@@@@@@@@@@@@
8
31 38 0
29 39 0
60 19 0
12 48 0
54 29 0
36 31 0
25 68 0
2 69 0

5 1 0
29 34 0
35 40 0
71 19 0
59 20 0
46 31 0
48 10 0
64 29 0
