width 72
height 72
@@@@@@@@@@@@.@@@..@@@@@@@@@@@@@@@@@@@@@@@@@@@@@@@@@@@@@@@@@@@@@@@@@@@@@@
@@.@@@........@....@@@@@@@@@@@@@@@@@@@@@@@@@@@@@@@@@@@@@@@@@@@@@@@@@@@@@
@..@@@.............@@@@@@@@@@@@@@@@@@@@@@@@@@@@@@@@@@@@@@@@@@@@@@@@@@@@@
@....@@@............@@@@@@@@@@@@@@@@@@@@@@@@@@@@@@@@@@@@@@@@@@@@@@@@@@@@
@................@@@@@@@@@@@@@@@@@@@@@@@@@@@@@@@@@@@@@@@@@@@@@@@@@@@@@@@
.....@....@..@..@@@@@@@@@@@@@@@@@@@@@@@@@@@@@@@@@@@@@@...@@@@@@@@@@@@@@@
................@@@@@@@@@@@@@@@@@@@@@@@@@@@@@@@@@@@@@@...@@@@@@@@@@@@@@@
@............@..@@@@@@@@@@@@@@@@@@@@@@@@@@@@@@@@@@@@@....@.@@@@@@@@@@@@@
@.......@....@@@@@@@@@@@@@@@@@@@@@@@@@@@@@@@...@@@@........@@@@@@@@@@@@@
@.......@......@@@@@@@@@@@@@@@@@@@@@@@@@@@@@...@@@@........@@@@@@@@@@@@@
@.......@.....@@@@@@@@@@@@@@@@@@@@@@@@@@@@@@.....@@........@@@@@@@@@@@@@
..............@@@@@@@@@@@@@@@@@@@@@@@@@@@@@@@....@@@@..@@.....@@@@@@@@@@
..........@....@@@@@@@@@@@@@@@@@@@@@@@@@@@@@@...@@@@..........@@@@@@@@@@
@..@...@..@.@@@@@@@@@@@@@@@@@@@@@@@@@@@@@@@.....@@@@......@@@@@@@@@@@@@@
..........@@@@@@@@@@@@@@@@@@@@@@@@@@@@@@@@@@....@@@@......@@@@@@@@@@@@@@
...............@@@@@@@@@@@@@@@@@@@@@@@@@@@@.....@@@@@......@@@@@@@@@@.@@
@..................@@@@@@@@@@@@@@@@@@@@@@@@........@.....@@@@@...@......
@@...................@@@@@@@@@@@@@@@@@@@@@...............@@@@@@@.......@
@@..................@@@@@@@@@@@@@@@@@@@@@@...@.@.........@@@@@.@......@@
@@.................@@@@@@@@@@@@@@@@@@@@@@@@........@.....@@@..........@@
@@..........@.....@@@@@@@@@@@@@@@@@@@@@@@@........@@@..@..@@........@..@
@@@@@..........@..@@@@@@@..@@@@@@@@@@@@@@@......@.@.....................
@@@@@@.........@@@@@@@@@@..@@.@@@@@@@...@@..............................
@@@@@@@........@@@..@@@....@.......@@........................@@.........
@@@@@@@........@@...@@...........@@@.........................@@.........
@@@@@@@@.......@@..........................@@@.........................@
...@@@.........@..............@@@@.........@@...@...................@..@
.@.@@@...@......@@@.......@@@..@@..@...@....@..........................@
@..@@....@.................@@..@@..@....................................
@@...........@.............@@...............@......................@@...
@@@......@@....@@@........................................@..@@@.......@
@@@...@@@@..@@@@@@@@....@.......................................@......@
@@.........@@.@@@@@@@@@...............@....@@@@...............@@.......@
..........@@....@@@@@@@.......@.............@@@...@........@@@@@@..@..@@
.........@..................................@..............@@@@@@@@@@@@@
..............@@...............@...............@.........@@@@@@@@@@@@@@@
.....@@.......@...@............@.........................@@@@@@@@@@@@@@@
................@.@...................@@.....@...........@@@@@@@@@@@@@@@
........@.....@.@.........@...@.@@@......@@..@........@..@@@@@@@@@@@@@@@
.............@....@...........@@@@@...................@.....@@@@@@@@@@@@
......@...@............@.......@@@..@...........@@@.........@@@@@@@@@@@@
.@@...................@@@@@....@@@....@@.......@@@@...........@@@@..@@@@
...........@@.........@.@@@@....................@@@@@.........@@@@...@@@
@.......................@@@@@@@@@..@...............@@@....@...@.........
....@@.................@@@@@@@@@@..................@@.............@@....
.....@...@.............@@@@@@@@@@....@........@@@...@..@...@......@@...@
.........@.@........@..@@@@@@@@@...@@@..@.........@.@..@@.@@@.....@@....
....@................@@@@@@@@@@@...@@...@@@@........@......@@...........
....@......@......@...@@@@@@@@@........@@@@@@....@@@@...@...............
@................@@...@@@@@@.................@.@@@@@@@........@.........
....@@.....@.....@@@@@@@@@@@.................@.@@@@@@@..................
...@@@@..............@@@@@.@................@@@@@@@@@@.....@@@.......@..
...@@@...............@@@@@...........@......@@@@@@@@@@.....@@......@@@@@
...................@@@@@@@...@.@............@.@@@@@@@@@.............@@@@
...........@@@.....@@@@@@@..@@....@...........@.@@@@@@@@@.....@.....@@@@
.....................@@@...@@@..@@@@@.....@......@@@@@@@@@..........@@@@
.........................@@@@..@@@@@@@....@.......@@@@@@@....@.@@@@@@@@@
......@..................@@@@@@@@@@@@...@.......@.@@@@@@@@.......@@@@@@@
@@....@..........@.......@.@@@@.@@@@@@@.@@.......@@@@@@@@@@@@....@@@@@@.
@@@............@@@..@@.....@@@....@@@@@@@.....@@@@@@@@@@@@@@@.....@@@@..
...............@@@@.@@@..........@@@@........@@@@@@@@@@@@@@@@....@@@@@..
...............@@...@@@@..........@@..........@@@@@@@@@@@@@@............
@....................@.@...@......@..........@@@@@@@@@@@@@@@............
@.................................@..........@@@@@@@@@@@@@@@@..........@
@...@......@................@...........@....@@@@@@@@@@@@@@@@.@..@.....@
..@...................@..........@.........@@@@@@@@@@@@@@@@@@...........
@@@@..................................@....@@@@@@@@@@@@@@@@@@...........
@@@...........................@@@..........@@@@@@@@@@@@@@@@@@.....@.....
@@............@.................@........@@@@@@@@@@@@@@@@@@@@@..........
@@@......................@...@........@@@@@@@@@@@@@@@@@@@@@@@@@@.@@.....
@@@..@@@...........................@..@@@@@@@@@@@@@@@@@@@@@@@@@@@.....@@
@@@...@...@@......@@..@...........@@@@@@@@@@@@@@@@@@@@@@@@@@@@@@@.....@@
8
44 44 0
45 42 0
50 24 0
33 45 0
32 32 0
8 15 0
1 44 0
36 66 0

57 50 0
12 7 0
43 39 0
5 6 0
70 64 0
6 13 0
12 47 0
47 57 0
