width 72
height 72
@@@@@@@@@@@@@@@@@@.........@....@@@@@@..@@@@@@@@@....@...@@.@@..@@.@@@@.
@@@@@@@@@@@@@@@@@.................@.@....@@@@@@@@@@..@...........@...@@.
@@@@@@@@@@@@@@@@@....@.......@......@.....@@@@@@@@....@@................
@@@@@@@@@@@@@@@@@.........................@@@@@@@....@...@..............
@@@@@@@@@@@@@@........@.......@...........@@@@@@@......@................
@@@@@@@@@@@@@.....................@@......@@@.@........................@
@@@@@@@@@@@@.........@@@..@.@.........@...............................@@
@@@@@@@@@@@@.....@....@@@@@.@..............................@........@.@@
@@@@@@@@@@@@..........@@@@@................@........................@@@@
@@@@@@@@@@@@@@@@.....@@@@....@.....................................@@@@@
@@@@@@@@@@@@@@@@....................@.................@.............@@@@
@@@@@@@@@@@@@@@@@@.................@@..@.......@...........@@@......@@@@
@@@@@@@@@@@@@@@@@@............................@@@.......@..@@@.@........
@@@@@@@@@@@@@@@@...........@@........@........@@@.......@@@@@@@@........
@@@@@@@@@@@@@@@@.............@.......@........@@@@@....@@@.@@..@@.......
@@@@@@@@@@@@@@@@.............@@@@....@@......@@@@@@.@@@@@@.....@@.....@@
@@@@@@@@@@@@@@@@@@.......@@@@@@@@@@..........@@@@@...@@@@@......@...@@@.
@@@@@@@@@@@@@@@@@@@........@@@@@@@@.....@.....@@@@@..@...@..........@@@.
@@@@@@@@@@@@@@@@@@........@@@@@@@@@...........@@@@..@@..................
@@@@@@@@@@@@@@@@@.........@@@@@@@..........@@@@@@@.............@.......@
@@@@@@@@@@@@@@@@@....@....@@@@@@@..........@@@@@@@.@@....@@............@
@@@@@@@@@@@@@@@@@.........@@@@@@@......@.@..@@@@@@.@..................@@
@@@@@@@@@@@@@@@@@...........@@@@@......@....@....@@@@....@.........@@@@@
@@@@@@@@@@@@@@@.............@@@@@......@....@....@@@@@@...........@@@@@@
@@@@@@@@@@@@@@@......@.@@@@@@@@@@@.@............@@@@@@@@..........@@@@@@
@@@@@@@@@@@@@....@.....@@@@@@@@@@...............@.@@@.........@....@@@@@
@@@@@@@@@@@@@..........@.@................@...................@....@@@@@
@@@..@.@@@@@@.....................................@@@@...............@@@
@@@..@.....@@.....@..@@......@........@.......@.....@@...............@@@
@.................@................@@@@......@@.....@......@@@.......@@@
......................@............@@@..@.......@........@@@@@@@@....@@@
................@......@...........@....@................@@@@@.@@...@@@@
...........................@@@..............................@.......@@@@
................@@.....@...@@@.....................................@@@@@
@@..........@@@........@....@@..........................@@...@.....@@@@@
...@@.....@@@@@@......@@@...@@..............@..@...........@.......@@@@@
..........@.@@@...@@@@@@............@.....@....@@@.........@@.....@@@@@@
........@....@@........@..@...........@........@....@......@@.....@@@@@@
........@.....@...........@................................@.......@@@@@
@@@......@................@................................@.........@@@
@@@.................@...@@@..........@........@......................@@@
@@@...........................@..................@..............@...@@@@
@........@.....................................@.@@.............@@@.@@@@
.@.................@@@..................@@............@@.........@@@@@@@
.@.......@@........@@@@..@@@..........................@@.........@@@@@@@
.@.......@@...........@..@.................@..@@......@@@@@@.....@@@@@@@
......@@..@@@................@@......@........@@......@@@@@@.....@@@@@@@
.........@@@@@...............@@@@.............@@......@@@@@@@@..@@@@@@@@
@.....@....@@.........@@@.....@@@@....@@..............@@@@@@@@@@@@@@@@@@
....@@@....@@@................@@@@@..........@.......@@@@@@@@@@@@@@@@@@@
@@...@@....@.@..@@...@@.......@@@@.........@........@@@@@@@@@@@@@@@@@@@@
@@.........@....@@@@@@..@@.....@@...................@@@@@@@@@@@@@@@@@@@@
@@..............@@@@@@@@@@.....@@.@@.........@@.......@@@@@@@@@@@@@@@@@@
@@...@@...@....@@@@@@@@@@.....@@@@.....................@@@@@@@@@@@@@@@@@
.............@@@@@@@@@@@.....@@@@@...@@@.........@.....@@@@.@@@@@@@@@@@@
.............@@@@@@@@.......@@.@@@@.@@@@.@..............@...@@@@@@@@@@@@
..................@@@@............@@@@@@.@......@...........@@@@@@@@@@@@
............@.....@@@.....@......@@@@@@@@@.......@.......@@..@@@@@@@@@@@
..........@@@...@@@@@...........@@@@@@@@@.......@@@...........@@@@@@@@@@
...@@..@..@@@....@@@@@..........@@@@@@@@@.........@..........@@@@@@@@@@@
.........@@@@@.@@@@@@......@.....@@@@@@@@.........@.......@@.@@@@@@@@@@@
.....@...@@@@.......@......@.....@@@@...@@......@@@..............@@@@@@@
.........@@@@.......@............@@....@..........@@......@.......@@@@@@
@........@.........@@@@@@...@..@@@...............@@@..............@@@@@@
..@@...............@@@@@@@.....@@@@@@.....@@............@..........@@@@@
@@@@@......@.@.....@@@@@@@@....@@@@@@.@..@@@..............@.....@@@@@@@@
@@@@@..@@@@@......@@@@@@@@@...@@@@@@@.@@@@@@.@@@...............@@@@@@@@@
@@@@@@.@@@@@...@..@@@@@@@@@@@@@@@@@@@@@@@@@..@.....@.........@@@@@@@@@@@
@@@@@@@@@@@@...@@@@@@@@@@@@@@@@@@@@@@@@@@@@...@@............@@@@@@@@@@@@
@@@@@@@@@@@@@@@@@@@@@@@@@@@@@@@@@@@@@@@@@@@..@@@@............@@@@@@@@@@@
@@@@@@@@@@@@@@@@@@@@@@@@@@@@@@@@@@@@@@@@@@..@@@@@@@.@....@@@@@@@@@@@@@@@
@@@@@@@@@@@@@@@@@@@@@@@@@@@@@@@@@@@@@@@@@@..@@@@@@@@@..@@@@@@@@@@@@@@@@@
8
67 21 0
12 30 0
44 66 0
35 7 0
9 29 0
40 52 0
58 22 0
24 11 0

1 57 0
6 29 0
17 15 0
11 64 0
14 33 0
64 8 0
56 60 0
50 64 0
