width 72
height 72
@@@@@@@@@@@@@@@@@@@@@@@@@@@@@@@@@@@@@@@@@@@@.......@@@@@@@@@@@@@@@@@@@@@
@@@@@@@@@@@@@@@@@@@@@@@@@@@@@@@@@@@@@@@@@..@@.........@@@@@@@@@@@@@@@@@@
@@@@@@@@@@@@@@@@@@@@@@@@@@@@@@@@.@@@@@@@@@............@@@@@@@@@@@@@@@@@@
@@@@@@@@@@@@@@@@@@@@@@@@@@@@...@.@@@@@@@@@............@@@@@@@@@@@@@@@@@@
@@@@@@@@@@@@@@@@@@@@@@@@@@@@@.@......@@.............@.@@@@@@@@@@@@@@@@@@
@@@@@@@@@@@@@@@@@@@@@@@@@@@@@............................@@@@@@@@@@@@@@@
@@@@@@@@@@@@@@@@@@@@@@@@@@@@@............................@@@@@@@@@@@@@@@
@@@@@@@@@@@@@@@@@@@@@@@@@@@@@..........................@@@@@@@@@@@@@@@@@
@@@@@@@@@@@@@@@@@@@@@@@@@@@@@@...........@.............@@@@@@@@@@@@@@@@@
@@@@@@@@@@@@@@@@@@@@@@@@@@@@@@@............@@........@@@@@@@@@@@@@@@@@@@
@@@@@@@@@@@@@@@@@@@@@@@@@@@@@@@............@@@@@@...@@@@@@@@@@@@@@@@@@@@
@@@@@@@@@@@@@@@@@@@@@@@@@@@@@@@@@.........@@@@@@@...@@@@@@@@@@@@@@@@@@@@
@@@@@@@@@@@@@@@@@@@@@@@@@@@@@@@@@@.........@@@@@@...@@@@@@@@@@@@@@@@@@@@
@@@@@@@@@@@@@@@@@@@@@@@@@.@@@.@@...........@@@@@@.@@@@@@@@@@@@@@@@@@@@@@
@@@@@@@@@@@@@@@@@@@@@@@@@..................@@@@@@@@@@@@@@@@@@@@@@@@@@@@@
@@@@@@@@@@@@@@@@@@@@@@@@.@...................@@@@@@@@@@@@@@@@@@@@@@@@@@@
@@@@@@@@@@@@@@@@@@@@@@@@..................@...@@@@@@@@@@@@@@@@@@@@@@@@@@
@@@@@@@@@@@@@@@@@@@@@@@@.....@........@.......@@@@@@@@@@@@@@@@@@@@@@@@@@
@@@@@@@@@@@@@@@@@@@@@@@@@@....................@@@@@@@@@@@@@@@@@@@@@@@@@@
@@@@@@@@@@@@@@@@@@...@@@@@.....@............@.@@@@@@@@@@@@@@@@@@@@@@@@@@
@@@@@@@@@@@@@@@@@....@@@@@@....................@..@@@@@@@@@@@@@@@@@@@@@@
@@@@@@@@@@@@@@@@.....@@@@@...@.......@...............@@@@@@@@@@@@@@@@@@@
@@@@@@@@@@@@@@@@.......@@@@........................@@@@@@..@@@@@@@@@@@@@
@@@@@@@@@@@@@@@@.......@@@@...............@........@@@@@@@..@@@@@@@@@@@@
@@@@@@@@@@@@@@@@@.....@@@@@...@.............@.......@@@..@..@@@@@@@@@@@@
@@@@@@@@@@@@@@@@......@@@@@..............@.@@...........@@..@@@@@@@@@@@@
@@@@@@@.@..@@@........@@@@@.............@...........@@@.....@@@@@@@@@@@@
@@@@.........@......@.....@..@@......@@@.@................@@@@@@@@@..@@@
@@.............@@........@@..@@.......@@..................@@@@@@@@@..@..
@@@.@@@...................@..@@.......@@....@..@...@@...@..@@@@@@.......
@....................@...........@....@@@..........@@........@@@@.......
@...............@....@@...............@@@@.@.......@@........@@@.......@
@@@.................@..........@....@@@@@@@@@...............@@.....@@@..
...................@@...............@@@@@@@@@@....@.....................
...@......@@.......@@..@........@@...@@@@@@@@@..........................
.........@.........@@@@.@........@...@@@@@@@..@....@....................
...@................@@..........@...@@@@@@@..@@..@.@@@@@................
..........@.........@...............@@@@@@@..@@@...@@@@@......@@........
.........@@@.............@@@@@......@@@@@@@........@@@@.................
........@@..@....@.........@@@.......@@@@..........@@@@................@
.@@@@@@....................@@@@@@....@..@@...@....@@@@.............@@@@@
@@@@@@......................@..@..................@@@@..@.@..........@@@
@@@@........................@..@..................@@@@...............@.@
@.................@.......@........................@@@......@@.........@
@.................@..@............@....@........@......@@....@..........
@.................@........................@...........@@....@@@........
@......@.@........................@....@.....................@@........@
.............................................@..@@.....@@....@........@@
@....@..................@@....@............@........@@@@..@.....@......@
...........@.............@.......@@................@@@@@..@@@@@@@@..@@.@
....@@....@@.............@.....@.@@@..............@@@@@@@@@@@@@@@@@@@@@@
...........@..@......@.......@.....@@..@.@....@...@@@@@@@@@@@@@@@@@@@@@@
@................................@.....@@@@...@@@@@@@@@@@@@@@@@@@@@@@@@@
@@......@.........@...@@....@@@..........@....@@@@@@@@@@@@@@@@@@@@@@@@@@
@@.........@.................@@.@..............@@@@@@@@@@@@@@@@@@@@@@@@@
@@.......@...@@..............@@................@@@@@@@@@@@@@@@@@@@@@@@@@
@@@@...@.......................................@@@@@@@@@@@@@@@@@@@@@@@@@
@@@......................@@@........@............@@@@@@@@@@@@@@@@@@@.@..
@@@@@@...................@@@.@......................@@@@@@@@@@@@@....@..
@@@@@@.......@....@@.....@..........................@@@.@@@@...@@@@.....
@@@@@@@.....@@@..@@@.............@........@..........@.....@....@@@@....
@@@@@@@..@@@@@@@.@@@@....@.....@....@................@..........@@@@....
@@@@@@@@@@@@@@@@.@@@@..@....@@.@....@...................................
@@@@@@@@@@@@@@@@@@@@@.......@@.....@@...................@@..............
@@@@@@@@@@@@@@@@@@.@...@@@.................@..@....@....@@@@............
@@@@@@@@@@@@@@@@@...@.@@@@................................@@...........@
@@@@@@@@@@@@@@@@@................@@...................................@@
@@@@@@@@@@@@@@@@@..........@@...........@..........@................@@@@
@@@@@@@@@@@@@@@@...@@......@@...........@.........@@..@..@.@.......@@@@@
@@@@@@@@@@@@@@@@..@@@......@@@......@@@@@@@@.@....@@.....@........@@@@@@
@@@@@@@@@@@@@@@.............@@...@@@@@@@@@@@@.....@...............@@@@@@
@@@@@@@@@@@@@@@@............@@...@@@@@@@@@@@@..@@@@@.@@@..........@@@@@@
8
50 11 0
41 57 0
50 28 0
40 46 0
30 6 0
13 32 0
67 44 0
46 48 0

57 41 0
39 7 0
21 70 0
20 55 0
64 69 0
59 70 0
51 25 0
2 34 0
