width 72
height 72
@......@@.....@.......@@@@@@......@@.....@@....@@@@@@@@@@@@...@@@@@.....
@.......@..............@@@@@......@@...........@@@@@@@@@@@....@@@@@.....
.......@@..............@@@........@@..@@....@..@@@@@@......@..@@@@@.....
@.......@.............@@@@........@@.........@.@.@@@@.....@@..@@@@@@....
..........@..@......@.@@@@.....@.@@................@.....@@@..@@@.......
...............@@...@@@@@............@...................@@.............
............@...@...@@@.....@..........................@@@............@.
...@....@.........@@@@@..................@.............@@@....@@.@......
........@..@@@....@@@@@.........@........@@@................@.......@@@.
............@@...@@@@@....................@@............................
@.........@.@@...@@@@@...@..............@.@@.....@........@@....@.......
@@@@.........@@...@@@.........@...........@@.....@....@@...@..........@@
@@@@..............@@@.........@..@.@............@.....@@...........@@..@
@@@@...........@..@@@...@@....@.........................................
@@@@@@@........@.@.@...@.............@@........@........................
@@@@@@@........@...@..@.............@@@@@......@@@@@..............@.....
@@@@@@@........................@@@...@@........@@@@@.............@......
@@@@@@@@.........@.....@........@@...........@@@@@@@@...@............@@.
@@@@@@@..............@.@@..@..@@@............@@@@@........@.@@........@@
@@@@@@@.............@.........@@@.............@@@@..........@@......@@@@
@@@@@@@.@......................@..............@@@@.........@@......@@@@@
@@@@@@@.@......@...............@.@............@@@@....................@@
@@@@@@@.@......@...............@@@...........@@@@@@...@......@.@........
@@@@@@@@@@..................@..@@@@@..............@.............@.......
@@@@@@@@@@..................@.@@@.@@.............@......................
@@@@@@@@@@@...@...................@@.........@..@@...........@..........
@@@@.@@@@@@...@@@@@..............@..........@@.@@@......................
@@@.........@@@@@@..@@@@.........................@@...@................@
@@.......@@...@@@@@@@@@@@....................@.....................@@...
@@......@@@...@@@@@@@@@@@@....@......@.......@.........@....@......@@...
@@......@@@..@@@@@@@@...@....@@@@..........................@@.....@@@@@@
@.......@....@@@@@@@@.......@@@@@.@@........................@.@...@@@@@@
@@...@..@....@@@@@@@@@.......@..@......................@..@.@@@@@@@@@@@@
.@...........@@@@@@@@@...........................@@@@..@......@@@@@@@@@@
..........@..@@@@@@@...........@@.................@@@...........@@@@@@@@
............@@@@@@@@...........@@....@@@@@......................@@@@@@@@
.@........@@@@@@@@@@@.@.......@@@@@@@@@@@@@.........@@.......@@@@@@@@@@@
....@@@@.@@@@@@@@@@...@......@@@@@@@@@@@@@@....@....@@.......@@@@@@@@@@@
.........@@@@@@@@@@...........@@.@@@@@@@@..@@@@...@.@@..@..@@@@@@@@@@@@@
.....@......@@@@@@.........@.....@@@@@@.@..@@@......@@..@@@@@@@@@@@@@@@@
.@........................@@.....@@@@..............@@@.@@@@@@@@@@@@@@@@@
..........@...........@@@@@......@@@.............@.@@@@@@@@@@@@@@@@@@@@@
@@.................@@.@@@@@...@@.........@..........@@@@@@@@@@@@@@@@@@@@
@@.................@..@@@@@...@..@...........@......@@@@@@@@@@@@@@@@@@@@
@@...@@..@..............@@@...@@.....@....@...@@....@@@@@@@@@@@@@@@@@@@@
......@@@@.........@......@.@@@@@.............@@...@@@@@@@@@@@@@@@@@@@@@
......@@....................@@@@...............@@.....@@@@@@@@@@@@@@@@@@
...@@@@@@..@..................@@.........@......@@....@@@@@@@@@@@@@@@@@@
@@@@@.@@@@@@................@.....@.............@@...@@@@@@@@@@@@@@@@@@@
@........@@@@......@...........@@.@...........@@@@..@@@@@@@@@@@@@@@@@@@@
..........@@......................@...........@@@@@@@@@@@@@@@@@@@@@@@@@@
@...@.@@................................@.....@@@@@@@@@@@@@@@@@@@@@@@@@@
@.....@@...@.......................@..........@...@@@@@@@@@@@@@@@@@@@@@@
@.....@@@..@...@..@..@@@@......@...@@...@........@@@@@@@@@@@@@@@@@@@@@@@
.......@@........@@..@@@@@........@..........@@...@@@@@@@@@@@@@@@@@@@@@@
.......@@...@@...@@.............@@@..........@@...@@@@@@@@@@@@@@@@@@@@@@
.............@@............@..@@@@@.................@@@@@@@@@@@@@@@@@@@@
..............................@@@@................@..@...@@@@@@@@@@@@@@@
......@....@...................@@@@@.......@..@..........@@@@@@@@@@@@@@@
@@.......................@.....@@@@@.......@@@@.@...........@@@@@@@@@@@@
@@.............................@@@@..........@@.............@@@@@@@@@@@@
.....@....@@....@@.........@...@@@@@@........@@.............@@@@@@@@@@@@
................................@@@@.........................@@@@@@@@@@@
@@...........@@..........@@......@@@.........................@@@@@@@@@@@
@@@@@.......@@@....@@@...@@@..................................@@@@@@@@@@
@@@@@@..@@@@@@@@..@@...@@@@@@@@......@...@.@.....@............@@@@@@@@@@
@@@@@@@..@@@@@@.......@@@@@@@@@.....@@.....@.....................@@@@@@@
@@@@@@@@@@@@@@@.......@@@@@@@@@@....@@...........................@@@@@@@
@@@@@@@@@@@@@@@...@...@@@@@@@@@@@@.....@..........@.............@@@@@@@@
@@@@@@@@@@@@@@@.......@@@@@@@@..............................@...@@@@@@@@
@@@@@@@@@@@@@@@@....@@@@@@@@@@............@.........@@@@@...@@@@@@@@@@@@
@@@@@@@@@@@@@@@@@.@@@@@@@@@@@@@.....................@@@@@@...@@@@@@@@@@@
8
24 33 0
66 13 0
31 29 0
41 62 0
29 63 0
38 8 0
51 32 0
5 50 0

38 34 0
22 49 0
29 19 0
45 48 0
67 16 0
43 47 0
58 36 0
6 49 0
