width 72
height 72
@@@@@@@@@@@@@@@@@@@@@@@@@@@@@@@@@@@....@....@.@@@...@....@@@@@...@@@@@@@
@@@@@@@@@@@@@@@@@@@@@@@@@@@@@@@@@@@@..........@@@..........@@@..@@@@@@@@
@@@@@@@@@@@@@@@@@@@@@@@@@@@@@@@@@@@...........@@...........@@@...@@@@@@@
@@@@@@@@@@@@@@@@@@@@@@@@@@@@@@@@@@@@@@..............@@.............@@@@@
@@@@@@@@@@@@@@@@@@@@@@@@@@@@@@@@@@@@@@.@............@@...........@@@@@@@
@@@@@@@@@@@@@@@@@@@@@@@@@@@@@@@@@@@@@@@@.@@@..@@.....@.............@@@@@
@@@@@@@@@@@@@@@@@@@@@@@@@@@@@@@@@@@@@@@@@@@@@@@......@.............@@@@@
@@@@@@@@@@@@@@@@@@@@@@@@@@@@@@@@@@@@@@@@@@@@@@@.....@..............@@@@@
@@@@@@@@@@@@@@@@@@@@@@@@@@@@@@@@@@@@@@@@@@@@@@@.@.................@@@@@@
@@@@@@@@@@@@@@@@@@@@@@@@@@@@@@@@@@@@@@@@@@@@@@..........@..@.......@@@@@
@@@@@@@@@@@@@@@@@@@@@@@@@@@@@@@@@@@@@@@@@@@@.........@@............@@@@@
@@@@@@@@@@@@@@@@@@@@@@@@@@@@@@@@@@@@@...@@@@@@@......@........@.@@.@....
@@@@@@@@@@@@@@@@@@@@@@@@@@@@@@@@@@@@@..@@@@@@@@@..............@.@@..@...
@@@@@@@@@@@@@@@@@@@@@@@@@@@@@@@@@......@@@@@@@@@@.......................
@@@@@@@@@@@@@@@@@@@@@@@@@@@@@@@@@.....@@@@@@@@@@@@......@...............
@@@@@@@@@@@@@@@@@@@@@@@@@@@@@@@........@@@@@@@@@@@..@......@............
@@@@@@@@@@@@@@@@@@@@@@@@@@@@@@@@@.......@@@@@@@@@@..@.........@@...@....
@@@@@@@@@@@@@@@@@@@@@@@@@.@@@@@@.......@@@@@@@@@@@..@.........@.........
@@@@@@@@@@@@@@@@@@@@@@@@..@@@@@@.......@@@@@@@@@@@@................@@@@.
@@@@@@@@.....@@@@@@@@@@@.@@@@@@@@@@.....@@@@@@..@@@............@..@@@@@.
@@@@@@@@@...@@@@@@@@@@@@.@@@@@@@@@@.......@@@....................@@@@@@@
@@@@@@@.....@@@@@@@@@@@....@....@........@@@@............@@......@@@@@@@
@@@@@@@....@@@@.@@@@@@@..................@..............@@@......@@@@@@@
@@@@@@@@........@@@@@@@..........@......................@@.....@@@@@@@@@
@@@@@@@@..........@@@@@...@.............................@@.......@@@@@@@
@@@@@@@@..........@@@@@.....@@@...........@....................@@@@@@@@@
@@@@@@@............@@@.....@............@@..@...................@@@@@@@@
@@@@@@@@.....@.....@@......@...................@......@..........@@@@@@@
@@@@@@@@...........@@.@........@..................................@@@@@@
@@@@@@@@...........@@.............@....@@@@@............@@........@@@@@@
@@@@@@@@...............@..........@.....@@@@............@@........@@@@@@
@@@.@@@...@@...@@...........@@...........@@@.@@............@@.....@@@@@@
@@.......@@@.@@@....@....................@....@@.......@........@.@@@@@@
@@.......@@@..@@...@@@.@@.....@.........@@................@@.@@@@@@@@@@@
@@...@....@....@@@@..@@@@..........@........@...@.....@.......@@@@@@@@@@
@@...@@...@......@...@@@@@.......@................@@..........@@@@@@@@@@
@@........@@...........@@........................@@...........@@@@@@@@@@
@@.......@@@@.........................@......@....@....@.....@@@@@@@@@@@
@@........@@@............................@............@.....@@@@@@@@@@@@
...@......................@@......@......@..........@...@@@.@@@@@@@@@@@@
....@..@..........................@..............@......@.@@@@@@@@@@@@@@
.........@.@@....................@@.@.......................@@@@@@@@@@@@
...........@@@@@.........@..@@...@..@......@..@..............@@@@@@@@@@@
.........@@@@@@@@..........................@@@@...............@...@.@@@@
@............................@............@@@@@...@@........@.....@.@@@@
.....@@@@.......@@..........@@.........@@@@@@@@...@@..................@@
.....@@@.......@@@.........@@@..........@@@@@@@...@@.......@@.........@@
.....@@.....@@@@@@......................@@@@@@@.........@..@@.........@@
....@@.................................@@@@@@@@.....@......@@...........
.@..................................@.@@@@@@@@@@@..................@....
@@....@........@@...@@@.......@.....@@@@@@@@@@@.........................
......@.........@..@@................@@@@@@@@@@@@....@@..@...@....@@....
.....@@.........@@@..............@.@@@@@@@@@@@@@@.@...............@@@...
@@...@@..........@@@@@...........@@@@@@@@@@@@.........@.............@@..
@@...@.....@......@@@@...........@@@@@@@@@@@..................@@........
@@@..@..@.........@@@@...........@@@@@@@@@@@@.............@.............
@@@@....@........@@@@@@..........@@@@@@@@@@@........................@...
@@@.....@........@@@@@@@.......@.@...@@@@....................@..........
@@.........@......@@@@@@...................................@...@@.....@.
.@@.........@.........@@........@@.........@.@...@...@..................
...@..................@@@.....@..........@...............@......@...@...
....@@............................@..................@@@.........@@@@@..
.......@......@@..................@...........@@..@..@@@@@@.@.....@@@@@@
...@........@.@@.............@...@...........@@@@....@@@@@@@@@..@@@@@@@@
...........................@@.................@@@@@@@@@@@@@@@@@@@@@@@@@@
........@.....@..@....@@@.@@@...................@@@@@@@@@@@@@@@@@@@@@@@@
......@@@........@.....@@@@@@..............@@@..@@@@@@@@@@@@@@@@@@@@@@@@
.......@@...............@@@@@@..............@@@.@@@@@@@@@@@@@@@@@@@@@@@@
.....@@@...........@...@@@@@@............@@@@@@@@@@@@@@@@@@@@@@@@@@@@@@@
.@@@@@@.......@@@@.@...@@@@@@....@...@....@@@@@@@@@@@@@@@@@@@@@@@@@@@@@@
@@@@@@@.....@@@@@@@@@@.@@@@@@..@@@.........@@@@@@@@@@@@@@@@@@@@@@@@@@@@@
@@@@@@@@.....@@@@@@@@@@@@@@@@..@@@@....@@..@@@@@@@@@@@@@@@@@@@@@@@@@@@@@
8
39 30 0
22 48 0
70 59 0
2 41 0
42 2 0
26 41 0
54 40 0
43 57 0

5 40 0
46 9 0
63 53 0
37 45 0
15 61 0
50 9 0
71 17 0
14 23 0
