width 95
height 95
@@@@....@@@@@@@@@@@@@@@@@@@...@..........@@.@@@@@@@@@@....@@@@@@@@@@@@@@@@@@@@@@@@@@@@@@@@@@@@@
@@@......@@@@@@@@@@@@@@@@@@............@..@.@@@@@@@@......@@@@@@@@@@@@@@@@@@@@@@@@@@@@@@@@@@@@@
@@.......@@@@@@@@@@@@@@................@........@@@.......@@@@@@@@@@@@@@@@@@@@@@@@@@@@@@@@@@@@@
@@........@@@@@@@@@@@.................@@...................@@@@@@@@@@@@@@@@@@@@@@@@@@@@@@@@@@@@
@@.......@@@@@@@@@@@...........@....@@@@..........@@........@@@@@@@@@@@@@@@@@@@@@@@@@@@@@@@@@@@
........@@@@@@@@@@@@..................@...........@@@@......@@@@@@@@@@@@@@@@@@@@@@@@@@@@@@@@@@@
.......@@@@@@@@@@@@@.....................@.......@@@@@......@@@@@.@@@@@@@@@@@@@@@@@@@@@@@@@@@@@
.........@@..@@@@@@......................@@......@@@@.......@.....@@@@@@@@@@@@@@@@@@@@@@@@@@@@@
.............@@@......@@........@@@..............@@@@@@...........@@@@@@@@@@@@@@@@@@@.......@@@
.............@@@.....@@@@.........@.............@....................@@@@@@@@@@@@...........@@@
.....................@@@...@..@@..@...@@....@...........@.............@@@@@@@@@@@.........@@@@@
.....@..................@@@@..@@....@.@@@...@.@..@..................@@@@@@@@@@@@@........@@@@@@
....@@..@.......................@...........@...@@..................@@@@@@@@@@@@@........@@@@@@
....@@..@..........@...@........................@@...................@@@@@@@@@...........@@@@@@
....@@@..................@...................@@@@.......@......@....@@@@@@@@@@@..........@@@@@@
...@@@@..................@@......................@...@.@............@@@.@@@@@@@.........@@@@@@@
@@@@@@@@...........@@.........@..................@...@.@..................@@@...@............@@
@@@@@@@@@@@......@@@.......@...............@........@......................@@...............@@@
@@@@@@@@@@@@@....@@......................@@......@@.@.................@@@...@@..@...........@@@
@.@@@@@@@@@.@@...@@........................@@.................@@.......@........@...@.......@@@
@.@@@@@@@@@.......@@......................@@@........@.................@........@...........@..
...@@@@@@.........@@........@.....@............@.........................................@@....
@...@@@@@@........@.........@@@.@..........@@.....................@....@.................@@@@..
@...@@@@@@.....@......@@...@@@@......@.....@...........................@@...@.............@@@@@
@.@.@@@@@@@....@@......@...@@@@........@...........@..............@.........@.............@@@@@
@.@.@@@@@@@..........@@@@@.@@@@.......@@.........................@@@@@@......@....@@......@@@@@
.....@@@@@@...........@@@@..@@@@......@@.........@....@.........@@@@@@@@.....@...@@@.........@@
......@@@@...........@@@@...@@@@.................@.............@@@@@@@@@@@...@..@@@@.........@@
......@@........@..@..@@@...@@@@........@@..@...................@@@@@@..........@@@..........@@
.@@..................@@@@@@@@@@.........@@@@@...................@@@@@@.........@@@@..........@@
...@@@..........@@.....@@@@@..............@@...............@......@@............@.........@@@@@
...@@@.....@@...........@@@@.........@.....@.............@@@......@.......................@@@@@
..@@@@.....@..@@.@..@...........@..........@.....@........@@..@..............@............@@@@@
@...@@.............................@@...@......@..........@..............@................@@@@@
@.................@@@..............@@....@@@..@@.....@.@......@...........@........@@@....@@@@@
@...............@................@..@....@@@.@............................@..............@@@@@@
@@@@........@@...................@..@..@@@@@@@.....@@@..................................@@@@@@@
@@@@@........@.....................@@@@@@@@@@@.@.@@@@@....@@...........@@....@@.....@@@.@@@@@@@
@@@@@@...@........@@@..............@..@.@@@@@@@@@@@@@......@.......@..@@@@...@......@@@@@@@@@@@
.@@.@.............@@@....................@@@@@@@@@@@@......@.......@.....@............@@@@@@@@@
.............@@.@@@.......@..@..............@@@@@..@@..............@...@@@@....@...@....@@@@@@@
..............@..@@.......@...@.@...........@@@@@.............@.........@@@@..@..@....@.@@@@@@@
@...................@...@@...@@............@.@@@@.............@@..........@@@@@.......@@@@@@@@@
@.........@@@.@.....@@................@....@.................@............@@@@@@@......@@@@@@@@
@@@........@@@@@.@................@...@........@..........................@@@.@@@@@@....@@@@@@@
@@@@@......@@@@@@@@..................@@........................@@..............@......@@@@@@@@@
@@@@@@.....@@@@@@@@@@..............@@.....................@....@@....@@...@@..........@@@@@@@@@
@@@@@@..@..@@@@@@@@@@@.....@@@................................@@@..........@......@@@.@@@@@@@@@
@@@@@@.....@@@@@@@@@@@@..@@@@........@........@...............@@@............@....@@@@@@@@@@@@@
@@@@@@........@@@@@@@@@..@@@@@@@@..@.................@......@@@@@..........@@@@@..@@@@@@@@@@@@@
@@@@@@........@@@@@@@@...@@@@@@@@@.......@@@......@.........@@@@@...........@@@...@@@@@@@@@@@@@
@@@@@@........@@@@@@@@@...@@@@@@@.......@@@@@@@.............@@@...@.........@@@@@@@@@@@@@@@@@@@
@@@@@...........@@@@@@@@@.@@@@@@@..........@@.@............@@...............@@@@@@@@@@@@@@@@@@@
@@@@@@@.........@..@@@@@@.@@@@@@@...........@.@.............................@@@@@@@@@@@@@@@@@@@
@@@@@@@@.................@@@@@.@@...............@.............@..............@@@@@@@@@@@@@@@@@@
@@@@@@@@@......@@@.........@@@............@...........@.......................@@@@@@@@@@@@@@@@@
@@@@@@@@@@@....@@@........................@..........@@@...................@@@@@@@@@@@@@@@@@@@@
@@@@@@@@@@......@@@....................@..@...........@........@......@....@@@@@@@@@@@@@@@@@@@@
@@@@@@@@@@.@...@@@@.......................@.......@@@@@........@@@....@..@.@@@@@@@@@@@@@@@@@@@@
@@@@@@@@.......@@@@@@@@@....................................................@@@@@@@@@@@@@@@@@@@
@@@@@@@@.....@@@@@@@@@@.............................@@.......................@@@@@@@@@@@@@@@@@@
@@@@@@@@@@..@@@@@@@@@@@...................@@................@................@@@@@@@@@@@@@@@@@@
@@@@@@@@@@...@@@@@@@@@@.....@.........@@...............@@.............@@.....@@@@@@@@@@@@@@@@@@
@@@@@@@@@.....@@@@@@@@@.......@....@@@@...@.....................@.....@.......@@@@@@@@@@@@@@@@@
@@@@@@@@@@@@..@@@@@@@@@@@@@.....@@@@@@@.......................@@................@@@@@@@@@@@@@@@
@@@@@@@@@@@@.@@@@@@@@@@@@@@@@@@@@@@@@@@..................@............@.........@@@@@@@@@@@@@@@
@@@@@@@@@@@@@@@@@@@@@@@@@@@@@@@@@@@@@@@@..........@....@.@......................@@@@@@@@@@@@@@@
@@@@@@@@@@@@@@@@@@@@@@@@@@@@@@@@@@@@@@@@@@@....@............................@...@@@@@@@@@@@@@@@
@@@@@@@@@@@@@@@@@@@@@@@@@@@@@@@@@@@@@@@@@@@...@@.............@..............@@@@@@@@@@@@@@@@@@@
@@@@@@@@@@@@@@@@@@@@@@@@@@@@@@@@@@@@@@@@@@@....@@....@.@......................@@@@@@@@@@@@@@@@@
@@@@@@@@@@@@@@@@@@@@@@@@@@@@@@@@@@@@@@@@@@@...........@@.......................@@@@@@@@@@@@@@@@
@@@@@@@@@@@@@@@@@@@@@@@@@@@@@@@@@@@@@@@@@@@@..................@@.......@..........@@@@@@@@.@@@@
@@@@@@@@@@@@@@@@@@@@@@@@@@@@@@@@@@@@@@@@@@@@@@@@@.............@@......@@..........@..@@@@@...@@
@@@@@@@@@@@@@@@@@@@@@@@@@@@@@@@@@@@@@@@@@@@@@.@@@.............@.......@................@.....@@
@@@@@@@@@@@@@@@@@@@@@@@@@@@@@@@@@@@...@@@@@@@..........................................@..@..@@
@@@@@@@@@@@@@@@@@@@@@@@@@@@@@@@@@@....@@@@@@..............@........@................@......@.@@
@@@@@@@@@@@@@@@@@@@@@@@@@@@@@@@@@@......@@@...@@@........@............@.............@@.........
@@@@@@@@@@@@@@@@@@@@@@@@@@@@@@.@@............@@@@.......................@.............@@......@
@@@@@@@@@@@@@@@@@@@@@@@@@@@@@@..@..@...........@@....................@....@@..........@@......@
@@@@@@@@@@@@@@@@@@@@@@@@@@@@@@.............@....@..............@...@.......@....@@...@@@@.....@
@@@@@@@@@@@@@@@@@@@@@@@@@@@@@@@....@.....@................@@@....................@@@..@@@......
@@@@@@@@@@@@@@@@@@@@@@@@@@@@@..........@.............@.....@@..............@@....@.............
@@@@@@@@@@@@@@@@@@@@@@@@@@@@@...@................@@@@@.....@@@...............@@..............@@
@@@@@@@@@@@@@@@@@@@@@@@@@@@@@@@@@@@@@@@@@@@....@@@@@@@....@@@@.@@...........@.@.........@....@@
@@@@@@@@@@@@@@@@@@@@@@@@@@@@@@@@@@@@@@@@@@@@.....@@@@@..@...@@..@...@.........@.........@......
@@@@@@@@@@@@@@@@@@@@@@@@@@@@@@@@@@@@@@@@@@@@@@@..@@@@@@.@........@....................@@@.@@@@@
@@@@@@@@@@@@@@@@@@@@@@@@@@@@@@@@@@@@@@@@@@@@@@@..@@@@@@......@...@......@..............@@.@@@@@
@@@@@@@@@@@@@@@@@@@@@@@@@@@@@@@@@@@@@@@@@@@@.....@@.......@@@...@........@@.............@@@@@@@
@@@@@@@@@@@@@@@@@@@@@@@@@@@@@@@@@@@@@@@@@@@@....................@........@@....@@.@....@.@@@@@@
@@@@@@@@@@@@@@@@@@@@@@@@@@@@@@@@@@@@@@@@@@@@@@@...@.............@.....@@@@......@@@......@@@@@@
@@@@@@@@@@@@@@@@@@@@@@@@@@@@@@@@@@@@@@@@@@@@@@@........................@@@......@@.......@@@@@@
@@@@@@@@@@@@@@@@@@@@@@@@@@@@@@@@@@@@@@@@@@@@@@@.......@@.@.............@.@....@@@@@......@@@@@@
@@@@@@@@@@@@@@@@@@@@@@@@@@@@@@@@@@@@@@@@@@@@@@@@..............................@@@@@@@@@@@@@@@@@
@@@@@@@@@@@@@@@@@@@@@@@@@@@@@@@@@@@@@@@@@@@@@@@@............................@.@@@@@@@@@@@@@@@@@
@@@@@@@@@@@@@@@@@@@@@@@@@@@@@@@@@@@@@@@@@@@@@@...@@....@.........@......@@....@@@@@@@@@@@@@@@@@
8
78 23 0
29 81 0
71 15 0
78 89 0
49 58 0
21 4 0
27 57 0
86 26 0

46 71 0
40 41 0
39 19 0
10 11 0
27 2 0
52 19 0
50 52 0
31 31 0
