width 95
height 95
@@@@@@@@@@@@@@@@@@@@@@@@@@@@@@@@..@@@@.@@@@@.@@@@@@@@.........@@@@@@@.@@......@@@@.@@@@.......@
@@@@@@@@@@@@@@@@@@@@@@@@@@@@@@@...@@....@@@..@@@@@@...........@.@@@@@..@......@@@..@@@@@@@....@
@@@@@@@@@@@@@@@@@@@@@@@@@@@@@......@@.........@@@@@...........@.@@@@@..@...........@@.@@@......
@@@@@@@@@@@@@@@@@@@@@@@@@@@@@..............@.@@@@@@.....@@@.....@@@@@@............@@@...@@@....
@@@@@@@@@@@@@@@@@@@@@@@@@@@@@................@@@@@@@.....@@....@...@@.............@@@.......@..
@@@@@@@@@@@.@@@@@@@@@@@@@@@@@................@@@.@@@.....@@....@..................@@...........
@@@@@@@@@@@.@@@..@@@@@@@@@@@.....................@@@...........@..................@@@..........
@@@@@@@@@@...@...@@@@@@@@@@@@..........@.........@@@@@.....................@......@............
@@@@@@@@@@......@@@@@@@@@@@@@...@......@..@.@.....@@@@@.................................@....@@
@@@@@@@@@@.......@@@@@@@@@.....@@.........@.......@@@@@.............@@.....@...........@@..@@@@
@@@@@@@@@@.....@.....@@@@....@@@@.........@@......@@@@@@...................@....@@.....@...@.@@
@@@@@@@@@@@................@@@@@.........@@@@.....@@@@@@@.......@@........@@@..................
@@@@@@@@@@@..................@@@..................@@@@.@@......@@@........@...................@
@@@@@@@@@@@@@@.......@.................@...@......@@@...........@@@.......@...@@..............@
@@@@@@@@@@@@@.......@@.................................@@@..@...@@@...@.....@@@.........@@....@
@@@@@@@@@@@@........@.........@........................@@@@@@...@@@.......@@@@.........@@......
@@@@@@@@@@......................@..............@@.....@@@@@@....@@@.......@............@@......
@..@@.@@.....................@....@@@.....@@...@@...@@@@@@@@@@..@@......................@...@..
@..@@...........................@@@@@@........@@....@@@@@@@@@@..........................@......
................................@@@@@................@@@@@@@@.@@.........@@@...@..............@
.............@...................@@....................@@@............@..@@@@@....@............
........................@..................@@@@........@..@.....@@......@@@@@@@...@....@......@
.........@@.............@...@.............................@.....@...@@.@@@@@@@......@@@@......@
.....@......@.......@...@...@............@...@......@...........@........@@@@@@.....@@@@.@.@@@@
@..........@@........................@...@..................@...@@@.........@....@..@@.@.@@@@@@
@@@........@@.......@@.........@.......@@........................@@.........@............@.@@@@
@...........@......@@...@......@............@......@........@.....@@......@@@.@...@@.....@.@@@@
............@.........@.@....@....@@@.@.....................@.....@.......@@@@@@..@@.......@@@@
.@..........@.......................@@@@.@..........@@@@@.................@@@@@@..@@..@....@@@@
.@@.........@@@@@..................@@@@@@@..........@@@@@.................@@@@@@....@@@.......@
@@@.....@....@@@@..............@....@@.@@...........@@@@@@......@..........@@@@@....@@@@@.....@
@@@@@@........@@@@@@................@@................@@@..................@@@@@@...@@@@@@@@..@
@@@.@@@........@@@....@...................................................@@@@@@@....@.@@@@@@@@
@@..@.........@@@@......@@@@.@....@@..@..................................@@@@@@@..@....@@@@@@@@
@@.............@@@..@.@.@@@@@@...@@@.....................@.........@@...@@@@@@@@@......@@@@@@..
@@..............@........@@@@@..@@@......@@@.............@...@.....@@....@@@.@@............@@..
@@.......................@@@@@@@@@@......@@@...........@..............@..@@@......@@@......@@..
@...........@..........@@@@@@@@@@@......@@@@......@...@@@@@@.........................@..@@@@@..
@.....@................@@@@@@@@@@@......@@@@..........@@@@@@...@...............................
@@........@..............@@@@@@@@@.@.....@@@..........@@@@@@................................@..
@@......................@@@@@@@@@@@@@@.@@@@...........@@@@@@..................@................
@@@@............@.......@@@@@@@@@@@@@@@@@@@.........@@@@@@@@@@@...@@@@.......@.................
@@@@..................@@@@@@@@@@@@@@@@@@@@@@@@@@......@@@@@@@@@...@.@..........................
@@@..................@@@@@@@@@@@@@@@..@@@@@@@@@@@@@@..@@@@@@@@....@....@.......................
@@@@.@.@@@....@..........@@@@@@@@@@....@@@@@@.@@@.....@@@@@@@@@........@..@..@@................
@@@@@@@@@@...............@@@@@@@@@@.@..@@@@@..@@@...@....@@..@@...@......@.......@..@.........@
@@@@@@@@@@@..............@@@@@@@@@@@@..@@@@...............@.............@@@........@@....@@...@
@@@@@@@@@@...............@@@@@@@@@@@@@.@@@..................@...........@@@@........@..........
@@@@@@@@@@........@....@@@@@@@@@@@@@............@........@..@............@@@................@@@
@@@@@@@@@@@.......@.....@@....@@@@@......................................@@@.......@........@@@
@@@@@@@@@@@...................@@.........................................@@@...........@....@@@
@@@@@@@@@@@.............................@............@..@@....@@@...@@@.@@@@.....@..........@@@
@@@@@@@@@@@@@@@@..............@@.......................@@@@.........@@......................@@@
@@@@@@@@@@@@@@@@@@@@..@................@...............@@@..........@@@..@....@..............@@
@@@@@@@@@@@@@@@@@@@@@.@@...............@..........@....@@.....@......@@.@@..@..@@.............@
@@@@@@@@@@@@@@@@@@@@@.........@@@......................@@..@............@@..@.................@
@@@@@@@@@@@@@@@@@@@@@@.@@@..@@@@@..............................@@@.......@..@@.................
@@@@@@@@@@@@@@@@@@@@@@@@@@....@@@@@.......@...........@........@@@........@..@@......@@.....@@.
@@@@@@@@@@@@@@@@@@@@@@@@......@@@..................@@....@.....@@@@@........@@@.@@@@@@@.....@..
@@@@@@@@@@@@@@@@@@@@@@@@@.@.@..................@...@@@.........@@@@.........@@@@@@@@@@@.....@..
@@@@@@@@@@@@@@@@@@@@@@@@@@......@...@..............@............@@@@@...@@@@@@@@@@@@@..........
@@@@@@@@@@@@@@@@@@@@@@@@@@@@@@@@@@@@@@....@....@@@@@@.............@@@....@@@@@@@@@@@@.....@..@@
@@@@@@@@@@@@@@@@@@@@@@@@@@@@@@@@@@@@@@@@@@.....@@@@@@....@@.......@@@@...@@@@@@@@@@@@.......@@@
@@@@@@@@@@@@@@@@@@@@@@@@@@@@@@@@@@@@@@@@@@.....@@@@@@....@@.......@@@@@@@@@@@@@@@@.....@....@@@
@@@@@@@@@@@@@@@@@@@@@@@@@@@@@@@@@@@@@@@@@@......@@@@@....@@@.......@@@@@@@@@@@@@@......@..@.@@@
@@@@@@@@@@@@@@@@@@@@@@@@@@@@@@@@@@@@@@@@@.......@@@@@..@@@@@@.......@@@@@@@@@@@.............@@@
@@@@@@@@@@@@@@@@@@@@@@@@@@@@@@@@@@@@@@@@@.......@@@....@......@.....@..@@@@@@@@@.......@...@@@@
@@@@@@@@@@@@@@@@@@@@@@@@@@@@@@@@@@@@@@@@@@@@....@.......................@@@@@@@@...........@@@@
@@@@@@@@@@@@@@@@@@@@@@@@@@@@@@@@@@@@@@@@@@@@..............@@...@..........@@@@@@....@......@.@@
@@@@@@@@@@@@@@@@@@@@@@@@@@@@@@@@@@@@@@@@@@@@..............@@......@.......@@@@@@@@@.@@.........
@@@@@@@@@@@@@@@@@@@@@@@@@@@@@@@@@@@@@@@@@@@@..............@@@.............@@@@@@@@.............
@@@@@@@@@@@@@@@@@@@@@@@@@@@@@@@@@@@....@@@@@.......@@@....@@@....@...@...@@@@@@@@@@............
@@@@@@@@@@@@@@@@@@@@@@@@@@@@@@@@@@@@....@@@@.....@.........@.........@...@@@@@@@..@............
@@@@@@@@@@@@@@@@@@@@@@@@@@@@@@@@@@@@......@@..........@.....@..............@@@.........@.......
@@@@@@@@@@@@@@@@@@@@@@@@@@@@@@@@@@........@......@@@.@@...@...............@@@@.................
@@@@@@@@@@@@@@@@@@@@@@@@@@@@@@@..................@@@..@@@......@...........@@@@..............@.
@@@@@@@@@@@@@@@@@@@@@@@@@@@@@@.....................@@....@.....@@.@........@@@........@......@.
@@@@@@@@@@@@@@@@@@@@@@@@@@@@@@..........@.........@@@@@..@......@.........@@@@@@@..............
@@@@@@@@@@@@@@@@@@@@@@@@@@@@@.....@.@@@...@@@...................@....@..@.@@@@@@........@.....@
@@@@@@@@@@@@@@@@@@@@@@@@@@@@@.........@...@@@............................@@@@@@........@@......
@@@@@@@@@@@@@@@@@@@@@@@@@@@@@@..................@.........@...............@@@@@........@.......
@@@@@@@@@@@@@@@@@@@@@@@@@@@@...@@.......................@.@@@................@@...............@
@@@@@@@@@@@@@@@@@@@@@@@@@@@@...............@...........................@...@@@@...............@
@@@@@@@@@@@@@@@@@@@@@@@@@@@@....@......@@...................................@@@@.............@@
@@@@@@@@@@@@@@@@@@@@@@@@@@@@@..........@@...................@...............@@@@@@@....@@@@..@@
@@@@@@@@@@@@@@@@@@@@@@@@@@@@@..@.@@@....................@...@@..@.........@@@@@@@@@.....@@@..@@
@@@@@@@@@@@@@@@@@@@@@@@@@@@@@@@@@@....@@....@@@..@@@......................@@@@@@@@@@@@@@.....@@
@@@@@@@@@@@@@@@@@@@@@@@@@@@@@@@@@@@@...@...@@@@......................@@.@@@@@@@@@@@@@@@@@@...@@
@@@@@@@@@@@@@@@@@@@@@@@@@@@@@@@@@@@@........@@......................@@@...@@@@@@@@@@@@@@@@...@@
@@@@@@@@@@@@@@@@@@@@@@@@@@@@@@@@@@@@.........@......................@@@@@.@@@@@@@@@@@@@@@@@@@@@
@@@@@@@@@@@@@@@@@@@@@@@@@@@@@@@@@@@@...................@@.............@@@@@@@@@@@@@@@@@@@@@@@@@
@@@@@@@@@@@@@@@@@@@@@@@@@@@@@@@@@@@@...@..@.............@..............@@@@@@@@@@@@@@@@@@@@@@@@
@@@@@@@@@@@@@@@@@@@@@@@@@@@@@@@@@..@............................@@@.......@@@@@@@@@@@@@@@@@@@@@
@@@@@@@@@@@@@@@@@@@@@@@@@@@@@@@@................@...............@@@......@@.@@@@@@@@@@@@@@@@@@@
@@@@@@@@@@@@@@@@@@@@@@@@@@@@@@@@.....@@.....@@....@.......@.....@@@.@.......@@@@@@@@@@@@@@@@@@@
8
43 66 0
11 39 0
16 50 0
40 57 0
69 86 0
60 7 0
91 47 0
47 85 0

39 27 0
87 11 0
91 1 0
73 15 0
92 30 0
32 1 0
66 46 0
34 58 0
