width 95
height 95
@@@@@@@@@@@@@@@@@@@@@@@@@@@@@@@@@@@@@@@@@@@@@@@@@@@@@.@@......@@@@@@@@@@@@@@@@@@@@@@@@@@@@@@@@@
@@@@@@@@@@@@@@@@@@@@@@@@@@@@@@@@@@@@@@@@@@@@@@@@@@@@@.@@.......@@@@@@@@@@@@@@@@@@@@@@@@@@@@@@@@
@@@@@@..@@@@@@@@@@@@@@@@@@@@@@@@@@@@@@@@@@@@@@@@@@@.............@@@@@@@@@@@@@@@@@@@@@@@@@@@@@@@
@@@@@@..@@@@@@@@@@@@@@@@@@@@@@@@@@@@@@@@@@@@@@@@@@@.............@@@@@@@@@@@@@@@@@@@@@@@@@@@@@@@
@@@@@@..@@@@@.@@@@@@@@@@@@@@@@.@@@@@@@@@@@@@@@@@@@......@.......@@@@@@@@@@@@@@@@@@@@@@@@@@@@@@@
..@@@@..@@@@@..@@@@@@@@@@@@@@@.@@@@@@@@@@@@@@@@@@@@............@@@@@@@@@@@@@@@@@@@@@@@@@@@@@@@@
.........@@.@....@@@@@@@@@@@@.....@@@@@@@@@@@@@@@@@@...@.......@@@@@@@@@@@@@@@@@@@@@@@@@@@@@@@@
.........@......@.@@@@@@@@@@..@...@@@@@@@@@@@@@@@@@@@..@@.....@@@@@@@@@@@@@@@@@@@@@@@@@@@@@@@@@
...................@@@@.@............@@@@@@@@@@@@@@@@.........@@@@@@@@@@@@@@@@@@@@@@@@@@@@@@@@@
.....................@...............@@..@@@@@@@@@@@@....@.@@.@@@@@@@@@@@@@@@@@@@@@@@@@@@@@@@@@
......................................@...........@@@.....@@@@@@@@@@@@@@@@@@@@@@@@@@@@@@@@@@@@@
....@.........@.......................@............@@@..@@@@@@@@@@@@@@@@@@@@@@@@@@@@@@@@@@@@@@@
.@..@....@@...........@@..........@..@.......@......@@...@@@@@@@@@@@@@@@@@@@@@@@@@@@@@@@@@@@@@@
@@@.@@@@.@@.......................@@........@@...........@@@@@@@@@@@@@@@@@@@@@@@@@@@@@@@@@@@@@@
@@@@@....@...@...@................@@........@@...........@@@@@@@@@@@@@@@@@@@@@@@@@@@@@@@@@@@@@@
@@@@@....................@...@.@..............@.......@@.@@@@@@@@@@@@@@@@@@@@@@@@@@@@@@@@@@@@@@
@@@@@@........@.@@@@.........@@..............@@......@.@@@@@@@@@@@@@@@@@@@@@@@@@@@@@@@@@@@@@@@@
@@@@@@@@...........@........@@..........@...............@@@@@@@@@@@@@@@@@@@@@@@@@@@@@@@@@@@@@@@
.....@@..........@..........@.......@@.........@........@@@@@@...@@@@@@@@@@@@@@@@@@@@@@@@@@@@@@
..........................@@@.@......@...........@@..........@.....@@@@@@@@@@@@@@@@@@@@@@@@@@@@
........@@.@..........@....@@...............@............@.........@@@@..@@@@@@@@@@@@@@@@@@@@@@
.......@@@........@@@@@....@@.............................@...@.........@@@@@@@@...@@@@@@@@@@@@
.......@@@.........@@@@@@@.@..........@.@...............................@@@@@@@@.....@@@@@@@@@@
@........@........@@@@@@@@.............@........@................@......@@@@@@@@@...@@@@@@@@@@@
@@......@@......@..@@@@@@.....@@@@........@..........@.............@...@@@@@........@@@@.@@@@@@
@@...@@@@@..........@@@@...@.@@@@@........@..@............@........@.......................@@@@
......@.............@@@......@@@@@...........@.............................@@...@............@@
.....@.@............@@.......@@@@@@@.........@........................@@...@@@@@...@...........
.....................@@........@@@@@@................................@@.....@@@@...............
..................@.........@@@@@@@@@........@................@@.@............@@.@............@
.................@..............@@@@.......@....@...........@@@@@@@..@@.......@@.@............@
.............@.................@@.@..........................@@@@@@@@@..........@@............@
...@@........@........@..............@...............@......@@@@@@@@@...........@@@............
...@@....@@@@@@................@@....@......@@......@@......@@@@@@@@............@@@........@...
@@@@@....@@@@@@....@@.......................@@..............@....................@...@..@......
@@@@@@....@@@@@@@...........@...................@...........@........@..................@......
@@@@@@@@@@@@@@@@@.....@.....................................@..................................
@@@@@@@@@@@@@@@@@@.................@@.................@@@...........@@@........................
@@@@@@@@@@@@@@@@@.....@..@@.........@@........@.......@@@......@..@@....@..@@@@@...............
@@@@@@@@@@@@@@@@@@............................@..@@...@@@.........@@@........@@.........@@.....
@@@@@@@@@@@@@@@@@@@.@.............................@...@..........................@.........@@@@
@@@@@@@@@@@@@.@@....@@....@.....................@........@@@..................@@@@...@.@...@@@@
@@@@@@@@@@@@@..........@....@.....@.............@@......@@@@............................@@..@.@
@@@@@@@@@@@@@@......................@@@....@...@........@@@@..........@@@...@....@.........@..@
@@@@@@@@@@@@@@......@..@........@.@@@@@....@...@.@@@@.....@@@@........@@@......................
@@@@@@@@@@@@@@.@@...@..@...........@@@@...@@......@@.....@@.@.........@@@@@..@.................
@@@@@@@@@@@@@@......@..@@@.........@@@....@...........................@@@@@@.@.@...............
@@@@@@@@@@@@@@...............@...@@@@@@...@@................@................@@................
@@@@@@@@@@@@@@.........@........@@@@@@@....@...................@@....@.......@.....@...........
@@@@@@@@@@@@@@@@@@@............@@@@@@@@.@@......................@...@@.@..@........@...........
@@@@@@@@@@@@@@@@@@@...........@@@@@@@@@@@@@@.@@...........@.@......@@@@..@.........@@@....@..@@
@@@@@@@@@@@@@@@@@@@...@@@@@...@@@@@@@@@..@....@.........@........@@@@@@............@@.....@....
@@@@@@@@@@@@@@@@@@@@@.@@@.@....@@@@@@@...@@..@@.................@@@@@@@.@........@@@..@........
@@@@@@@@@@@@@@@@@@@@@@@@@.......@...@.......@@..................@@@@@@@........................
@@@@@@@@@@@.@@@@@@@@@@@@@......@@......@...........@@..............@@@@@@@.......@............@
@@@@@@......@@@@@@..@@@@@@@....@................@..@@..@............@@..@.......@@..........@..
@@@..@........@@.@.@...........@@.............@@@@.@....@...........@@..........@@......@@@@..@
@@@...........................................@@.....................@............@.....@@@@@.@
@.....@...............@@......................@@...........@...........................@@@@@@@@
......@.........@@@.@@@.......................@@......@.@@@............................@@@@@@@@
..@............@@@@@@@@@................@.....@@.....@@@@@@...@@..................@....@@@@@@@@
..@................@@@@@@.............................@@@@@..@@@..............@...@.....@@@@@@@
....................@@@..........@...@@.....@@...........@@..@........@......@@...@.....@@@@@@@
.....@@@..@.....@..............@.@...@@.....@@@.....@@...@............@......@@@@@@.....@@@@@@@
...@.................@@...@......@...............@@................@@......@@@@@@.@..@.@@@@@@@@
.................@...@@...@@.....@....@...@......@@.......................@@@........@.@@@@@@@@
......@..........@@..@@....@......@@...........@@@@@@.@.@@....@@..........@.@......@@@@@@@@@@@@
@@@@...@@.......@@@...............@............@@@@@@..................@@.........@@@@@@@@@@@@@
@@@@@@.........@@@@@..............@............@@@@@............@@@...@@@........@@@@@@@@@@@@@@
..@@@....@@@...@@@.............@..@...........@@@@@..............@@.@.@..........@@@@@@@@@@@@@@
..@@@@@..@@@@................@@...@............@@@.........@@@@..................@@@@@@@@@@@@@@
...@@@@..@......@................@@........................@@@@@..........@.....@@@@@@@@@@@@@@@
...@@@..........@...............................@......@....@.@...@.............@@@@@@@@@@@@@@@
...........@...................................@@......@........................@@@@@@@@@@@@@@@
..........................................@..@@@@@...@.@.......@@...@@...........@@@@@@@@@@@@@@
.....................................@.......@@@@..@@@.@@@.........@@..@.........@@@@@@@@@@@@@@
..............@.....@.......@.....@@.@.@....@@.@....@@..@@.........@.............@@@@@@@@@@@@@@
..............@@...................@........@@.....@..............................@@@@@@@@@@@@@
........@@....@@....@@........@.............@@@......@...........................@.@@@@@@@@@@@@
...@@............@@..@........@...........@@@@@@...................@@....@..........@@@@@@@@@@@
....@......@@........@.............@..@.@..@@@@@............@.......@@.......@.....@@@@@@@@@@@@
@@..@......@@........@...@.........@..@@....@@@@@@.........@@..@@..................@@@@@@@@@@@@
@@.@...............................@..@@....@@@.@@@@..........@@@.........@@...@@@.@@@@@@@@@@@@
@@@..@....@@@................@..@..@.............@@@...@@@................@@@@@@@@@@@@@@@@@@@@@
@@@.......@@@..@....@......@@@@..................@@...@@@@@@.@@@..........@@@@@@@@@@@@@@@@@@@@@
@@@..@....@@@..@............@@......@............@@..@@@@@...@@..@......@@@@@@@@@@@@@@@@@@@@@@@
@@@.......@....@.........@@@@@.@...@@..@.@......@@@@@@@@@@@@.@@@...@....@@@@@@@@@@@@@@@@@@@@@@@
.......@@@.....@@............@@@@@.......@......@@@@@@@@@@@@..@@...@@@.@@@@@@@@@@@@@@@@@@@@@@@@
..............................@@@@@.....@@@@.@@@@@@@@@@@@@@@.....@@@@@@@@@@@@@@@@@@@@@@@@@@@@@@
..................@@.........@@@@@@@....@@@@@@@@@@@@@@@@@@@@@@...@@@@@@@@@@@@@@@@@@@@@@@@@@@@@@
....@@............@@@@.....@.@@@@.......@@@@@@@@@@@@@@@@@@@@@....@@@@@@@@@@@@@@@@@@@@@@@@@@@@@@
.................@@@@@....@@@@@@@...@.@@@@@@@@@@@@@@@@@@@@........@@@@@@@@@@@@@@@@@@@@@@@@@@@@@
.................@@@@@...@@@@@@@@..@@@@@@@@@@@@@@@@@@@@@@@.@@@....@@@@@@@@@@@@@@@@@@@@@@@@@@@@@
@.......@@@......@@@@@...@@@@@@@@@@@@@@@@@@@@@@@@@@@@@@@@@@@@@.....@@@@@@@@@@@@@@@@@@@@@@@@@@@@
........@@@......@@@@@@..@@@@@@@@@@@@@@@@@@@@@@@@@@@@@@@@@@@@@...@@@@@@@@@@@@@@@@@@@@@@@@@@@@@@
8
85 62 0
37 53 0
19 71 0
36 30 0
18 33 0
37 11 0
21 19 0
3 7 0

81 65 0
54 79 0
26 20 0
72 70 0
37 70 0
20 9 0
73 53 0
58 85 0
