width 95
height 95
@@@@@....@@......@..@@@@@@@@@@@@@@@@@@@@@@@@@@@@@@@@@@@@@@@@@@@@@@@@@@@@@@@@@@@@@@@@@@@@@@@@@@@
@@@@....@@@..........@@@@@@@@@@@@@@@@@@@@@@@@@@@@@@@@@@@@@@@@@@@@@@@@@@@@@@@@@@@@@@@@@@@@@@@@@@
@@@@...............@.@@@@@@@@@@@@@@@@@@@@@@@@@@@@@@@@@@@@@@@@@@@@@@@@@@@@@@@@@@@@@@@@@@@@@@@@@@
@@@@.................@@@@@@@@@@@@@@@@@@@@@@@@@@@@@@@@@@@@@@@@@@@@@@@@@@@@@@@@@@@@@@@@@@@@@@@@@@
@@@...................@@@@@@@@@@@@@@@@@@@@@@@@@@@@@@@@@@@@@@@@@@@@@@@@@@@@@@@@@@@@@@@@@@@@@@@@@
@@@@..@@@.@.......@@@@@@@@@@@@@@@@@@@@@@@@@@@@@@@@@@@@@@@@@@@@@@@@@@@@@@@@@@@@@@@@@@@@@@@@@@@@@
@@@@.@@@@@@.......@@@.@@@@@@@@@@@@@@@@@@@@@@@@@@@@@@@@@@@@@@@@@@@@@@@@@@@@@@@@@@@@@@@@@@@@@@@@@
@@@@.@@@@@@.@..@..@...@@@@@@@@@@@@@@@@@@@@@@@@@@@@@@@@@@@@@@@@@@@@@@@@@@@@@@@@@@@@@@@@@@@@@@@@@
@@@@@@@@@@...............@@@@@@@@@@@@@@@@@@@@@@@@@@@@@@@@@@@@@@@@@@@@@@@@@@@@@@@@@@@@@@@@@@@@@@
@@@@@@@@@@...............@@@....@@@@.@@@@@@@@@@@@@@@@@@@@@@@@@@@@@@@@@@@@@@@@@@@@@@@@@@@@@@@@@@
@@@@@@@@@@......@@.......@@@.....@.@.@@@@@@.@@@@@...@.@@@@@@@@@@@@@@@@@@@@@@@@@@@@@@@@@@@@@@@@@
@@@@@@@@@@...............@@@............@@@............@@@@@@@@@@@@@@@@@@@@@@@@@@@@@@@@@@@@@@@@
@@@@@@@@@................@@@@............@@............@@@@@@@@@@@@@@@@@@@@@@@@@@@@@@@@@@@@@@@@
@@@@@@@@@@........................................@....@@@@@@@@@@@@@@@@@@@@@@@@@@@@@@@@@@@@@@@@
@@@@@@@@@@................@..........@.......@@........@@@@@@@@@@@@@.@@@@@@@@@@@@@@@@@@@@@@@@@@
@@@@@@@@.@@...@..............@@.........@...........@..@@@@@@@@.......@@.@@@@@@@@@@@@@@@@@@@@@@
@@@..@@@.............@@.@....@@@........................@@@@@@@........@.@@@@@@@@@@@@@@@@@@@@@@
@@@@..........@......@@@...@.@@@..........@..@............@@@@...@...@...@@@@@@@@@@@@@@@@@@@@@@
@@@................@@@@@@..@@@@@......@@..@...............@......@......@@@@@@@@@@@@@@@@@@@@@@@
@@@.....@...........@@@@@..@@@@@......@@@..........@......@...............@........@@@@@@@@@@@@
@@@..@@...@..@@.....@@@@@..@.@..........@.......@..@...........@...@................@@@@@@@@@@@
@@@..@@@.....@@.....@@@@@..@...................................@.....................@@@@@@@@@@
@@@@@@@@........@..@@@@@@@@@@...@@@.....................@.....@@@@...................@@@@@@@@@@
@@@@@@@@.@..........@@@@...........@...................@@@....@@@@@..................@@@@@@@@@@
@@@@@@@@..@@.@...@..@@@@@@@.............................@.........@........@@..@....@@@@@@@@@@@
@@@@@@@@..@@.@......@.@@@@@..@.......................@@..................@..........@@@@@@@@@@@
@@@@@@@...@@...@@@......@@@..............@..@@.......@@..@..........@...............@@@@@@@@@@@
@@.......@@@...@@@............@...@.........@@..@........@@.........@.....@........@@@@@@@@@@@@
@.............................@.............@.............@..........@.........@@@@@@@@@@@@@@@@
.........@.@@............@....@.............@@....@@......@.@...@@@..@@.....@@@@@@@@@@@@@@@@@@@
........@...@................@..............@@................@......@@@..@@@@@@@@@@@@@@@@@@@@@
@...........@@.......................................................@@@@@@@@@@@@@@@@@@@@@@@@@@
@............@...................................................@...@@@@@@@@@@@@@@@@@@@@@@@@@@
.....................@...........@@..............................@...@@@@@@@@@@@@@@@@@@@@@@@@@@
@......@.......................................@.............@...@@@@@@@@@@@@@@@@@@@@@@@@@@@@@@
.......@@...........@..................@.............@@...@..@....@@@@@@@@@@@@@@@@@@@@@@@@@@@@@
........@@..@..............@@@@@.....@@@@............@.@.....@...@@@.@@@@@@@@@@@@@@@@@@@@@@@@@@
......@@@.........@..@.........@......@@.......@@@.@..............@@.@@@@@@@@@@@@@@@@@@@@@@@@@@
@@....@@@........@@.....@..........@@.@@@@@....@@@.@............@.....@@@@@@@@@@@@@@@@@@@@@@@@@
@@.............@.@@@@........@......@...@.@..@@@@@@@@.................@@@@@@@@@@@@@@@@@@@@@@@@@
@...................@.....@@@.......@...@....@@@@@..................@@@@@@@@@@@@@@@@@@@@@@@@@@@
...........@...............@............@.....@@@................@@@@@@@@@@@@@@@@@@@@@@@@@@@@@@
......................@.@........@.....@.....@@@@.......@......@.@@@@@@@@@@@@@@@@@@@@@@@@@@@@@@
........@........@@@@@@@@@....@.@@...........@@.................@@@@@@@@@@@@@@@@@@@@@@@@@@@@@@@
@@@@.@@.@........@@@@@@@@@@........................@..@........@@@@@@@@@@@@@@@@@@@@@@@@@@@@@@@@
@@@@.@@.@@.......@@@@@@@@@........@.........................@@@@@@@@@@@@@@@@@@@@@@@@@@@@@@@@@@@
@@@......@.......@@@@@...@......@.....@....................@@@@@@@@@@@@@@@@@@@@@@@@@@@@@@@@@@@@
@@@................@@@..........@@@...@...@..................@@@@@@@@@@@@@@@@@@@@@@@@@@@@@@@@@@
@@@.........@...@@..............@@@...@..@@.......@............@@@@@@@@@@@@@@@@@@@@@@@@@@@@@@@@
@@@@......@@@@@@@.........@...@..@@.@.....@....................@@@@@@@@@@@@@@@@@@@@@@@@@@@@@@@@
@@@.......@@@@@@@@@..@....@@@.......@....@@@...@@..@...........@@@@@@@@@@@@@@@@@@@@@@@@@@@@@@@@
@@@.........@@@...@.......@@@..............@@.@@@@......@......@@@@@@@@@@@@@@@@@@@@@@@@@@@@@@@@
@....@.......@@...@..@....@@@.............@@@@@@@@@@...........@@@@@@@@@@@@@@@@@@@@@@@@@@@@@@@@
@....@............@.@@@..............@.@..@@@@@@@..@.@.........@@@@@@@@@@@@@@@@@@@@@@@@@@@@@@@@
......@.........@@@.@@@....................@@@@@@....@.........@@@@@@@@@@@@@@@@@@@@@@@@@@@@@@@@
....................@@.....................@@@@@.....@.....@....@@@@@@@@@@@@@@@@@@@@@@@@@@@@@@@
.........................@@...@@.@.........@@@.@...........@@@..@@@@@@.@@@@@@@@@@@@@@@@@@@@@@@@
@@........................@@@@@@......@....@@@..............@@..........@@@@@@@@@@@@@@@@@@@@@@@
@@............@....@...@.....@@@......@@....@@...............@@@......@..@..@@@@@@@@@@@@@@@@@@@
@.............@@...@....@....@...@.@..@@.....................@@.............@@@@@@@@@@@@@@@@@@@
@..............@@.@@@..............@..@....@.................@@.....@...@...@@@@@@@@@@@@@@@@@@@
..@......@.....@..@.....................................@..@..@.............@@@@@@@@@@@@@@@@@@@
........@@........@....@..............@..@..............@..@................@@@@@@@@@@@@@@@@@@@
.@.......@........@......@....@.......@@..@............@@...................@@@@@@@@@@@@@@@@@@@
.........................@....@@.................@.....@@@@.@..@.........@....@@@@@@@@@@@@@@@@@
............@............@.....@....@@...................@@@@.@...............@@@@@@@@@@@@@@@@@
......@..................@@....@..@......@..@.....@@@....@@....................@@@@@@@@@@@@@@@@
......@.....@............@@@@@@@.@...@....@@@......@@.........@............@..@@@@@@@@@@@@@@@@@
..............@..@@.@...@@@@@@@@@@@@@@....@@@@@..@@@@.@............@@.......@@@.@@@@@@@@@@@@@@@
.......@@@.@..@.......@.@@@@@@@@@@@@@@@@@..@@@@@@@@@.............@@@............@@@@@@@@@@@@@@@
.......@@@..........@@@.@@@@@@@@@@@@@@@....@@@@@@@@@.......@@@...@@@@...........@@@@@@@@@@@@@@@
.......@@@@....@....@@@@@@@@@@@@@@@@@@@.....@@@@@@@@.......@@....@..@@...@.....@@@@@@@@@@@@@@@@
........@@........@.@@@@@@@@@@@@@@@@@@@@@@@@@@@@@@@@...@.........@...........@@@@@@@@@@@@@@@@@@
........@@.......@@.@@@...@@@@@@@@@@@@@@@@@@@@@@@@@@...@...@@@...............@@@@@@@@@@@@@@@@@@
.........................@@@@@@@@@@@@@@@@@@@@@@@@@@@@..@...................@@@@@@@@@@@@@@@@@@@@
...@..@.............@.....@@@@@@@@@@@@@@@@@@@@@@@@@@@...@..................@.@@@@@@@@@@@@@@@@@@
.@@@...@...@........@..@@@@@@@@@@@@@@@@@@@@@@@@..@@@@.......@......................@@@@@@@@@@@@
.@@....@............@..@@@@@@@@@@@@@@@@@@@@@@.....@....@......................@...@@@..@@@@@@@@
.@@@@......@@..........@@@@@@@@@@@@@@@@@@@@@@....................@.....................@@@@@@@@
...@@@.........@..@....@@@@@@@@@@@@@@..@...@@@@................@.............@..........@@@@@@@
...@@@@........@.......@@@@@@@@@@@@@@.........@................@.....@@...........@..@@@@@@@@@@
@@@@@@......@.@..........@@@@@@@@@@@@...@.......@........@...@.@.....@.........@....@@@@@@@@@@@
@@@@@@@.....@...........@@@@@@@@@@@@@...@.@........@.....@....@@...............@....@@@@@@@@@@@
@@@.....@...@@@@@@@@....@@@@@@@@@@@@@@@@@..........@@.....@....................@@....@@@@@@@@@@
........@.@.@@@@@@@@..@@@@@@@@@@@@@@@@@@..............@.....................@@@@@@.....@@@@@@@@
..........@..@@@@@@@@@@@@@@@@@@@@@@@@@@@@.........@@@.............@..........@@@@@@@..@@@@@@@@@
.........@@..@@@@@@@@@@@@@@@@@@@@@@@@@@@@@@@@@...@@@@.............@..........@@@@@@@@@@@@@@@@@@
@.......@@@@@@@@@@@@@@@@@@@@@@@@@@@@@@@@@@@@....@@@.........................@@@@@@@@@@@@@@@@@@@
@..........@@@@@@@@@@@@@@@@@@@@@@@@@@@@@@@@@@@............@.............@..@@@@@@@@@@@@@@@@@@@@
@..........@@@@@@@@@@@@@@@@@@@@@@@@@@@@@@@@@@@....@...@....................@@@@@@@@@@@@@@@@@@@@
@.@..@......@@@@@@@@@@@@@@@@@@@@@@@@@@@@@@@@@@....@@@@@....@.............@@@@@@@@@@@@@@@@@@@@@@
@...@........@@@@@@@@@@@@@@@@@@@@@@@@@@@@@@@@@@.@........@@@...@.......@@@@@@@@@@@@@@@@@@@@@@@@
...........@@@@@@@@@@@@@@@@@@@@@@@@@@@@@@@@@..@...@.......@@@@..........@@@@@@@@@@@@@@@@@@@@@@@
...........@@@@@@@@@@@@@@@@@@@@@@@@@@@@@@@@@.....@@......@@@@@@@........@@@@@@@@@@@@@@@@@@@@@@@
..........@@@@@@@@@@@@@@@@@@@@@@@@@@@@@@@@@@.@..............@@@@@.......@@@@@@@@@@@@@@@@@@@@@@@
8
50 53 0
61 65 0
6 57 0
70 85 0
79 21 0
21 10 0
50 35 0
54 76 0

72 75 0
3 18 0
43 18 0
75 20 0
61 78 0
7 17 0
59 94 0
3 27 0
