width 95
height 95
@@@@@@@@@@@@@@@........@...@..@@..@@......@@@@@@@@@@@@..@@..@@@@@@@@@@@@@@@@@@@@@@@@@@@@@@@@@@@
@@@@@@@@@@@@@@@@...........@......@....@@@@@@@@@@@@@@@..@....@@@@@@@@@@@@@@@@@@@@@@@@@@@@@@@@@@
@@@@@@@@@@@@@@@.@.@@@.....@........@@....@@@@@@@@@@@.......@@@@@@@@@@@@@@@@@@@@@@@@@@@@@@@@@@@@
@@@@@@@@@@@@@.....@@@@@...........@@.....@@@@@@@@@@@@@@....@@@@@@@@@@@@@@@@@@@@@@@@@@@@@@@@@@@@
@@@@@@@@@@@@@.....@@@@@...................@@@@@@@@@@@@@@...@@@@@@@@@@@@@@@@@@@@@@@@@@@@@@@@@@@@
@@.@.@@@@@@@@......@@@....................@@@@@@@@@@@@@@..@@@@@@@@@@@@@@@@@@@@@@@@@@@@@@@@@@@@@
@@.....@@@@@@.......@@....................@@@@@@@@@@@@@.....@@@@@@@@@@@@@@@@@@@@@@@@@@@@@@@@@@@
@@........@@........@@......@..........@...@@@@@@@@@@@......@@@@@@@@@@@@@@@@@@@@@@@@@@@@@@@@@@@
.@.......@@@........@@@@@......@@.@........@....@@@@@.......@@@@@@@@@@@@@@@@@@@@@@@@@@@@@@@@@@@
........@@@@....@....@@@.........................@@@..@......@@@@@@@@@@@@@@@@@@@@@@@@@@@@@@@@@@
..........@..........@@........@@............@@...@@....@.....@@@@@@@@@@@@@@@@@@@@@@@@@@@@@@@@@
...............................@@...@@........................@@@@@@@@@@@@@@@@@@@@@@@@@@@@@@@@@
.@...............@.................@@@........................@@@@@@@@@@@@@@@@@@@@@@@@@@@@@@@@@
.........@.@...@.......@..@@.......@@..@.......................@@@@@@@@@@@@@@@@@@@@@@@@@@@@@@@@
....@@.....@..@@......@@....@...........@........@.............@@@@@@@@@@@@@@@@@@@@@@@@@@@@@@@@
@@@@@@........@@.@.@@@@@.......................@....@@@@........@@@@@@@@@@@@@@@@@@@@@@@@@@@@@@@
@@@@@...@@....@@@@..............@@.........@..........@@........@@@@@@@@@.@@@@@@@@@@@@@@@@@@@@@
@@@@@@.........@@.......@.......@......@....@...@............@@@@..@@@@@@.@@@@@@@@@@@@@@@@@@@@@
@@@@@.......@....@..................@......@@...@@....@@........@@....@....@@@@@@@@@@@@@@@@@@@@
@......@.........@............@@....@.......@..........@...................@@@@@@@@@@@@@@@@@@@@
.........@....@@@@................@...@.......@......@...........@....@@.@@@@@@@@@@@@@@@@@@@@@@
.........@.....@@@...............@....@@...........@@@@@.........@.....@..@@@@@@@@@@@@@@@@@@@@@
@@@...................@..............@..........@@@@@@@@...............@..@@@@@@@@@@@@@@@@@@@@@
@@..@.....@.....................@.....@...@@..@@@@@@@@@@@...@.............@@...@@@@@@@@@@@@@@@@
@@@@@@@.........@....................@@...@...@@@@@@@@@@@.....@......@@...@........@@@@@@@@@@@@
@.@@@@@........@@...@@...@..........@@@.......@@@@@@@@@@......@.......@............@@@@@@@@@@@@
..@@@@@@@@...........@......@......@@@@@@@@..@@@@@@@@...@...........@..............@@@@@@@@@@@@
@..@@@@@@..............@@@..@...@@@@@@@@@@...@@@@@@@@...........@@@.....@.....@@...@@@@@@@@@@@@
...@@@@.....@@............@.....@@@@@@@@@@.@@@@@@@@@@.........@@@@.............@..@@@@@@@@@@@@@
...@@......@@@....................@@.@@@@@...@@@@@@@@.......................@....@@@@.@@@@@@@@@
..............................@@.......@@@...@@@@@@@@@..........................@@@@@..@@@@@@@@
.........@...................@@@.......@@......@@@@@@@.....................@.@...@@@@..@@@@@@@@
.....................................@....@....@@@@@@@@.....................@@...@@@....@@@@@@@
@........@@@.........@............................@@@@..@.....@@............@@...@@.....@@@@@@@
@........@@@.@.........@@........@.@..@@.....@.@@@@@@@..@@.@......................@.....@@@@@@@
@........@@@.@...@@...@@@@.........@.........@@@@@@@@@@@@@@@......@..@..........@.......@@@@@@@
@@@.....@@@@@@@@@@@@.@@@@@.@@@@............@@@@@@@@@@@@@@@@@.....@@.....................@@@@.@@
@@@@..@.@@@@@@@@@@@@@@@@@@@@@@@.............@@@@@@@@@@@@@@@@....@@@.......@.......@...@@@@@..@@
@@@@....@@@@@@@@@@@@@@@@@@@@@@@.@@..@......@@@@@@@@@@@@@@@@@.....@@..........@...@@...@@@@@...@
@@@@......@@@@@@@@@@@@@@@@@@@...@@............@@@@@@@@@@@@@@......@....................@@.....@
@@@@@......@@@@@@@@@@@@@@@@@@.....................@@@@@@@@@......@...@...@@.....@......@...@@@@
@.@@@......@@@@@@@@@@@@@@@@@@.@...............@@......@@@.@......@@...@......@@@...........@@@@
@.....@.......@@@@@@@@@@@@@@@.@......@...@.....@..@....@..@..........@@....@@@@@............@@@
@@@.....@..@@@@@@@@@@..@@@@@@@@................@@.@..................@@..@@@@@@@..@@..@......@@
@@...........@@@@@@@@...@@@@...........@...@...@...@......@@.............@@@@@@@..@@.......@@@@
@@@@.........@@@@@@@@......@...@@...........@...........@.@@@.................@............@@@@
@@@@.........@..@@@@@...........@...@.......@.@@................@@...........................@@
@@.............@@@@@....@.....................@@@............@.............@............@.....@
@@.....@.......@@@@...........@@.......@.@...........@@.......@...............@..@.............
@...@@@.........@@@@.@.......@@@............@.........................@@@.............@@@......
@@.@@.......@...@....@.....@@@@@@@@.....@@@@@.........@@@@.............@@.@@........@@@@@....@@
@@..@...@...........@.....@@@@@@@@........@@....@@....@@@..............@..@...@@@.............@
@@......@@@@@.............@@@@@@...........@..@@@@...............@@....@.........@....@.......@
@@......@@..@@...........@@@@@@@@.@........@...@@@@@...@.........@@@@@@@........@@@@...@@@.@@@@
@@......@@...@...@.......@@@@@@@@..........@...@@@@....@.....@...@@@@@@@@@.........@.@@@@@.@@@@
@@......@@.....@.........@@@@@@........@.....@@@@@@....@..@@.....@@@@@@@@...............@@@@@@@
@@......@..............@@@@@@@@@....@.@@@@@..@@@@.................@@@@@@@...@......@...@@@@@@@@
@............@@........@@@@@@@@@@@...@@@@....@....................@@@@@@@...@...@@.....@@@@@@@@
...........@.............@@@@@@@@@...@@@.........................@@@@@@@@......@@..@....@@@@@@@
...............@@........@@@@@@@@@...@.@@...........................@@@@@..@...@@..@....@@@@@@@
@........................@@@@@@@@@.....................@@@@@........@@@@@..........@...@@@@@@@@
@@........................@@@@@@@..........@@..........@@@@@.......@@.@@@.............@@@@@@@@@
.@.........................@@.@@@..........@@..@.@.....@@@@@...@..@...................@@@@@@@@@
............................@..@@..........@........@@@@@@@@..........................@@@@@@@@@
....@..........@..@@@@.@@......@@@..........@...@.@@@@@@@@@@.............................@@@@@@
...@........@.......@@@@@...@@@@@@..............@@@@@@@@@@@@@@@..@.....................@@@@@@@@
.................@..@@@@....@@@@@@...........@...@@@@@@@@@@@.......@.......@.......@@@@@@@@@@@@
.................@@.........@@@@@............@@@@@@@@@@@@@@@..................@.....@@@@@@@@@@@
........@........@@........@@@@@@..............@@@@@@@@@@@@@.........@......@.......@@@@@@@@@@@
................@@@.@......@@@.@@............@@@@@@@@@@@@@@@.@@..@.................@@@@@@@@@@@@
@............@..@@@@@..........@@@..@@.......@@@@@@@@@.@@@@@...@.......@..........@@@@@@@@@@@@@
@.@@.............@@@@@..........@@@...........@@@@@@@@.............@@@............@@@@@@@@@@@@@
@@@@@@..........@@@@.@..@.........@@..........@@@@@@@@..........................@@@...@@@@@@@@@
@@@@@@@@....@...@@@.........@...@.............@@@@@@@@........@.................@@@......@@@@@@
@@@@@@@@........@@...@@.....@...@..@..........@..@@@@.........@@.........@@@....@@@...@@@@@@@@@
@@@@@@@@......@......@@............@......@....................@......@..@@.....@@@....@..@@@@@
@@@@@@@@@............@@......@....@@.......@.........................@@@@@@@.....@@.......@@@@@
@@@@@@@@@@.......@...@..........@...................................@@@@@@@@...............@@@@
@@@@@@@@@........@@................................................@@@@@@@@@...................
@@@@@@@@@.@.........................@............@@@@............@..@@@@@@@@...................
@@@@@@@@@@..@.........@.......@@..................@..................@@@@@@..........@....@....
@@@@@@@@@@@...........@...@..@@@@@.......................@...........@@@@@@....................
@@@@@@@@@@......@.........@..@@@@@..@....@................@...........@...@...............@....
@@@@@@......................@@@@@@.................@....@@@...........@...@@...................
@@@@@@..@....@@..............@@@@@.......@..............@...@..................................
@@@@@........@..................@@...............@..@.......@@.....................@@@.........
@@......@@.@@@..............@@..@@............@....@@@@....@@@@@.....@@@@@.........@@@@........
@@.......@.@@@@@...........@@@@.@@@.@@............@@@@@..@@@@@@@.....@@@@@...............@.....
@@.......@.@@@@.........@@..@@@@@@@.@@............@@.....@@@@@@@..@@@@@.................@......
@@@........@@@@.........@...@@@@@@@@@......@.........@@@@@@@@@@@..@@@@@........................
@@....@.......@......@..@..@@@@@@@@@..................@@@@@@@@@@....@@@.................@@@..@@
...........................@@@@@@@@@@@...............@@@@@@@@@@@@@...@...@......@......@@@@@@@@
....................@...@@@@@@@@@@@@@...........@@....@@@@@@@@@@@@.......@@.....@......@@@@@@@@
....................@@....@@@@@@@@@@@.................@@@@@@@@@@@@...........@@@@@@@...@@@@@@@@
....@.@@...@@@@@@@@@@@@...@@@@@@@@@@..@...@..........@@@@@@@@@@@@@.@.@@....@@@@@@@@@@@@@@@@@@@@
8
72 37 0
30 16 0
65 64 0
27 14 0
23 72 0
24 53 0
40 90 0
38 68 0

72 39 0
72 71 0
64 66 0
66 31 0
13 48 0
42 40 0
40 12 0
77 50 0
