width 95
height 95
@@@@@@@@@@@@@@@@@@@@@@@@@@@@@@@@@@@@@@@@@@@@@@@@@@..@@@@@@@@@@..@@@@@@@@@@@@@@@@@@@@@@@@@@@@@@.
@@@@@@@@@@@@@@@@@@@@@@@@@@@@@@@@@@@@@@@@@@@@@@@@@...@@@@@@..@...@@@@@@@@@@@@@@@@@@@@@@@@@@..@..
@@@@@@@@@@@@@@@@@@@@@@@@@@@@@@@@@@@@@@@@@@@@........@.@@@...@.....@@@@@@@@@@@@@@@@@@@@@@@@.....
@@@@@@@@@@@@@@@@@@@@@@@@@@@@@@@@@@@@@@@@@@@@@@.........@...@......@@@@@@@@@@@@@@@@@@@@@@.......
@@@@@@@@@@@@@@@@@@@@@@@@@@@@@@@@@@@@@@@@@@@@@...................@@@@@@@@@@@@@@@@@@...@.....@...
@@@@@@@@@@@@@@@@@@@@@@@@@@@@@@@@@@@@@@@@@@@@@..@....@...........@@@@@@@@@@@@@@@@@@.............
@@@@@@@@@@@@@@@@@@@@@@@@@@@@@@@@@@@@@@@@@@@@@@@@...........@@...@@@@@@@@@@@@@@@@@..............
@@@@@@@@@@@@@@@@@@@@@@@@@@@@@@@@@@@@@@@@@@@@@@@@.......@...@......@@@@@@@@@@@@@@@.@@...@.......
@@@@@@@@@@@@@@@@@@@@@@@@@@@@@@@@@@@@@@@@@@@@@@@@..................@@@@@@@..@@@@@@.@.........@@.
@@@@@@@@@@@@@@@@@@@@@@@@@@@@@@@@@@@@@@@@@@@@@@@@@....@............@@@@@@....@.@@..@............
@@@@@@@@@@@@@@@@@@@@@@@@@@@@@@@@@@@@@@@@@@@@@@@@..................@@@@@@....@.@@......@....@...
@@@@@@@@@@@@@@@@@@@@@@@@@@@@@@@@@@@@@@@@@@@@@@@@...@@@......@........@@@..@@...................
@@@@@@@@@@@@@@@@@@@@@@@@@@@@@@@@@@@@@@@@@@@@@@@@...@...............@@@.............@@....@.....
@@@@@@@@@@@@@@@@@@@@@@@@@@@@@@@@@@@@@@@@@@@@@@@...@@.....@........@......@.........@.......@..@
@@@@@@..@@@@@@@@.....@@@@@@@@@@@@@@@@@@@@@@@@@@...@...@.......@...................@.......@@@@@
@@@@@@...@@@@@@@.....@@@.@@@@@@@@@@@@@@@@@@@@@@....@...............@@.............@..........@@
@@@@@@.....@@@@@@.@......@@.@@@@@@@@@@@@@@@@@@@@...@@.............@@.....@@@.................@@
@@@@@........@@@..........@....@@@@@@@@@@@@.@@@@.......@.................@@@........@@@......@@
@@@@@@@@....@@@.....@@.........@@@@@@@@@@@.........................@.@@..@...........@@@.....@@
@@@@@@......@@..................@@@@@@@@@@...........@.............@@..................@.....@@
@@@@@........@..................@@@.@@@@@@...........@.@..........@@.......................@...
@@@@@....@.....@......@........@@...@@@@@@............................@@@.....@..@.............
@@@@@................................@@@@@.......@..@@.@@...............@......................
@@@@@.....@.@..@.....................@@@@@@@...@...@.@..........@...@...@...@.............@....
@@@@@....@...........................@@@@@@@.@..................@.........@@@.....@.......@@@@@
.@@@@....@............@@............@@@@@@@@.@@.......................@@@@@@@@............@@@@@
.........@............@@@@@@@....@@@@@@@@@@@............................@.@@@.............@@@@@
..........@............@@@@@@@...@@@@@@@@@....@...@@....@......@@........................@@@@@@
.....@....@@@@.........@@@@@.........@@@.@..............@......@...........@...@...@@..@@@@@@@@
...@.@....@@@@@...@....@@@.@@........@@.......@@..................@........@@@@@...@@@@@@@@@@@@
.@@@......@@@@@@......@@@@.@.........@...................@..........@..@@...@@@@...@@@@@@@@@@@@
...@......@@@@@@@.....@@@.......@........................@.............@@.@@@@......@@@@@@@@@@@
.@@..@....@@@@@@.......@..@...@...........@@@................@@......@.@@..@@@......@@@@@@@@@@@
.@.@.@.....@@@@.@...@.................................@.......@............@@@.....@@@@@@@@@@@@
............@@@....@.......@.@.........@.....@......@@@....................@@@@...@@@@@@@@@@@@@
...........@...........................@.....@.....@@@@......................@....@@@@@@@@@@@@@
......@.......@..........@.........@.........@@@@@@@@@.............@....@...@......@@@@@@@@@@@@
..........@...@...................@@...........@@@@@@@....@....@...................@@@@@@@@@@@@
@@@@@............................@@.............@@@@@@....@........................@@@@@@@@@@@@
@@@@@...@.........................@...............@@@@........@.........@@@@@.....@@@@@@@@@@@@@
@@@@.....@..@..................@...................@........@...........@@@@@.@@@@@@@@@@@@@@@@@
@@@@....@@@@@@@@@.....@@.......@@..............@...@......@@@..........@@@@@@@@@@@@@@@@@@@@@@@@
@@@@@@....@@@@@@@.............@@@...@..................................@@@@@@@@@@@@@@@@@@@@@@@@
@@@@@@@@@@@@@.@....@.........@@@@@@@@.@@@@.............................@@@@@@@@@@@@@@@@@@@@@@@@
@@@@@@@@@@@@@.................@@@@@@@@@@@@@@@@@..........................@@@@@@@@@@@@@@@@@@@@@@
@@@@@@@@@@@@.......@.@.....@@@@@@@@@@@@@@@@@@@..........@.............@..@@@@@@@@@@@@@@@@@@@@@@
@@@@@@@@@@@@@@.....@@.......@@@@@@@@@@@@...@.@..........@.@.@.........@.@@@@@@@@@@@@@@@@@@@@@@@
@@@@@@@@@@@@@@@....@@@......@@@@@@@@@@...@...@@......@.@@......@@.......@@@@@@@@@@@@@@@@@@@@@@@
@@@@@@@@@@@@@@@....@@@......@@@@@@@@@@.........@...@..@@@@@..@..........@@@@@@@@@...@@@@@@@@@@@
@@@@@@@@@@@@@@@.....@@......@@@@@@@@@@...@@@.......@..@@@@@..@..........@@@@@@@@@...@@@@@@@@@@@
@@@@@@@@@@@@@@@..@..@@......@@@@@@@@@@@@@@@...@........@@@..............@@@@@@@@...@@@@@@@@@@@@
@@@@@@@@@@@@@@@@@@@.@@...@...@@@@@@@@@@@@@@@..........@@@@@...@@...@@..@@@@....@@..@@@@@@@@@@@@
@@@@@@@@@@@@@@@@@@..@@...@@..@@@@@@@@@@@@@@@.................@@@@@................@@@@@@@@@@@@@
@@@@@@@@@@@@@@@@@@..@.....@....@@@@@@@@@@@.............@......@...............@@@@@@@@@@@@@@@@@
@@@@@@@@@@@@@@@@@@...........@@..@@@@@@@@@..................@.............@...@@@@@@@@@@@@@@@@@
@@@@@@@@@@@@@@@@@@..........@.....@@@@@@@@................@...................@@@@@@@@@@@@@@@@@
@@@@@@@@@@@@@@@@@.................@@@@@@@@.............................@.....@@@@@@@@@@@@@@@@@@
@@@@@@@@@@@@@@@@@.....@...@.......@@@@@@@@@@................@@@@..............@@@@@@@@@@@@@@@@@
@@@@@@@@@@@@@@@@@.................@@@@@@@@@...@.............@@.......@@........@@@@@@@@@@@@@@@@
@@@@@@@@@@@@@@@@@..........@.....@@@@@@@@@@...............@@@@.................@@@@@@@@@@@@@@@@
@@@@@@@@@@@@@@@@@@@........@.....@@@@@@@@@@.......@.@.....@@...........@........@@@@@@@@@@@@@@@
@@@@@@@@@@@@@@@@@@@..............@@@@@@@@@@.................................@......@@@@@@@@@@@@
@@@@@@@@@@@@@@@@@@@..............@@@@@...@@@.............@......@@...@......@@.....@@@@@@@@@@@@
@@@@@@@@@@@@@@@@@.............@.....@@@.@@@@...........@...@@......................@@@@@@@@@@@@
@@@@@@@@@@@@@@@@@..........................@..................................@....@@@@@@@@@@@@
@@@@@@@@@@@@@@@@@...@@@..................@.@@@....@...............@...............@@@@@@@@@@@@@
@@@@@@@@@@@@@........@.........@...@@................@.@@......................@@@@@@@@@@@@@@@@
@@@@@@@@@@@@.................@.....@@..........@..@....@@.............@.....@.....@@@@@@@@@@@@@
@@@@@@@@@@@...................@................@......@.@.@...............@.@......@@@@@@@@@@@@
@@@@@@@@@@@@..................@.....................@...@@@.......@@...@.............@@@@@@@@@@
@@@@@@@@@@@@......@..@.....@.@@............@............................@...........@@@@@@@@@@@
@@@@@@@@@@@@...........@@.........................................................@..@@@@@@@@@@
@@@@@@@@@@@@.@..........................................@....................@@...@@@@@@@@@@@@@
@@@@@@@@@@@@................@................@.............................@@@@@@.@@@@@@@@@@@@@
@@@@@@@@@@@@................@@@...@@@@@.@@@........@..................@...@@@@@@@@@@...@@@@@@@@
@@@@@@@@@@@@.....@..........@@@@..@@@@@@@@@.......@@@@@@@@................@@@@@@@@@@...@@@@@@@@
@@@@@@@@@@@@......@..........@@@..@@@@@@@@@.......@@@@@@@@@....@@..@.....@@@@@@@@@@@..@@@@@@@@@
@@@@@@@@@@@@@@@....@.........@@@@.@@@@@@@@@.@@@....@@@@@@......@@....@....@@@@@@@@.......@@@@@@
@@@@@@@@@@@@@@@.@............@@@@@@@@@@@@@@.........@@@@@.....@@@@..@@....@...@@.@..@.....@@@@@
@@@@@@@@@@@@@@.....@..........@@@@@@@@@@.@.....................@@....@........@.....@......@@@@
@@@@@@@@@@@@@@.................@@@@@@@@@...@.................@.....@...............@@....@@@@@@
@@@@@@@@@@@@@@@.................@@@@..@@...@@.............@.......@@..@.............@.......@@@
@@@@@@@@@@@@@@@..@..@............@@@............@.................@.@..................@.......
@@@@@@@@@@@@@@@..................@...............@@.........@......................@...@.......
@@@@@@@@@@@@@@@@......................@@.........@@.........@@.........................@.......
@@@@@@@@@@@@@@@@@..@@.................@.......@@................@@..@..........................
@@@@@@@@@@@@@@@@@@.@@@@@.............@@@@.....@@....................@@..@.................@....
@@@@@@@@@@@@@@@@@@@@@@@@...........@@@@@@@...@@@......@..............@.@@...............@..@@.@
@@@@@@@@@@@@@@@@@@@@@..............@..@@@@....@@@@.....................@@..................@@@@
@@@@@@@@@@@@@@@@@@@@....................@..........@@@.....@............@.............@......@@
@@@@@@@@@@@@@@@@@@@...............@.........@......@@@@.................@@@.@..@@@..........@@@
@@@@@@@@@@@@@@@@@@@@.......@@.....@...........@....@@@@........@......@@@@@@@@@@@@...@.....@..@
@@@@@@@@@@@@@@@@@@@........@@......................@@.................@@@@@@@@@@@@..@..........
@@@@@@@@@@@@@@@@@@@..@....@@@@@@........@.....................@....@..@@@@@@@@@@@@@@@..........
@@@@@@@@@@@@@@@@@@@@......@@@@@@@@.@@.@@@.............@@@@@@.......@@@@@@@@@@@@@@@@@@@@@.......
8
73 72 0
81 35 0
19 44 0
62 65 0
69 69 0
86 86 0
55 84 0
32 67 0

60 91 0
80 37 0
69 91 0
59 17 0
19 33 0
29 31 0
50 92 0
64 51 0
