width 95
height 95
@@@@@@@@@@@@@@@@@@@@@@@@@@@@@@@@@@@@@@@@@......@........@@.....@@@@@@@@@@@@@@@@@@@@@@@@@@@@..@@
@@@@@@@@@@@@@@@@@@@@@@@@@@@@@@@@@@@@@@@@@....@....@............@@@@@@@@@@@@@@@@@@@@@@@@@@@.....
@@@@@@@@@@@@@@@@@@@@@@@@@@@@@@@@@@@@@@@@@..@..............@..@.@@@@@@@@@@@@@@@@@@@@@@@@@@....@.
@@@@@@@@@@@@@@@@@@@@@@@@@@@@@@@@@@@@@@@@@.................@....@.@.@@@@@@@@@@@@@@@@@@@@@@@.....
@@@@@@@@@@@@@@@@@@@@@@@@@@@@@@@@@@@@@@@@............................@@@@@@@@@@@@@@@@@@@@.......
@@@@@@@@@@@@@@@@@@@@@@@@@@@@@@@@@@.@@@@@.............@@@...............@@@@@@@@@@@@@@@@@.......
@@@@@@@@@@@@@@@@@@@@@@@@@@@@@@@@@@..@@@..............@@@@........@@...@@@@@@@@@@@@@@@@@@......@
@@@@@@@@@@@@@@@@@@@@@@@@@@@@@@@@@@..@@@......@........@.........@@..@@@@@@@@@@@@@@@@@@@@...@..@
@@@@@@@@@@@@@@@@@@@@@@@@@@@@@@@@@@........................@.....@@@@@@@@@@@@@@@@@@@@@@@.......@
@@@@@@@@@@@@@@@@@@@@@@@@@@@@@@@@@@....@@........................@@@@@@@@@@@@@@@@@@@@@@@@......@
@@@@@@@@@@@@@@@@@@@@@@@@@@@@@@@@@@....@@......@@................@@@@@@@@@@@@@@@@@@@@@@@........
@@@@@@@@@@@@@@@@@@@@@@@@@@@@@.........@@.@......................@@@@@@@@@@@@@@@@@@@@@@@........
@@@@@@@@@@@@@@@@@@@@@@@@@@@@@.................................@@@@@@@@@@@@@@@@@@@@@@@@@@@@.....
@@@@@@@@@@@@@@@@@@@@@@@@@@@@..................@@...@............@@@@@@@@@@@@@@@@@@@@@@@@@@.....
@@@@@@@@@@@@@@@@@@@@@@@@@@@@@....@...@.........@@....@@.......@@@@@@@@@@@@@@@@@@@@@@@@@@@@.....
@@@@@@@@@@@@@@@@@@@@@@@@@@@...@...@............@....@@@@.........@@@@@@@@@@@@@@@@@@@@@@@@...@..
@@@@@@@@@@@@@@@@@@@@@@@.@@........................................@@@@@@@@@@@@@@@@@@@@@@@......
@@@@@@@@@@@@@@@@@@@@@@@..................@@..............@@...@..@@@@@@@@@@@@@@@@@@@@@@@@@...@.
@@@@@@@@@@@@@@@@@@@@@@@....@@@.........@@@@.@............@@......@@@@@@@@@@@@@@@@@@@@@@@@....@@
@@@@@@@@@@@@@@@@@@@@@@@....@@@...@...@@@@@@......@.......@@@@....@@........@@@@@@@@@@@@@....@@@
@@@@@@@@@@@@@@@@@@@@@.....@@@..........@@........@.......@@@@@@..@..........@@@@@@@@@@@@....@@@
@@@@@@@@@@@@@@@@@@@@@@@@@@@@@..@....@............@......@@@@@...............@@@@@@@@@@@......@@
@@@@@@@@@@@@@@@@@@@@@@@@@@@@@@......@@@.......@..@...@@@@@@...........@......@@@@@@@@........@@
@@@@@@@@@@@@@@@@@@@@@@@@@@@@@@.......@........@..@.......@@...@..............@@@@@@@@@.........
@@@@@@@@@@@@@@@@@@@@@@@@@@@@@@.@.....@@@@@......@@@@@@@..@..............@.......@@@@@@@.......@
@@@@@@@@@@@@@@@@@@@@@@@@@@@@@@@@@.....@@@.......@@@@@@@......@................@@@@@@@@.........
@@@@@@@@@@@@@@@@@@@@@@@@@@@@@@@@@@.......@.....@@@@@@@@........................@@@.@@@@........
@@@@@@@@@@@@@@@@@@@@@@@@@@@@@@@@@.............@@.@@@@@@@@........@.........@...@@@.@@@@@.......
@@@@@@@@@@@@@@@@@@@@@@@@@@@@@@@@@.................@@@@@@@....@.......@.....@...................
@@@@@@@@@@@@@@@@@@@@@@@@@@@@@@@@@@................@@@@@@...........@.......@.....@.............
@@@@@@@@@@@@@@@@@@@@@@@@@@@@@@@@@@....@......@...@@@..@................@@..@@@.......@....@....
@@@@@@@@@@@@@@@@@@@@@@@@@@@@@................@...@@@..............@@......@@@@.................
@@@@@@@@@@@@@@@@@@@@@@@@@@@@@@@@......@@........@@@@..........@......@...@@@@@.................
@@@@@@@@@@@@@@@@@@@@@@@@@@@@@@@@.....@@@@.......@@@@..........@........@@@@@@.........@........
@@@@@@@@@@@@@@@@@@@@@@@@@@@@@@@@@@@@@@@..........@......................@....@@...@...........@
@@@@@@@@@@@@@@@@@@@@@@@@@@@@@@@@@@@@@@.....................................@.@@..........@@@...
@@@@@@@@@@@@@@@@@@@@@@@@@@@@@@@@@......................................@.....@@...........@@@@@
@@@@@@@@@@@@@@@@@@@@@@@@@@@@@@@@@....@......@........@.@@....................@@........@..@@@@@
@@@@@@@@@@@@@@@@@@@@@@@@@@@@@@@@@...............@@..@@@......@@.............@@@........@@@@@@@@
@@@@@@@@@@@@@@@@@@@@@@@@@@@@@@@@.......@........@....@@..............@@..@..@@...@.....@@@@@@@@
@@@@@@@@@@@@@@@@@@@@@@@@@@@@@@@@......@........@....................@@@...............@@@@@@@@@
@@@@@@@@@@@@@@@@@@@@@@@@@@@@@@@..............................@....@@@@@........@.........@@@@@@
@@@@@@@@@@@..@@@@@@@@@@@@@@@.@@.......@@...@@@@@@.................@@@@........@@@........@@@@@@
@@@@@@@@@....@@@@@@@@@@@@@@.....@@@..........@....................@@@@@@.....@@@@......@@@@@@@@
@@@@@@@@@....@@@.@@@@@@@..@.....@@...........@............@.......@@@........@@@@.@@...@@@@@@@@
@@@@@@@@@@........@@..@...@@....@.....................@@......@...@.........@@@@@.....@@@@@@@@@
@@@@@@@@@@@.......@@@....@@@@......@@................@.@.....@@........................@@@@@@@@
@@@@@@@@@@...............@@@@......@@...@............@.......@@.@....@@...@............@@@@@@@@
@@@@@@@@@@@.............@@@@@............................@...@@@@@........@..@.........@@@@@@@@
@@@@@@@@@@........@......@@@@@.............@......@.@....................@@@@@@....@..@@@@@@@@@
@@@@@@@@@...........@...@@@@............................@......@..........@@@@@@......@@@@@@@@@
@@@@@@@@@..................@@...@@.......................@.....@...@...@....@@........@@@@@@@@@
@@@@@@@@@...@.....@@@..@.......................@..................@@.................@@@@@@@@@@
@@@@@@@@@@.......@@@@@@@@...........@..........@..................@...................@@@@@@@@@
@@@@@@.@@@.....@...@@@@@@.......@...@..@.......@..............@..............@@@.......@@@@@@@@
@@@..@..............@@@@@.....@@@@..@...................................................@@@@@@@
@.@..@........@.....@@@@@@@@@.....@..@@....@............@.........@.@@..................@@@@@@@
.......@...........@@@@@@@@.........@@@....@@..@........@@.......@@@@@............@@....@@@@@@@
.@....@@.........@@.@@@..@..@.........@..........@......................................@@@@@@@
.@..................@@@@.@@@@.........@..........@..................@....@.....@......@.@@@@@@@
@@@.............@....@@@..................@@@@..@........@@@..............@....@...........@@@@
@@@....@.............@@@.......@..........@@@...@.......@@@@@@@.........@.@..................@@
@@@......@..@.............@@@.@@@.........@@.......@.@@@@@@@@@@@..........@.@...@@.......@...@@
@@@...............@..@.....@...@.....@...............@@@@@@@@@@@...............................
@@@...............@..@@@@............@....@...........@@@@@@@@@.......................@...@....
@@@...@@..........@..@..@..................@...........@@@@@@@@.....@...........@.@.@....@@@...
@@@.@@@@@..................................@...@........@@@@@@@.............@@@.@@......@@@@...
@@@..@@@@@........@.........@.@............@@..@@....@@@@@@@@@@............@@.@................
@@.......@................@@@@@...........@@@@@@@@@..@@@@@@@@@@@................@.........@..@@
@..@..@.......@@...@..@@@@@@@@@...@@...@....@@@@@@@.@@@@@@@@@@@@@............@............@.@@@
@@.....................@@@@@@@@@@@@@........@@@@@@@@@@@@@@@@@@@@@........................@@@@@@
@......@..@........@......@@@@@@@@..........@..@@@@@@..@@@@@@@@@................@..@.@@@.@@@@@@
.......@.@@.................@@@........@@@.@@..@@@@@....@@@@@@@@@@@......................@@@@@@
.....................@........@................@@@@@@..@@@@@@@@@...........@@............@@@@@@
...@@..@.......@.....@.............@........@....@@......@@@@@.@...........@.......@..@...@@@@@
.@@@@......@...@@@@..@...........................@@......@@@...........@@................@@@@@@
.@@@@@....@@..@@@@@@@@....................@......................@@......................@@@@@@
@@@@@@....@@.@@@@@@@@@@@@.......@............@.......@.......@@..........................@@@@@@
@@@@.....@@@.@@@@@@@@@@@@@................@...............@..@@.....@.............@.....@@@@@@@
@@@@...@@@@@@@@@@@@@@@@@@.......@@..........@@@...@.........@.@......@@...........@@....@@@@@@@
.......@@@@@@@@@@@@@@@@@@....@......@........@@.......@@@@.................@............@@@@@@@
.......@@@@@@@@@@@@@@@@@..@.................@@@........@@@@..............@@@...............@@@@
.......@@@@@@@@@@@@@@@...................@..@@@...@.....@@@@...........@......@..........@@@@@@
........@@@@@@@@@@@@@@..@....@@..................@@....@@@...@.@@......@..............@...@@@@@
..........@@@@@@@@@@@.......@@@..@....@................@@@..@@@@............@.............@@@@@
........@.@@@@@@@@@@@........@@@.......................@@@@@@@@@...@.........................@@
.@.@....@.@@@@@@@@@@@.@......@@@@...............@@.....@@@...@@@..........@...................@
@......@@.@@@@@@@@@@@....@@@@@@@@@@@...........@@@......@@...@@...........@....................
..........@@@@@@@@@@@....@@@@@@@@@@@...@.......@@@@@@...@@...@@..........@.....................
...........@@@@@@@@@@@@@@@@@@@@@@@@....@@.@@..@@@@......@@@.............@@.....................
............@@@@@@@@@@@@@@@@@@@@@@@....@@.@@.@@@@..................@@.........@@@@@...@........
@@@..........@@@@@@@@@@@@@@@@@@@@@@.......@@.@@@..................@@@.@@@...@@@@@@@.......@....
@@@...@......@@@@@@@@@@@@@@@@@@@@@@..........@@@....@........@@...@@@@@@@...@@@@@@@@@..........
@@@@@@@@....@@@@@@@@@@@@@@@@@@@@@@@.@...@@@@@@@@....@@......@@@@@@@@@@@@@@@@@@@@@@@@@@.@@@..@..
@@@@@@@@@@..@@@@@@@@@@@@@@@@@@@@@@@.@@@@@@@@@@@@@...@........@@@@@@@@@@@@@@@@@@@@@@@@@@@@@....@
8
29 16 0
53 50 0
30 48 0
41 0 0
52 3 0
41 47 0
49 46 0
17 67 0

0 72 0
94 17 0
79 88 0
41 7 0
82 80 0
52 23 0
13 75 0
23 20 0
