width 95
height 95
@@@@@@@@@@@......@@..@@.....@...@@@@@@@@@@@@@@@@@@@@@@@@...@...................@@....@@@@@@@@@@
@@@@@@@@@@......@@@..@@@........@@@@@@@@@@@@@@@@@@@@@@@@...@.................@.......@@@@@@@@@@
@@@@@@@@@@................@.....@@@@@@@@@@@@@@@@@@@@@@@.............................@@@@@@@@@@@
@@@@@@@..@........................@@@@@@@@@@@@@@@@@@@@@.........................@@.@@@@@@@@@@@@
@@@@@@@@.........................@@@@@@@@@@@@@@@@@@@@@....................@.........@@@@@@@@@@@
@@@@@@@@@@@@@..@.................@....@@@@@@@@@@@@@@@@..................@@@.......@@@@@@@@@@@@@
@@@@..@@@..@@.@@.......@@..............@@@@@@@@@@@@@@.............................@@@@@@@@@@@@@
...@....@.@@......@.....@......@...@...@@@@@@@@@@@@@@...@.........................@@@@@@@@@@@@@
@..........@......@@..........@@.@...@.@@@@@@@@@@@@.............................@@@@@@@@@@@@@@@
...........@......@...........@@@.....@@@@@@@@@@@@@.......@..........@.@..@@.....@@@@@@@@@@@@@@
........@.....@...@...........@@@.....@@@@@@@@@@@@..................@...@@@@....@@@@@@@@@@@@@@@
...........@..............@@@..@@.....@@@@@@@@@@@..............@@@.......@@@.....@@@@@@@@@@@@@@
................................@@...@@@@@@@@@@@@@...@@.........@@@.....@@@......@...@@@..@@@@@
@@....@...@.......@@....................@@@@@@@@@@@@@........@@.@@@.@...@@................@@@..
.....................@..........@........@@@@@@@@@....@...........@..@@.@@@@................@..
...................@.@..............@.....@@@@@@@@......@@......@@@@@@@@@@@@...................
...................@@@....................@@@@.@.........@..@@@@@@@@@@@@@@........@@.@.........
...................@@@...................@@@......@........@@@@@@@@@@@@@@@@.....@@@..@........@
.......@@...@@...........................................@@@@@@@@@@@@@@@@@@....@@@@.@@.....@...
..@@@.............@.@..............@@.@..................@@@@@@@@@@@@@@@@@@.@@.@@@@............
..@@@.............@.@..........@...@@@@..............@....@@@@@@@@@@@@@@@@@@@....@............@
.....................@..............@.............@@.....@@@@@@@@@@@@@@@@@@@@..................
.@.@................@...............@.@@........@@@@......@@@@@@@@@@@@@@@@@@@....@.....@@......
........@@@..................@..@...@@@@...@.@@@@@@@........@@@@@@@@@@@@@@@@...........@@@@....
@..@.....@@@@.....@.....@@@@@@@.....@@.......@@@@@@@.....@@@@@@@@@@@@@@@@@@@...........@@@@@...
@......@@@@@..........@..@@@@@@....@@........@@@@@@@.....@@@@@@@@@@@@@@@@@@@@...........@@@@...
@.......@@@@..........@@@@@@@@..............@@@@@@@@....@@@@@@@@@@@@@@@@@@@@@...@..........@..@
@........@@@..........@@..@@@@..@...........@@@@@@@@..@..@@@@@@@@@@@@@@@...@@..........@......@
@........@@..............@@@@@@............@@@@@@@@@..@....@@..@@@@@@@........@@...............
..........@@@.....@@.......@@@@@@......@@.@@@@@@@@@@....@......@@@@@@@..@........@.............
..........@..@...@@@....@...@@@@@.....@@@@@@@@@@@@@@...@@......@@@@@@@@@@........@............@
@......@@.....................@@......@@@@@@@@@@@@@@...@..@..@.@@@@@@@@@@.....@.......@.......@
@@@@.........................@@..@@............@.......@.........@@@@@@@@....@@@..@............
@@@....@@........@....@@..@@@@@@@@@@@.........@@.........@....@..@@@@@@@@@........@..@@........
@@@@...@..............@...@.@@@@@@@@@@...@@@....................@@@@@.........@@@@@.......@..@.
@@..@@@@@.....@..............@@@@@@@@@....@@............@.......@@@.@.......@@@@@@@.........@@@
@@..@..........@@@@@@........@@@@@@@@@..............@....................@@@@@@@@@.........@@@@
@@..@........@@@@@@@@...@....@@@@@@@@@..............@@...................@@@@@@@@@@@....@...@@@
@............@@@@@@@.........@@@@@@@@........@......@..@.@..@............@@@@@@@@@@@....@...@@@
.............@@@@@@@.........@@@@@@@@..............@..@@@@@@@@...........@@@@@..@@@@@.......@@@
................@@@..@.......@@@@@@......@............@@@@@@@@@@@@....@@@@@@@@@.@@@@@..@@...@@@
.........@@......@@.........@.@@@@@.....................@@@@@@@@.....@@@.@@@@@...@.....@@...@@@
........@@@...................@@@@@.@.........@@..........@@@@@..@..........@@.......@@@@......
...@@...@@.......@..@...........@............@@........@..@@@@@...@.........@.......@@@@.......
.@.@@@...@...........@........@@@.....@......@@........@@.@.@@.....................@@@@@...@...
...@@@................@..@...@@......@@......@@.........@..................@.......@@@@@@@@@...
...@@..........@@.....@..@@....@@.@..@.......@@..............@@.......@@@....@@...@@@@@@@@@....
@@@@@.................@@.@@@.................@@..........@@...................@.@@@@@@@@@......
@@@@@@....@...........@@.@@..@@..................@@............@....@@..........@@@@@@@@@.@@...
@@@@@.....@....@.............@@.....@...@@.....................@...........@.....@@@@@@@@@@@...
@@@@.....@@@@@@..............@@....@@...@.........................................@@@@@@@@@@@..
@@@@@@......@@...........@..@@@...........@@...................@@.............@....@@@@@@@@....
@@...@@..@@@@@.@@..........@@@@@@.........@....@@@@............@@...@..............@@@@@.@.....
@@@@.....@@@@@@@@..@@......@@@@..........@@....@@@@....@........@@@.@.......@..................
@@@@.....@@@@@@@@@@@@..@....@@.@................@@....@@.................@@....................
@@@@.....@.@@@@@@@@@@............@..............@@...@@@@.......@@..............@..............
@@@@@..@@@.@.......@@..@.........................@..............@......................@.......
@@@@@.@@@.....@..............................@..............@@.......................@@@.......
@@@@@.@...@...@@@.......................................................@............@@@.......
@@@@@@@..@@...@@..@...@................................@@@................@@...@@@...@@....@.@@
@@@@@@@@@@@................@@..@@......................@.@...@.........@@@@@@@@@@@...@@@..@@@@@
@@@@@@@@@@@..................................@..@........@.............@.@@@@@@@@@.@@@@@...@...
@@@@@@@@@@@.......@@.@....@............................@@@.......@.......@@@@@@@@@@@@@@.....@@.
@@@@@@@@@@@@......@@.@...@@...........@@...............................@.@@@@@@@@@@@...........
@@@@@@@@@@@@@@......@@@@@@@@...........@.......@.........................@@@@@@@@@@@...........
@@@@@@@@@@@@@.......@@@@@@................@@@.@@.......@....................@@@@@@@..@........@
@@@@@@@@@@@@...........@@.....@..@.@@.........@@.................@..........@@@@@............@@
@@@@@@@@@@....................@.......@@......@@.........@@@@@@@@@..........@@.@.............@.
@@@@@@@@@@.............................@............@.@@@@@@@@@@@@...................@@....@...
@@@@@@@@@@.................@..............@.........@@@@@@@@@@@@@.@...................@........
@@@@@@@@@@@.......@..@.....@@@@.........@...@......@@@@@@@@@@@@@@...................@.@........
@@@@@@@@..............@...@@@@....................@@@@@@@@@@@@@@@@..@..........@....@.......@..
@@@@@@@@...........@@.....@@@......................@@@@@@@.@@@@@@..@.......@.....@.@@.......@..
@@@@@@@@@.......@.........@@@........................@@@@@.@@@@@@..@......................@..@@
@@@@@@@@@@@......@......@@@@...................@.@...@@@@@...@@@@@@@.....@@@@..............@@@@
@@@@@@@@@@@..............@@@@...@..............@....@@@@@@....@@@@@@@....@@@@..@@@@@...@...@@@@
@@@@@@@@.................@@@...........................@@@.....@@@@@......@@@..@@@@@@@.........
@@@@@@@@......................@................................@@@@@.....@@@@@.@@@@@@@@........
@@@@@@@@.................@..@............@....@...............@@@@@@@@@@@@@@@@@@@@@@@@@..@.....
@@@@@@@@.....@@.........@@@@@........@..@.....................@@@@@@@@@@@@@@@@@@@@@@@@@..@.....
@@@@@@@@@...@...........@@@@@@......@@........@................@@@@@@@@@@@@@@@@@@@@@@@@@.....@@
@@@@@@@@@@..@.........@......@@.....@...........@@.@.@.....@....@@@@@@@@@@@@@@@@@@@@@@@@...@@@@
@@@@@@@@@@@@@..@.@......@@..@@@....@@@@@@@...........@@@.......@@@@@@@@@@@@@@@@@@@@@@@@@@..@@@@
@@@@@@@@@@@@@....@@................@@@@@@@@.........@@@...@....@@@@@@@@@@@@@@@@@@@@@@@@@@@@@@@@
@@@@@@@@@@@@@....................@@@@@....@.........@.........@@.@@@@@@@@@@@@@@@@@@@@@@@@@@@@@@
@@@@@@@@@@@@@..@@...@..@.@@@..@@@@@@@...............@.@@@.........@@@@@@@@@@@@@@@@@@@@@@@@@@@@@
@@@@@@@@@@@@@..@@.........@@@@@@@@@@....................@....@@...@@@@@@@@@@@@@@@@@@@@@@@@@@@@@
@@@@@@@@@@@@@@@@@@.....@.@@@@@@@@@@@....@........@...@..........@@@@@@@@@@@@@@@@@@@@@@@@@@@@@@@
@@@@@@@@@@@@@@@@@@....@@@@@@@@@@@@...@........@..@.....@........@@@@@@@@@@@@@@@@@@@@@@@@@@@@@@@
@@@@@@@@@@@@@@@@@@@@@@@@@@@@@@@@@@.............................@@@@@@@@@@@@@@@@@@@@@@@@@@@@@@@@
@@@@@@@@@@@@@@@@@@@@@@@@@@@@@@@@@@.........................@@..@@@@@@@@@@@@@@@@@@@@@@@@@@@@@@@@
@@@@@@@@@@@@@@@@@@@@@@@@@@@@@@@@@...............@.....@..@@....@@@@@@@@@@@@@@@@@@@@@@@@@@@@@@@@
@@@@@@@@@@@@@@@@@@@@@@@@@@@@@@@@@......@@.....@..........@@.....@@@@@@@@@@@@@@@@@@@@@@@@@@@@@@@
@@@@@@@@@@@@@@@@@@@@@@@@@@@@@@@@@@@@@...............@@....@@....@@@@@@@@@@@@@@@@@@@@@@@@@@@@@@@
@@@@@@@@@@@@@@@@@@@@@@@@@@@@@@@@@@@@@@@........@@@..@@..........@@@@@@@@@@@@@@@@@@@@@@@@@@@@@@@
8
69 73 0
46 82 0
46 85 0
83 27 0
14 19 0
57 44 0
6 40 0
20 39 0

44 21 0
48 48 0
18 69 0
23 3 0
92 26 0
63 47 0
17 42 0
50 20 0
