width 95
height 95
@@@@@@@@...............@@@@@@@@@@@@@@@@@@@......@............@@@@@@@@@@@@@@@@@@@@@@@@@@@@@@@@@@
@@@@@@@......@.........@@@@@@@@@@@@@@@@@@@.....@@...@........@@@@@@@@@@@@@@@@@@@@@@@@@@@@@@@@@@
@@@@@@@@..............@@@@@@@@@@@@..@@@@@......@...........@@@@@@@@@@@@@@@@@@@@@@@@@@@@@@@@@@@@
@..@@@@@...............@@@@@@@@@....@...............@..@...@@@@@@@@@@@@@@@@@@@@@@@@@@@@@@@@@@@@
@..@@@@...@......@.....@@@@@@@@@...................@@......@@@@@@@@@@@@@@@@@@@@@@@@@@@@@@@@@@@@
@..@@@......@...........@@@@@@@.@......@....................@@@@@@@@@@@@@@@@@@@@@@@@@@@@@@@@@@@
..................@.....@@@..@@................@.............@@@@@@@@@@@@@@@@@@@@@@@@@@@@@@@@@@
..............................@..........@...................@@@@@@@@@@@@@@@@@@@@@@@@@@@@@@@@@@
...@................@........................................@@@@@@@@@@@@@@@@@@@@@@@@@@@@@@@@@@
..@@...@@.............@..............@.@......................@@@@@@@@@@@@@@@@@@@@@@@@@@@@@@@@@
..@...@@..............@....................@..................@@@@@@@@@@@@@@@@@@@@@@@@@@@@@@@@@
......@...............@...........................@......@...@@@@@@@@@@@@@@@@@@@@@@@@@@@@@@@@@@
......@@...........@@.....@........@..............@...@@@@@@@@@@@@@@@@@@@@@@@@@@@@@@@@@@@@@@@@@
....@@@..........................@@@.......@........@@@@@@@@@@@@@@@@@@@@@@@@@@@@@@@@@@@@@@@@@@@
......@.........@@@.............@@@.............@...@@@@@@@@@@@@@@@@@@@@@@@@@@@@@@@@@@@@@@@@@@@
......@.....@@.@@@@.............@@...........@.....@@@@@@@@@@@...@@@@@@@@@@@@@@@@@@@@@@@@@@@@@@
............@@@@@@@....@...............@.......@@@...@@@@@@@@@....@@@@@@@@@@@@@@@@@@@@@@@@@@@@@
@@@@@.......@@@@@@...@.@..............@.....@@@@@@...@@@@@@@@@.....@@@@@@@@@@@@@@@@@@@@@@@@@@@@
@@@@@@..@...@@@@@@..........@......@.....@..@@@@@@@.@@@@@@@@@@@....@@@@@@@@@@@@@@@@@@@@@@@@@@@@
@@@@@@@......@....................@.........@@@@@@@@@@@@@@@@........@@@@@@@@@@@@@@@@@@@@@@@@@@@
@@@@@@@..@..................@@.................@@@@@@@@@@@@@........@@@@@@@@@@@@@@@@@@@@@@@@@@@
@@@@@@@..........@...........@..@..............@@@@@@@@@@@@@........@@@@@@@@@@...@@@@@@@@@@@@@@
@@@@@@....@@...................................@@@@@@@@@@@@@........@@@@@@@@@@@..@@@@@@@@@@@@@@
@@@@@....@@@..........@......@.@.........@@.......@@@@@........@.....@@@...@....@@@@@@@@@@@@@@@
@@@@@..@@................@@@...@.@...@@@@@@......@@@@@@.........@........@......@@@@@...@@@@@@@
@@@@...@@@@@@@..@@...@........@@.....@@@@@@@.....@@@@@@@.................@.......@@@....@@@@@@@
.........@@@@@..@@...................@@@@@@@.....@@@@@@.....@...@@........@....@.@@.....@@@@@@@
.....@......@...@@.@@.............@....@@@@@....@@@@@@@..................@@....@@@@.....@@@@@@@
.......................@............@@..@@@@....@@@@@@@...................@....@@@.........@@@@
...........@............................@@@@...@@@@@@@@..@.@....@@.............@@..........@...
........@@.........@....@@.............@@@@@@@....@@@@@....@...@@@......@......@@..............
...@.....................@...........@..@@@@@@.......@@..@....@@@@..@@..@..@..@@@..............
.................@@@@...@@.........@@@.@@@@@@@...@.....@@@.....@@@.....@@@....@@........@@@.@..
@@...@@@@@..............@.........@@@@@@@@@@.......@...@@@@...@@@@.....@@@....@..@@@...........
.@...................@@@....@.....@@@@@@@@@@................@@@@@@.....@....@@@@@@@..@@@.......
..............@....@@@@@@.........@@@@@@@@..................@@@@@@..........@@.......@@........
...................@@@@@@@..........@@@@.........@......@....@@@@@.............................
....@@..@.......@......@@@..........@.@@@...............@.....@@@@@...@............@....@......
@@..@.@.@...................@@........@@........@..@@@@........@@@...@@.........@..............
@.....@.............@.................@@..@@...@...@@@@@...................@..........@........
............@.@@@....@..............@@@@...........@@@.@...@@..@@................@@.@.....@@@.@
......@.......@@@@@............@@...................@..@...@..............@@@...@@@.@@......@@.
..............@@@@@...................@................@...@.............@@@@@.@@@@..@.@.......
.............@@@@@@.....................@@.............@.......@@..@...@@@@@@@.@@@.............
.............@@@@@@........@@...........@@.........@..........@@@.......@@@....@@@@@........@.@
......@@@@..@@@@@@@@..........@.......@.............@@.........@@..............@@@@@@......@@.@
...@...@@@..@@@@@@@@........@@...@@.................@@.........@@....@.........@@@..@...@@@@@@@
.......@@@@@@@@@@@@@..@..........@@.................@.@....@@.......@@@.@.....@.........@@@@@@@
.......@@@@@@@@@@@@@.............@@@................@................@@@@....@@@........@@@@@@@
........@@@@@@@.@@@@.....@@.......................@@@..@@............@@@@@...@.......@..@@@@@@@
.@....@@@@@@@@@...@@@...@...@@@.@...................@.@@@@.............@@@...........@..@@@@@@@
@@@...@@@@@@@...@@@@@...@....@@................@......@@@@.......@..........@@.......@.@@@@@@@@
@@@@...@@@@@@...@@@@....@.....@@@@@............@@@.....@@@......@@@.........@@......@@@@@@@@@@@
@@@@.....@@........@..........@@@@.............@@@@@....@@@@.@..@@@.........@@......@@@@@@@@@@@
@@@@@..@..@.....................@.......@.......@@@@....@@@@@@....@@.........@...@@.@@@@@@@@@@@
@@@@@@.......@..........................................@@@@@@@..............@@..@@@@@@@@@@@@@@
@@@@@..............@@...................................@@@@@@@......@@..@.......@@@@@@@@@@@@@@
@@@.................@@..@@@...........@....................@@@@....@....@........@@@@@@@@@@@@@@
@......@........@...@@@.@..................................@@@@@...@@............@@@@@@@@@@@@@@
....@..@..@@....@...@...........@@@.....@@@....@@@.@@@@....@@@@@..............@..@@@....@@@@@@@
.....@....@@@@.............@.....@@...................@................@......@..@@@....@@@@@@@
@@.@......@@@@...................@...@................................@...@@@@@.@@@@....@@@@@@@
@@@@.@..@..@@@.......................@....................................@@@@..@@@.....@@@@@@@
@@.........@@@...@.......@.....@.....................@@..@........@.............@@@@...@@@@@@@@
@.........@@@@@..@@.........................@@.....@@@@@@@...@@......@..........@@@@...@@@@@@@@
@.......@@@@@..............@....@.........@.......@@@@@@@......................@@@.....@@@@@@@@
@@....@@@@@@....................@.................@@@@@@@@....@.........@....@@@@@.....@@@@@@@@
.@.....@@@@@.......................@....@....@@.....@@@@@....................@........@@@@@@@@@
...@....@@@.................................@@@......@@@@.......@@....................@@@@@@@@@
........@@@.........@...............@.......@.@.............@...@.....................@@@@@@@@@
......@@..@........@@@.............@@@....................@.@@@...........@@......@@@@@@@@@@@@@
....@@@............@@..............@@@@@@..............@@...........@..@......@@@@@@@@@@@@@@@@@
@....@......................@..........@...............@...@@@@...............@@@@@@@@@@@@@@@@@
@.....@.................@............@@@@..................@@@@.@.........@....@@@@@@@@@@@@@@@@
@@............@................@......@@@...................@@@@@.@...@...@@...@@@@@@@@@@@@@@@@
@............@................@.......@.@.......................@@@@...@.......@@@@@@@@@@@@@@@@
..........@@@@@.................@..........@@....@.@............@@@@@..@.....@.@@@@@@@@@@@@@@@@
........@.....@............@............................@.@@.....@@@.@......@..@@@@@@@@@@@@@@@@
............@@@@...@.......................................@.....@@@......@....@@@@@@@@@@@@@@@@
....@@@.....@......@...................@@.................@@................@@@@@@@@@@@@@@@@@@@
......@@@.....@@............@............@@@................@...............@@@@@@@@@@@@@@@@@@@
........@............................@@..@@...............@..........@....@@@@@@@@@@@@@@@@@@@@@
.....@..@@...........................@@.......@@....@.....@......@...@...@@@@@@@@@@@@@@@@@@@@@@
....@@@....................@..................@@@@@@@@...@@@.........@@@@@@@@@@@@@@@@@@@@@@@@@@
..@..@@..@....@@@.@.....@.................@@@@@@@@@@@@@@.@@@.........@@@@@@@@@@@@@@@@@@@@@@@@@@
..@@@@@........@@@@...................@@.@@@@@@@@@@@@@@@@@@@....@@@..@@@@@@@@@@@@@@@@@@@@@@@@@@
@.@@.@........@@@@@@@@...@................@@@@@@@@@@@@@@@@@....@@@@@@@@@@@@@@@@@@@@@@@@@@@@@@@@
..............@@@@@@@@@@@@..........@.......@@@@@@@@@@@@@@@..@.@...@@@@@@@@@@@@@@@@@@@@@@@@@@@@
......@.......@@@@@@@@@@@....@.....@@.......@@@@@@@@@@@@@@@@.......@@@@@@@@@@@@@@@@@@@@@@@@@@@@
..............@@@@@@@@@@@...................@@@@@@@@@@@@@@@@.......@@@@@@@@@@@@@@@@@@@@@@@@@@@@
..............@@@@..............@............@.@@@@@@@@@@@@@..@...@@@@@@@@@@@@@@@@@@@@@@@@@@@@@
.....@........@@.........................@.....@@@@@@@@@@@@@@@@@.@@@@@@@@@@@@@@@@@@@@@@@@@@@@@@
.........@...................................@@@@@@@@@@@@@@@@@@@@@@@@@@@@@@@@@@@@@@@@@@@@@@@@@@
.........@.@.....@...........@..............@@@@@@@@@@@@@@@@@@@@@@@@@@@@@@@@@@@@@@@@@@@@@@@@@@@
...........@@..@@@..@@@......@.....@.@.....@@@@@@@@@@@@@@@@@@@@@@@@@@@@@@@@@@@@@@@@@@@@@@@@@@@@
8
10 24 0
23 94 0
33 28 0
45 36 0
38 16 0
5 24 0
5 44 0
24 48 0

72 72 0
21 81 0
32 72 0
38 89 0
60 83 0
85 68 0
57 26 0
40 70 0
