width 35
height 35
@....@@@.......@@@@@.@@@@@@@@@@@@@@
.....@@......@.@@@@..@@@@@@@@@@@@@@
.....@@.........@.....@@@@@@@@@@@@@
..@......................@@@@.@@@@@
....................@.....@@@.@@@@@
...........................@@.@@@@@
...@@@@@................@.....@@@@@
......@@...@....................@@@
.....@@@...@....................@@@
....@@@@@@@@.........@...........@@
....@@@@@@@..............@.......@@
.........................@.........
.@...........@...........@@.@......
..................@....@...........
...................................
@......@@....@@.......@.@..........
@@.@@..@@.......@.....@.@..@.......
@@@@@.@@@.............@@@..@..@@@..
@@@@@.@@@....@................@@@..
@@@@@.@@@@...@..@............@@@@..
@@@@@@@@@@@..........@......@@@@@..
@@@@@@@@@@@.................@@@@@@@
@@@@@@@@@@@.................@@@@@@@
@@@@@@@@@@@.................@@@@@@@
@@@@@@@@@@..@...@..@..........@@@@@
@@@@@@@@@@..@...@@@@..............@
@@@@@@@@@@@@@...@@@...............@
@@@@@@@@@@@@@.....................@
@@@@@@@@@@@@.............@....@....
@@@@@@@@@@....@..........@.....@@..
@@@@@@@@@@@@@@@@.........@@..@.....
@@@@@@@@@@@@@@....@..@.............
@@@@@@@@@@@@@@@@.@.....@...@@.@@...
@@@@@@@@@@@@@@@@@@@..@@@@..@@@@@@@.
@@@@@@@@@@@@@@@@@@@..@@@@@.@@@@@@@@
8
3 7 0
10 2 0
3 4 0
29 6 0
5 7 0
34 30 0
27 9 0
4 1 0

0 9 0
32 28 0
34 32 0
3 4 0
4 12 0
4 14 0
30 16 0
32 14 0
