width 35
height 35
@@@@@@@@@@@@@@@@..@@@@@@@@@@@@@@@@@
@@@@@@@@@@@@@@@..@@@@@@@@@@@@@@@@@@
@@@@@@@@@@@@@@@...@@@@@@@@@@@@@@@@@
@@@@@@@@@@@@@.@@..@@@@@@@@@@@@@@@@@
@@@@@@@@@@@@@..@..@....@@@@@@@@...@
@@@@@@@@@@@@@.....@@@..@@@@@@@....@
@@@@@@@@@@@@@.......@..@@@@@@...@@@
@@@@@@@@@@@@@..........@@@@@@...@@@
@.....@@@@@...@@.......@@@@@@..@@@@
.......@@@....@..@...@@@@......@@.@
.......@@............@@........@@..
.....................@@........@@..
.....................@@.@@@........
....@.................@............
..............................@.@@@
......@...@..................@@.@@@
..@...@..@@............@.@@@..@@@@@
@@....@@@@@@...........@@@@@@@@@@@@
@@...@.@@..@..........@@@@@@@@@@@@@
@....................@@@@@@@@@@@@@@
.....................@@@@@@@@@@@@@@
.@..............@@@@@@@@@@@@@@@@@@@
........@.......@@@@@@@@@@@@@@@@@@@
@.......@....@@@@@@@@@...@@@@@@@@@@
..............@@@@@@......@@@@@@@@@
..............@@@@@.......@@@@@@@@@
..............@@@@........@@@@@@@@@
...@..........@@.@.....@..@@@@@@@@@
...........@...@.......@@...@@@@@@@
.............@.............@@@@@@@@
............@@.............@.@@@@@@
@...........@........@.......@@@@@@
@...........@@.................@@@@
.........@@@@@.................@@@@
@@@......@@@@.....@@@..........@@@@
8
27 12 0
34 12 0
5 16 0
1 26 0
9 15 0
8 33 0
6 25 0
24 32 0

5 33 0
30 34 0
6 13 0
29 12 0
9 12 0
14 12 0
20 4 0
13 9 0
