width 35
height 35
@@@@@@@@@@@@@@@@@@@@@@@@..@.....@@@
@@@@@@@@@@@@@@@@@@@@@@@...........@
@@@@@@@@@@@@@@@@@@@@@@@...........@
@@@@@@@@@@@@@@@@@@@@@@@..........@@
@@@@@@@@@@@@@@@@@@@@@@@@...........
@@@@@@.@@@@@@@@@@@@@@@@@@.........@
@@@@@@..@@@@@@@@@@@@@@@@@..@....@@@
..........@@@@@@@@@@@@@@@@@.@......
..........@@@@@@@@@@@@@@@.@........
..........@@@@@@@@@@@@@@@..........
.........@@@@@@@@@@@@@@@@.........@
.....@...@@@@@@@@@@@@@@@..........@
@@.......@@@@@@@@@@@@@@@.......@.@@
@.......@@@@@@@@@@@@@@@.......@@@@@
@.......@@@.@@@@@@..@@......@@@@@@@
.............@..............@@@@@@@
................@............@@@@@@
.....................@........@@@@@
....@.........@......@........@@@@@
...@@@@......................@@@@@@
....................@..........@@@@
...................@........@@@@@@@
.................@.@.......@@...@..
.................@....@...........@
............................@......
@@.................@.......@@.@....
@@.@@@.................@...........
@@.@@@...@...@.@.......@....@.@..@@
............@@@@@...........@@@@@@@
....@@........@.............@@@@@@@
...@@...........@...........@@@@@@@
....@....@..................@@@@@@@
........@@......@............@@@@@@
........@@@@.......@.@.......@@@@@@
..@...@.@@@@....@..@@@..@@.@@@@@@@@
8
9 9 0
0 16 0
29 23 0
3 13 0
27 33 0
25 19 0
5 20 0
16 33 0

24 13 0
29 10 0
10 21 0
26 28 0
26 3 0
24 20 0
32 8 0
31 7 0
