width 35
height 35
.@@@@@@@@@@@@@@@@@@@@@@@@@@@@@@@@@@
..@@@@@@@@@@@@@@@@@@@@@@@@@@@@@@@@@
..@@@@@@@@@@@@@@@@@@@@@@@@@@@@@@@@@
...@@@@@@@@@@@@@@@@@@@@@@@@@@@@@@@@
....@@@@@@@@@@@@@@@@@@@@@@@@@@@@@@@
.....@@@@@@@@@@@@@@@@@@@@@@@@@@@@@@
.@...@@@@@@@@@@@@@@@@@@.@@@@@@@@@@@
.....@@@@@@@@@@@@@@@@@...@@@@@@@@@@
......@@@@@@@@@@@@@@@........@@@@@@
@......@@@@@@@@@@@@@@........@@@@@@
@......@@@@@@@@@@@@......@@@@@@@@@@
@....@.@@@@@@@@@@........@@@@@@@@@@
.......@@@@@@@@@@........@@@@@@@@@@
.........@@@..@@@@@......@@@@@@@@@@
.........@@@...@@..........@@@@@@@@
..........@...............@@@@@@@@@
....@.............@......@@@@@@@@@@
...........................@@@@@@@@
.........@@....@.@@@@......@@@@@@@@
.......@.@@....@..........@@@@@@@@@
.......@.@@....@@......@.@@@..@@@@@
..@@.....@@@..@..........@@@..@.@@@
......@@@@@@.................@...@@
.....@@@@@@.....................@@@
.@@@..@.@...........@.........@@@@@
@@@@...........@............@....@@
.................................@@
.....@...@@...@.@@.........@.....@@
@.@@@@...........@................@
@.@@..............................@
@..@..................@...........@
...........@..................@@@@@
....@@.....@............@...@@@@@@@
@@@.@@.....@......@....@@@@@@@@@@@@
@@@..@.....@@..@...@..@@@@@@@@@@@@@
8
6 19 0
7 27 0
26 27 0
3 4 0
17 29 0
29 25 0
4 17 0
5 16 0

33 29 0
28 8 0
7 14 0
1 18 0
24 24 0
4 13 0
6 16 0
32 30 0
