width 20
height 25
........@...........
............@.......
@.@.................
..............@...@.
..@.@...............
....................
......@.............
.....@...........@..
....................
.....@..@..@..@@....
..................@.
@@....@.............
@@..................
@@...@..............
.......@.@...@...@..
......@.......@.....
..................@@
.....@....@......@@@
..............@.....
......@.............
....@..@.......@....
...@................
...............@@@..
.........@....@@@@..
...........@.@@@@@@.
6
6 21 0
7 6 0
10 23 0
17 10 1
18 8 1
19 7 1

2 21 0
10 4 0
17 21 0
18 15 1
12 10 1
10 6 1
