width 20
height 25
....................
.........@.....@....
....................
..@.......@....@....
.................@..
......@....@........
@@...........@.....@
@@................@@
@@......@....@....@@
..........@.......@@
...@..@...........@@
............@..@..@@
...............@...@
...@.........@......
......@.......@.....
...@................
.@@...@.....@.@.@...
..@............@...@
.......@............
.........@.....@....
................@...
@...................
@.@@@......@.@.@....
@@@@@...............
@@@@@.@@@...........
6
0 10 0
15 15 0
16 6 0
1 1 1
11 3 1
7 10 1

16 4 0
2 0 0
6 12 0
19 4 1
16 1 1
15 24 1
