width 20
height 25
@.................@.
@@..................
@@...........@......
....@...@...........
....................
.@.......@..@.......
....@...............
...@................
..........@...@.....
....................
.....@.@............
................@..@
............@.....@.
.@..................
..............@.@...
@........@..........
..@.@......@........
......@.......@.....
..........@.....@.@.
......@.............
............@.......
@@.........@........
@...@....@..........
......@.............
.......@@..........@
6
3 0 0
13 21 0
4 10 0
2 18 1
8 1 1
8 5 1

3 17 0
13 20 0
10 21 0
17 4 1
10 19 1
3 5 1
