width 20
height 25
@..............@....
@......@...@@......@
....@.........@.....
....................
....................
....@.....@........@
@..........@...@..@@
.......@......@....@
..@................@
.....@@..@..........
@@.....@..@.........
@@...............@..
@.........@@........
@..........@........
.......@..........@.
..@.................
......@.............
.@...@.@......@.....
.........@...@......
..@...........@.....
.....@..............
@@.......@..@.......
@@@.............@...
@@@.................
@@@......@.........@
6
15 2 0
16 11 0
16 0 0
17 22 1
15 22 1
9 0 1

3 19 0
1 0 0
14 9 0
19 16 1
13 0 1
16 8 1
