width 20
height 25
....@...............
....................
........@....@......
....................
....................
....@.....@.........
..@.................
....................
......@.........@...
............@......@
......@...@....@....
.@.....@...@........
.............@......
........@...@.......
...................@
.................@@@
.@@@....@..@.....@@@
.................@@@
..@..............@@@
........@..@.....@..
....................
.............@......
........@.....@....@
..@...@.............
......@.....@@......
6
17 21 0
11 9 0
3 6 0
6 21 1
16 23 1
3 3 1

2 3 0
11 8 0
0 13 0
6 4 1
16 16 1
14 23 1
