width 20
height 25
...@@...............
....................
.....@...........@..
.............@....@.
....@..@..@.........
.............@......
.............@..@...
......@......@...@..
.......@...@.@......
..@...........@.....
........@...........
..@...@.@...........
.............@......
..................@.
....................
..@.....@....@......
.................@..
................@...
..@................@
.................@.@
.....@...........@..
........@...........
....................
.....@............@.
@..@.@@.....@@......
6
12 17 0
15 12 0
5 1 0
3 2 1
4 17 1
9 0 1

4 2 0
10 15 0
19 23 0
7 2 1
12 13 1
0 17 1
