width 20
height 25
...@................
.....@..@.@....@....
.......@............
.@.........@..@.....
....................
..................@.
@........@......@...
...@................
.......@............
@..........@.@......
@...................
..............@.....
.@.@........@..@.@..
...........@........
..@..@..............
.......@.....@...@..
....................
......@.............
.@.....@....@.@.....
................@@..
................@...
...@....@......@...@
...................@
......@.............
..@.................
6
0 11 0
11 17 0
13 8 0
10 21 1
2 3 1
3 5 1

15 3 0
11 6 0
3 4 0
7 10 1
16 14 1
15 17 1
