width 20
height 28
..............@.....
...@.........@......
.........@.@........
....@...............
..@.....@........@..
.....@......@.......
........@...........
...@...........@.@..
..........@.....@...
......@..@..........
............@......@
.........@..@......@
........@...@..@...@
......@......@..@...
.....@..............
........@..@...@....
...@................
....@...............
................@...
.@....@.@.@.....@...
..@.................
..........@........@
......@.......@@....
....@........@@.....
..@.................
.........@.........@
..@..........@@...@@
@............@@....@
6
1 6 0
7 3 0
19 14 0
14 4 1
17 15 1
8 0 1

17 27 0
10 23 0
5 8 0
17 1 1
1 15 1
8 0 1
