width 20
height 28
.....@..@@@@........
........@@@@........
....@...............
............@.......
.....@.........@.@..
.........@..........
.................@..
..@..............@..
.@....@....@....@...
..............@..@..
@...@...@......@....
......@.....@.......
....................
...@.........@...@..
..............@.....
....@..@...@...@....
........@...@.@.@...
..@................@
....@.@.@.....@....@
............@..@.@@@
@..@................
........@...........
.@.@..........@...@.
.......@..@......@..
...@................
.....@.......@......
.............@......
..@.................
6
16 10 0
10 24 0
10 19 0
10 21 1
7 7 1
9 22 1

7 27 0
16 4 0
8 22 0
18 2 1
19 27 1
2 4 1
