width 20
height 28
@@..................
@...................
@........@.@........
....................
...@..........@..@..
@.......@...........
@......@............
@........@..........
...@................
..........@......@..
.............@......
.@.......@....@.....
...............@....
......@....@........
..@..@..............
....@.......@...@...
@.......@...........
@@..@.....@...@.....
....................
....@...............
.............@......
..@....@.@........@.
@@...@........@.@...
@@...........@@@@@@@
@.........@@...@@@@@
@.........@....@@@@@
................@@@@
.......@........@@@@
6
8 20 0
19 10 0
15 17 0
13 22 1
4 10 1
14 1 1

16 0 0
13 8 0
5 24 0
3 18 1
7 19 1
19 10 1
