width 20
height 28
...@................
......@.............
....................
....................
....................
.@....@.@........@..
...@.......@....@...
....@........@.@....
.....@..............
.................@..
................@...
...........@........
...@.@...@..........
.................@..
.......@.....@......
...@......@.@......@
@................@@@
.@....@.........@.@@
........@...........
..@......@.........@
....................
...............@....
............@......@
....................
......@....@.@.@...@
...@......@........@
@@..............@@@@
@@@@............@@@@
6
3 3 0
4 16 0
0 25 0
11 18 1
9 25 1
12 21 1

0 9 0
4 17 0
11 25 0
0 5 1
18 5 1
5 0 1
