width 20
height 28
..................@@
.........@.....@..@@
...@................
.........@.@...@....
.....@..............
........@...........
.....@.......@.@....
....................
@...@...............
.....@....@.........
.@.....@............
@....@.@....@....@..
@@.............@....
@...............@...
@........@..........
........@...........
..@......@..@.@.....
....@........@.@....
@..................@
@@.....@..@..@.....@
@...................
@...................
....@....@..........
........@...........
...........@.@@.....
.@..................
......@.............
..........@.......@@
6
11 19 0
7 2 0
11 0 0
2 8 1
8 20 1
5 21 1

3 9 0
6 13 0
11 0 0
1 1 1
1 26 1
16 0 1
