width 20
height 28
...@....@@..........
...................@
....@.......@...@..@
.@.@..@.@@..........
.............@......
.......@..........@.
..@..@...........@..
....@...............
....................
....................
..@...@.............
....................
......@.............
..........@.@.@.....
................@...
.....@........@.....
....@........@......
.@.....@.........@..
.....@..............
....................
...@....@....@......
@....@....@.......@.
@...................
.......@.@...@......
...............@....
..@.................
...@......@.........
....................
6
7 1 0
14 6 0
8 14 0
0 6 1
4 14 1
8 15 1

19 27 0
15 16 0
6 14 0
1 12 1
12 8 1
16 0 1
