width 42
height 42
@@@@@@@@@@........@.....@@.....@@@@@@@@@@@
@@@@@@@@.@@.............@......@@@@@@@@@@@
@@@@@@..................@......@@@@@@@@@@@
@@@@@@.........@@@.............@@@@@@@@@@@
@@@@@@@.@................@....@@@@@@@@@@@@
@@@@@.................@@@@@@...@@@@@@@@@@@
@.....@...............@@@@@@@..@@@@@@@@@@@
@..@.................@@@@@@@@@@@@@@@@@@@@@
@@@.........@.............@@@@@@@@@@@@@@@@
@@@......@.@@.............@@@@@@@@@@@@@@@@
@@@..........@...@@....@..@@@@@@@@@@@@@@@@
@@@@.........@@...........@@@@@@@@@@@@@@@@
@@@@.......................@@@@@@@@@@@@@@@
@@@...@@.....................@@@@..@@@@@@@
@@@...@@@@@...........@.......@@...@@@@@@@
@@@@@..@@@@...@.......@@............@@@@@@
@@@@@...@@@...@.............@@.......@@@@@
@@@@@@..@........@@..................@@@@@
@@@@@@@..............................@@@@@
@@@@@@@@.@..........@..............@....@@
@@@@@@@...........@.................@@..@@
@@@@@@@.............@.....@@.@...@......@@
@...@...............@@....@@............@@
@...................@...............@@@@@@
@.................................@@@@@@@@
......@............................@@@@@@@
..@@...............@.............@.@@@@@@@
..@@...............@@..@......@....@@@@@@@
........@.....................@...@@@@@@@@
@.......@@.....@@@@...........@.@@@@@@@@@@
@.......@.......@@@..........@@@@@@@@@@@@@
@..........@....@.@..@......@@@@@@@@@@@@@@
@...................@@.....@@@@@@@@@@@@@@@
....@..@............@@..@..@@@@@@@@@@@@@@@
.......@@...........@@..@..@@@@@@@@@@@@@@@
@..@...@@.@.........@@..@...@@@@@@@@@@@@@@
@...@@@@................@@@@@@@@@@@@@@@@@@
@...@@@@@.........@@@....@@@@@@@@@@@@@@@@@
@.....@@@@@.....@@@@.....@@@@@@@@@@@@@@@@@
@.......@@......@@@@@..@@@@@@@@@@@@@@@@@@@
@@@@........@@..@@@@@.....@@@@@@@@@@@@@@@@
@@@.......@@@@..@@@@@.....@@@@@@@@@@@@@@@@
8
5 31 0
23 30 0
25 21 0
6 16 0
26 30 0
19 11 0
19 4 0
11 32 0

4 28 0
5 8 0
21 36 0
7 16 0
1 6 0
10 36 0
1 33 0
24 19 0
