width 42
height 42
@....@....@@@@@@@@@@@@@@@@@@@@@@@@@@@@@@@@
.....@......@@@@@@@@@@@@@@@@@@@@@@@@@@@@@@
............@@@@@@@@@@@@@@@@@@@@@@@@@@@@@@
............@@@@@@@@@@@@@@@@@@@@@@@@@@@@@@
..@........@@@@@@@@@@@@@@@@@@@@@@@@@@@@@@@
....@.....@@@@@@@@@@@@@@@@@@@@@@@@@@@@@@@@
...@@........@@@@@@@@@@@@@@@@@@@@@@@@@@@@@
@@..........@@@@@@@@@@@@@@@@@@@@@@@.@@@@@@
............@@@@@@@@@@@@@@@@@@@@@@...@@@@@
...@@@..........@@@@@@@@@@@@@@@@@@..@@@@@@
...@..@@.....@.....@@@@@@@@@@@@@@...@@@@@@
........................@@@.@.......@@@@@@
......@@@................@...........@@@@@
.......@@................@............@@@@
..................@@...................@@@
................@@@@......@......@.....@@@
@@....@..@.......@@@@................@@@@@
...@..@..@..........@@.........@...@..@@@@
.....................@.........@@@@@.@@@@@
.....................@...........@..@@@@@@
....................................@@@@@@
@...@..@.......@@.............@@@.@@@@@@@@
@@.....@.@@@.@.@@@@@........@@@@@@@@@@@@@@
.........@@@@@.@@@@@@.....@@@@@@@@@@@@@@@@
.........@@@@@..@@@...........@...@@@@@@@@
..@.....@@@@@@..@@................@@@@@@@@
..........@.@...@@...............@@@@@@@@@
................@@@@@............@@@@@@@@@
.......................@..........@@@@@@@@
...........................@@.@.....@@@@@@
.....@@..............................@@@..
.........................@...........@@...
......@....................@.@.....@@@@...
.............@..@@@.........@@@@@....@@...
.......@@@@@....@@...........@@@@........@
.@....@@@@..........@.@........@...@......
@@..@@@@@@.@@@.....@@@@.......@...@@......
@@.@@@@@@@.@@.......@@........@...........
@@@@@@@@@@@@@@......@@........@.....@@@@..
@@@@@@@@@@@@@@@....@@@@.............@@@@@.
@@@@@@@@@@@@@@@....@@@@...........@@@@@@@.
@@@@@@@@@@@@@@@....@@@...........@@@@@@@@@
8
27 38 0
23 24 0
23 18 0
4 14 0
16 17 0
2 9 0
32 38 0
12 34 0

19 33 0
8 17 0
23 21 0
21 29 0
13 14 0
4 11 0
24 25 0
21 11 0
