width 42
height 42
@@@@@..@@@..@@@@@..@@.......@@@@@@@@@@@@@@
@@@@@@......@@@@@..........@@@@@@@@@@@@@@@
@@@.............@...........@@@@@@@@@@@@@@
@@....@.....................@.@@..@@@@@@@@
.......@.@....@........@@...........@@@@@@
@@@.........@......................@.@@@@@
@@@@@...........@@.@@.............@@..@@@@
@@@@@...@....@@@@...@.........@........@@.
@@@@.........@@...........................
@@@..@@@.....@@.@.........................
@@@...@@@.....@@@.............@...........
@.....@@@................@................
......@@@..@...........................@..
......@@@..........@......................
..@...@...................................
..@@..@@..@......@....@..........@...@....
..........@.@...................@@...@....
...................@@@@@@........@@@....@@
@@@@...........@....@@@......@....@.....@@
@@@@@.....@......@..@@....................
@@@..........@............................
@@.........@...@@.........@..............@
...............@@.......@.@@...@.........@
........@@....@@@@........................
.................@..@..........@..........
@................@@.......................
...............@@@@@.....................@
...............@@@@@......................
@.......@......@@@@@@@..............@@@@..
.........@@@@..@......@..........@.@@@....
............@..@...........@.......@@@@...
..................................@.@@@@@.
.@@@...............@................@@@@@@
.@@@.........................@@....@@@@@@@
@@@@..@...........@...........@......@@@@@
@@@...@@@.........@....@.............@@@@@
@@@@....@....@....................@@@@@@@@
.........@..........@@@@........@@@@@@@@@@
.........@.....@@..@@@@@....@@@@@@@@@@@@@@
.............@@@@..@@@@......@@@@@@@@@@@@@
...@........@@@@@@@@@@@@.....@@@@@@@@@@@@@
@@....@...@@@@@@@@@@@@@@@..@@@@@@@@@@@@@@@
8
25 9 0
16 19 0
28 26 0
18 21 0
32 3 0
22 7 0
8 29 0
7 22 0

15 14 0
41 31 0
5 0 0
25 38 0
31 23 0
5 27 0
15 6 0
9 28 0
