width 42
height 42
@@@@@@@@@@@@@@@@@@@@@@@@@@@@@@@@@@@@@@@@@@
@@@@@@@@@@@@@@@@@@@@@@@@@@@@@@@@@@@@@@@@@@
@@@@@@@@@@@@@@@@@@@@@@@@@@@@@@@@@@@@@@@@@@
@@@@@@@@@@@@@@@@@@@@@@@@@@@@@@@@....@@@@@@
@@@@@@@@@@@@@@@@@@@@@@@@@@@@@@@@....@...@@
@@@@@@@@@@@@@@@@@@@@@@@@@@@@@@@@....@.....
@@@@@@@@@@@@@@@@@@@@@@@@@@@@@.@.....@.@...
@@@@@@@@@@@@@@@@@@@@@@@@@@@@@.@.....@.....
@@@@@@@@@@@@@@@@@@@@@@@@@@@@..@.....@.....
.@....@.@.@@@@@@@@@@@@@@@@@...@...........
..........@@..@.@@@@@@@@@@................
.......@..@@@.....@@.@@@@@.....@..........
.....@@@@.@@@......@.....................@
...................@.....@..@@............
..............@..@..........@@.@..@.......
..........@....................@.@........
@.........@@.....................@@@....@@
@@@@@.@..............@..........@.@@....@@
@@....@.@@..........@...........@.....@@@@
..@...........................@......@@@@@
...@......@@.........................@@@@@
.........@........@......@..........@@.@@@
..@@@@......@.....@...............@.@..@@@
@@@@@@@..........................@@....@@@
@@@@@@@@............................@..@@@
@@@@@@@@@.....................@........@@@
@@@@@@@@@...........@@........@.......@@@@
@@@@@@@@@@...@...@..@@..@....@@......@@@@@
@@@@@@@@.....@..@...@@........@......@@@@@
@@@@@......@@@@.....@.........@@@@@....@@@
@@@@.....@..........@.......@@@@@@@@@....@
@@@@@..................@@......@@@@@@....@
@@@@@...@..@............@......@@@@@@....@
@@@.@...................@......@@@@@@@@..@
...........@.................@.@@@@@@@@...
.@.....................@.......@@@@@@@..@@
@@@..@...........@@@@@...@.......@@@@@@@@@
@@@@.....@.@....@@@@@@@@.....@....@@@@@@@@
@@@@@@@@@@@@....@@@@@............@@@@@@@@@
@@@@@@@@@@.......@@@@@@........@.@@@@@@@@@
@@@@@@@@@@.....@@@@@@@@@@@@.......@@@@@@@@
@@@@@@@@@@.......@@@@@@@@@@@@....@@@@@@@@@
8
30 34 0
25 35 0
7 10 0
13 34 0
15 27 0
38 35 0
35 25 0
22 32 0

23 32 0
37 14 0
39 35 0
11 36 0
17 15 0
4 15 0
16 41 0
23 24 0
