width 42
height 42
@@@@.....@@@@@@@...........@@.@@@@........
@@@@@..@@@@@@@@@...........@@.............
@@@@...@...@@@@@@........@@@....@.........
@@@@...@...@@@@@..........................
@@@@.......@.@@........@........@.........
@@@.....@.....@..................@@@@@....
@@@@@.................@..........@@@@@@@..
@@@@......@@@@.......@@....@....@@@@@@@@@@
@@.........@@........@@.........@@@@@@@@@@
@@.....@.............@@.........@@@@@@@@@@
@@.....@...@@.......@@.........@@@@@@@@@@@
@@.....@...@@@.....@@@...........@@@@@@@@@
@@@......@.@@...@@@@@...........@@@@@@@@@@
@@@.@.........@@@@@@@...........@@@@@@@@@@
@...........@@@@@@@.............@@@@@@@@@@
@.............@@@@@@@...........@@@@@@@@@@
........@.@...@@@@@@@............@@@@@@@@@
........@@....@@@@@@@@..@.........@@@@@@@@
........@@@...@@@@@@@@........@...@@@@@@@@
....@@..@@@...@@@@.@@@...........@@@@@@@@@
..............@@@@.@@@.@@......@...@@@@@@@
@..................@@@@@@.......@......@@@
@@@..........@@.....@@@@@..@@@.....@...@@@
@@.......@@@@@@.....@@@@@..@@@..........@@
....@@.....@@@......@@@@@..@@@.....@@@@@@@
....@@@.....@@@@....@@@@@..@@.@....@@@@@@@
@........@....@@.....@@@@.....@....@@@@@@@
@...@..........@@....@@@.@@@......@@@@@@@@
@@@.................@@@@..........@@@@@@@@
@@......@@..@@...............@.@@.@@@@@@@@
........@@......................@@@@@@@@@@
....@@.........@@................@@@....@@
@...@@...@@..@@@@@......................@@
........@@@.@@@@@@...@...................@
........@@@..@@@@@@......@@@@@@.......@.@@
........@@@@.@@@@@.....@@@@@@@@.........@@
......@@@@@....@@@@@@@@@@@@@@@@.........@@
.......@@@.....@@@@@@@@@@@@@@@.........@@@
..........@...@@@@@@@@@@@@@@@@.........@@@
...............@@@@@@@@@@@@@@@@......@@@@@
....@@......@@@@@@@@@@@@@@@@@@@@@.@@@@@@@@
.......@@@@@@@@@@@@@@@@@@@@@@@@@@@@@@@@@@@
8
17 11 0
39 31 0
31 11 0
0 33 0
13 17 0
36 32 0
20 29 0
41 1 0

29 8 0
32 26 0
36 38 0
22 34 0
40 0 0
10 21 0
34 0 0
26 4 0
