width 48
height 48
@@........@@@@@@@............@@@@...@@......@@@@
@@.........@@@@@@...................@@........@@
@@@...@....@@.@@@@@..................@.........@
@@@........@....@@@@@...........................
..@.............@@@@@..........@@..............@
..........@@....@@@@@....................@@.....
..........@@....@@@@@.@.........................
..@.......@@@.....@@@............@.....@........
@@........@.@......@@.@.......@@@@.....@@@......
@...........@......@@@@@...@@@@@@...............
@@.......@.........@@@@@......@@@..@@....@......
@@@................@@@@@.......@@@@........@....
@@@................@@@@....@@..@@..............@
@@@....@..........@@@@@@...@@..@@...............
................@@@@@@@@........@..@............
........@@..@...@@@@@@@@........@...............
............@@@..@@@@@@@...........@............
..................@@@.@...................@.....
.............@....................@...@...@@@.@.
.............@@@..........@.......@.......@@@@@@
@......@.......@......@@....@.@.........@.@@@@@@
@@.............@...@@......@@................@@@
@....@@@.......@@...@..@@@....................@.
....@@@@@.......@............@.....@@...........
....@@@@@..@@....@...........@.....@@.......@...
....@@@@@..@@....@..................@...........
@@@@@@@@@@@@@........@.....................@....
@@@@@@@@@@@@@........@.....@........@......@....
@@@@@@@@@@@...@.........@@............@@........
@@@@@@@@@@@@....@@@........@...........@........
@@@@@@@@@@@@.....@@@..............@.............
@@@@@@@@@@@@@....@@..........@@@.@@.............
@@@@@@@@@@@@.................@@@@@..............
@@@@@@@@@@@.......@@.........@@.@..........@....
@@@@@@@@@@@@......@@..@@...@.............@.@....
@@@@@@@@@@...@.@................................
@@@@@@@@@@.....@................................
@@@@@@@@@@...@.@......@..............@..........
@@@@@@@@@@@...............@@.......@............
@@@@@@@@@@@........................@@...........
@@@@@@@@@@...........@.@@@......................
@@@@@...@@@@.........@.@@@...................@..
@@@@@......@@....................@@........@@@@.
@@@@@......@@................@........@.....@..@
@@@@@@.....@@..................................@
@@@.@@......@...........................@@.....@
@@@........@@............@...@@@@.....@@@@@@@.@@
@@@....@........@............@@@@.....@@@@@@@.@@
8
22 35 0
4 0 0
22 30 0
0 14 0
42 22 0
15 26 0
45 7 0
44 41 0

46 6 0
39 25 0
38 23 0
45 24 0
6 6 0
23 23 0
43 1 0
6 44 0
