width 48
height 48
@@@@@@@@.........@@@@.....@..............@@@@..@
@@@@@@@@@....@...@@@@@..........................
@@@@@@@@@....@..@@@.@@..@..@..@..........@@..@..
@@@@@@@@@......@@@@.........@....@..@@..........
@@@@@@@@@.......@@.................@@@..........
@@@@@@@@........................@...............
@@@@@@@@@....@..........@.......@.....@.........
@@@@@@@.@.@..........@....@@..........@@........
@@@@@@@.@.............................@....@@..@
@@@@@@@.@.....@@...@..........@...@...@....@...@
@@@@@@....@...@@.@.@@...@........@@@@......@....
@@@@..........@@.@@@@.............@.@@......@.@@
.@................@@@................@@........@
.......@@.........@@...@.@@@@...@@..@@@........@
......@@@..........@...@@@@@@...@@.........@....
......@@................@@@@@..............@....
......@@@..@............@@@........@@...........
.........................@.........@.....@@.....
.........@@..............@@.................@@.@
..........@..............@@.....................
@@.@..................@...@...@..........@@.....
@@@@@@.......@@........................@.@......
..@@@@.......@@@@@...........................@..
@.@@@@.......@@@@@......@.............@@@.......
@.......................@@@........@@@@@@@@@@...
@......@@@@@...........@@@@........@@@@@@@@@@...
......@@@@@@@..........@@@@......@@@@@@@@@@@@@..
......@@@@@......@@@@@@@@@@.@@@@..@@@@@@@@@@@@@@
..@@@..@@@@...@..@@@@@@@@@@@@@@....@@@@@@@@@@@@@
........@@@......@@@@@@@@@@@@@@...@@@@@@@@@@@@@@
..................@@@@@@@@@@@@....@@@@@@@@@@@@@@
................@@@@@@@@@@@@@.....@@@@@@@@@@@@@@
......@....@....@@@@@@@@@@@@......@@@@@@@@@@@@@@
@.....@@@.....@@@@@@@@@@@@@@.....@@@@@@@@@@@@@@@
@.............@@@@@@@@@@@@@......@@@@@@@@@@@@@@@
....@.........@@@@@@@@@@@@@.@@...@@@@@@@@@@@@@@@
....@.....@...@@@@@@@@@@@@@@@....@@@@@@@@@@@@@@@
......@@......@@@@@@@@@@@@@@@....@@@@@@@@@@@@@@@
......@@......@@@@@@@@@@@@@@@@...@@@@@@@@@@@@@@@
@.....@@@@...@@@@@@@@@@@@@@@@@@@@@@@@@@@@@@@@@@@
@@@@@@@@@@@@@@@@@@@@@@@@@@@@@@@@@@@@@@@@@@@@@@@@
@@@@@@@@@@@@@@@@@@@@@@@@@@@@@@@@@@@@@@@@@@@@@@@@
@@@@@@@@@@@@@@@@@@@@@@@@@@@@@@@@@@@@@@@@@@@@@@@@
@@@@@@@@@@@@@@@@@@@@@@@@@@@@@@@@@@@@@@@@@@@@@@@@
@@@@@@@@@@@@@@@@@@@@@@@@@@@@@@@@@@@@@@@@@@@@@@@@
@@@@@@@@@@@@@@@@@@@@@@@@@@@@@@@@@@@@@@@@@@@@@@@@
@@@@@@@@@@@@@@@@@@@@@@@@@@@@@@@@@@@@@@@@@@@@@@@@
@@@@@@@@@@@@@@@@@@@@@@@@@@@@@@@@@@@@@@@@@@@@@@@@
8
42 7 0
18 4 0
8 12 0
20 20 0
12 29 0
15 29 0
16 16 0
0 26 0

28 11 0
43 16 0
3 24 0
46 0 0
13 30 0
46 15 0
11 5 0
19 19 0
