width 48
height 48
@@@@@@@@@@@@@@@@@@@@@@@@.............@@.@@@@@@@@
@@@@@@@@@@@@@@@@@@@@@@@.......@.@.......@@@@@@@@
@@@@@@@...@@@@@@@@@......................@@@@@@@
@@@@@@@...@@@@@@@@@...............@@....@@@@@@@@
@@@@@@@@...@@@@@@@@.....................@@@@@@@@
@@@@@@@....@@@@@@@@...@@................@@@@@@@@
@.@@@@@.....@@@@@@@....@@...@......@...@@@@@@@@@
..@@@@@.....@.@...@@...@@..@@@@.@@.....@@@@@@@@@
...@@@@...............@@@@@@@@@@@@@@....@@@@@@@@
@.....................@@@@@@@@@@@@@...@@@@@@@@@@
@@.....@@.............@@..@@@@@@@@@@.@@@@@@@@@@@
@@.....@@..............@..@@@@@@@@@@@@@@@@@@@@@@
@@@...@@@..@..............@@...@@@@@@@@@@@@@@@@@
@@@@..@....@...@@@.........@....@@@@@@@@@@@@@@@@
@@@@@@@.......@@@..@@@.....@....@@@@@@@@@@@@@@@@
@@@@@@@......@................@.@@@@@@@@@@@@@@@@
@@@@@.....................@@@..@.@@@@@@@@@@@@@@@
.@..@@............@@......@@.....@@@@@@@@@@@@@@@
........@.........@..............@@@@@@@@@@@@@@@
.@......@@@@......@@@...@........@@@@@@@@@@@@@@@
.@@.....@@@@......@@@............@@@@@@@@@@@@@@@
@@.....@@@@......@@@.......@..@..@@@@@@@@@@@@@@@
@@..@.......@..............@..@..@@@@@@@@@@@@@@@
..............................@.@....@@@@@@@@@@@
.........................@....@......@@@@@@@@@@@
............................@.@.....@@@@@@@@@@@@
........@.......@...........@...@@..@@@@@@@@@@@@
...............@@..................@@@@@@@@@@@@@
.............@..@..................@@@@@@@@@@@@@
................@...@@...........@@@@@@@@@@@@@@@
.......@.....@@@@..@@@@...........@@@@@@@@@@@@@@
.............@@@@....@@......@@...@@@@@@@@@@@@@@
@@............@@@.............@...@@@@@@@@@@@@@@
.@............@@.@.............@..@@@@@@@@@@@@@@
.......@..................@....@..@@@@@@@@@@@@@@
.....@@@@@@@..................@@@@@@@@@@@@@@@@@@
.......@@@@@..@@..............@@@@@@@@@@@@@@@@@@
........@.....@...............@@@@@@@@@@@@@@@@@@
..@..@....@................@@@@@@@@@@@@@@@@@@@@@
.@.......@@.............@@@@@@@@@@@@@@@@@@@@@@@@
.@.......@@...@@..@.....@@@@@@@@@@@@@@@@@@@@@@@@
.......................@@@@@@@@@@@@@@@@@@@@@@@@@
..................@@@@@@@@@@@@@@@@@@@@@@@@@@@@@@
...............@..@@@@@@@@@@@@@@@@@@@@@@@@@@@@@@
.............@.....@@@@@@@@@@@@@@@@@@@@@@@@@@@@@
......................@@@@@@@@@@@@@@@@@@@@@@@@@@
.......@....@........@@@@@@@@@@@@@@@@@@@@@@@@@@@
......@@....@........@@@@@@@@@@@@@@@@@@@@@@@@@@@
8
10 13 0
23 39 0
13 13 0
17 32 0
11 43 0
29 4 0
5 11 0
27 32 0

17 30 0
4 10 0
8 33 0
36 6 0
12 42 0
21 4 0
18 23 0
30 18 0
