width 48
height 48
@@@.@@@@@@@@@.............@@@@@@@@@@@@@@@@@@@@@@
@@..@@@@@@@@..............@@@@@@@@@@@@@@@@@@@@@@
@......@........@.......@@@....@@@@@@@@@@@@@@@@@
@.........................@@@.....@@@@@@@@..@@@@
@.........................@@@.....@@@@@@@@...@@@
@......................@...@@......@@@@@..@..@@@
@@.........................@.........@@@.....@@@
@.........................@@@@...............@@@
..................@.........@@.@.............@@@
.................@...........@...............@@@
......@....@@.@..........@@...................@@
.....@@@@..@@.@....@..................@@......@.
.......@@@.........@.............@@.......@.....
.@........@@....@@.............@.@@..@..........
@...............@@........@@...@@@@@............
@................@........@@@@@@@@@@........@...
@...@..@@..@.....@.........@@@@@@@@@@@@.....@...
@...@@@@@..@@@..@@.........@@@@@@@@@@@@.....@@..
@@.@@@@@@@@@@@@@@@@@@........@@@@@@@@@@@@@......
@@@@@@@@@@@@@@@@@@@@@........@@@@@@@@@@@@@@.....
@@@@@@@@@@@@@@@@@@@......@...@@@@@@@@@@@@@@.....
@@@@@@@@@@@@@@............@...@@@@@@@@@@@@@.....
@@@@@@@@@@@@@@....@.......@....@@@@@@@@@@@@.....
@@@@@@@@@@@@@..................@@@@@@@@@@@@.....
@@@@@@@@@@@@@...................@@@@@@@@@@@@....
@@...@@@@@@.....@................@@@@@@@@@@..@..
@@.@.@@@@@@..@.....@.............@@@..@@@@@...@@
@@....@@@@@..@...........@.@@@...@@....@@@.....@
@@@....@@@@.............................@.......
@@@...@@@@@...@@.........@..............@...@...
@@@...@@@@@@.....@@.....@@...@..............@.@.
@@@...@@@@@......@@......@@.@@@....@@@.......@..
@@.....@@@@.......@......@@@@@@.....@@.........@
@.......@@@.............@@@@..@.@...............
......@..@@............@@@@@@.@..............@@.
..............@.......@@@@@@@...............@@@.
.....@........@@........@@@...............@.@@@@
@..@..........@@@.@.....@@.......@......@@@@@@@@
.............@@@@.@......@.......@..@@...@@@@@@@
..............@@@...@..@@@........@......@@@@@@@
....@..@@@.........@@.............@@..@@@@@@@@@@
........@@@@....@..@@.................@@@@@@@@@@
........@@@@@.......................@.@@@@@@@@@@
......@@@@@@@....@@...............@@@@@@@@@@@@@@
@@@@@@@@@@@@@@@....@@@..........@@@@@@@@@@@@@@@@
@@@@@@@@@@@@@@@.@@.@@@.......@...@@@@@@@@@@@@@@@
@@@@@@@@@@@@@@@@@@@@@@......@.....@@@@@@@@@@@@@@
@@@@@@@@@@@@@@@@@@@@@@.@.@..@.....@@@@@@@@@@@@@@
8
11 40 0
21 43 0
42 32 0
13 34 0
9 5 0
38 34 0
3 29 0
30 3 0

12 40 0
19 15 0
11 37 0
18 14 0
38 14 0
20 5 0
5 30 0
24 8 0
