width 48
height 48
@@@@@@@@@@@@@@@@@@@@@@...@.@@@@@@@@....@@@@@@@@@
@@@@@@@@@@@@@@@@@@@@@......@@@@@@@@....@@@@@@@@@
@@@@@@@@@@@@@@@@@@@@.......@@@@@@@@.....@@@.@@@@
@@@@@@@@@@@@@@@@@..........@@@@@@@@.......@.@@@@
@@@@@@@@@@@@@@@@@@.......@...@..@@..........@@@@
@@@@@@@@@@@@@@.@@@...............@......@...@@@@
@@@@@@@.....@@..@........@.........@..@....@@@@@
@@@............@..........@@..@@@@@....@...@@@@@
@@@@................@.@...@.....@@@.......@.@@@@
@@...@@...............@@@@.......@@.........@@@@
@@....@..................@@......@@.@...@....@@@
......@@......@.................@@@....@......@@
..........@...........@.....@.................@@
.........@@@@......@..@.....@...........@..@@..@
.........@@@..............@@........@......@@@@@
@....@@..@@@..................@....@@@........@@
@.....@..@@......@..........@...@....@.....@..@@
@.....@...@.....@@..@..................@.......@
@..@.......@....@@@....................@....@...
....@@.....@....................................
....@@....@@...........@.@......................
..........@@............................@.....@.
..........@@...@............@.............@.....
..@.......@@....................................
@@@@.......................@.............@......
@@@@........@@@@...@.......@@@.@................
@@@@....................@@...@@@................
@@@@@@........@..............@@@@...@.....@@@@..
@@@@@@@@..@........................@@...@.@@@@@@
@@@@@@@@@.........@................@@@@@@.@@@@@@
@@@@@@@@@@........................@@@@@@@@@@@@@@
@@@@@@@@@@.........................@@@@@@@@@@@@@
@@@@@@@@@...........................@@@@@@@@@@@@
@@@@@@@.........@..@.................@@@@@@@@@@@
@@@@@@.....@...@@.................@@@@@@@@@@@@@@
@@@@@@..@.......@...@.............@@@@@@@@@@@@@@
@@@@@@@@@@.......................@@@@@@@@@@@@@@@
@@@@@@@@@@.@.....................@@@@@@@@@@@@@@@
@@@@@@@@@@@@..@.......@..........@@@@@@@@@@@@@@@
@@@@@@@@@@@@@@......@.....@@....@@@..@@@@@@@@@@@
@@@@@@@@@@@@@@............@@.@..@@@....@@@@@@@@@
@@@@@@@@@@@@@@............@@@@............@@@@@@
@@@@@@@@@@@@@@@.........@..@.......@@......@@@@@
@@@@@@@@@@@@@@@............@......@@......@@@@@@
@@@@@@@@@@@@@@@....................@@.........@@
@@@@@@@@@@@@@@@@@@..@@...........@@.............
@@@@@@@@@@@@@@@@@@@@@@@@....@....@@.......@.....
@@@@@@@@@@@@@@@@@@@@@@@@..@@@@@@@@........@..@..
8
34 25 0
6 24 0
12 32 0
33 18 0
9 12 0
38 41 0
37 7 0
33 27 0

31 15 0
47 47 0
13 13 0
32 43 0
4 18 0
29 12 0
1 18 0
7 24 0
