width 48
height 48
@@@@@@@@@@@@@@@@@@@...........@@@@@@@.@@@@@@@@@@
@@@@@@@@@@@@@@@@@@@...........@@@@@@@..@@@@@@@@@
@@@@@@@@@@@@@@@@@@@@...........@@@@@@..@@@@@@@@@
@@@@@@@@@@@@@@@@@@@@...........@@@@@@..@@@@@@@@@
@@@@@@@@@@@@@@@@...@@........@@@@@@@@@.@@@@@@@@@
@@@@@@@@@@@@@@..........@.........@@@..@@@@@@@@@
@@@@@@@@@@@@@@.........................@@@@@@@@@
@@@@@@@@@@@@@..........................@@@@@@@@@
@@@@@@@@@@@@@@.........@@@.............@@@@@@@@@
@@@@@@@@@@@............@@@@.............@@@@@@@@
@@@@@@@@@@@............@@@@..............@@@@@@@
@@@@@@@@@@@..@.........@@............@...@@@@@@@
@@@@@@@@@@@..@........@@........@@...@.@@@@@@@@@
@@@@@@@@.@............@@.......@........@@@@@@@@
@@@@@@@@..............@..@@@...@........@@@@@@@@
@@@@@@@@............@@@....@@.@@....@...@@@@@@@@
@@@@@@@@@.@@.....@@.@@......@@@@@.......@@@@@@@@
@@@@@@@@@@@@......@@@@@......@@.........@@@@@@@@
@@@@@@@@@@@@......@@.@@....@.........@..@@@@@@@@
@@@@@@@@@@@@....@.....@.........@...@...@..@@@@@
@@@@@@@@@@@@@..............@@@..@@@.....@@.@@@@@
@@@@@@@@@@@@@........@..........@@@.........@@@@
@@@@@@@@@@@@@@...............@....@@...@....@@@@
@@@@@@@@..@@@@.............@.......@@..@.@.@@@@@
@@@@@@@....................@.......@@....@@@@@@@
@@@@@@@...................@@......@@@..@@@@@@@@@
@@@@@@..............@@....@@......@@@@.@@@@@@@@@
@@@@@@...............@....@@......@@@@@@@@@@@@@@
@@@@....................@.........@@@@@@@@@@@@@@
@@@@....................@.....@@..@@@@@@.@@@@@@@
@@@@..@......@.....@...........@@@@.@@...@@@@@@@
@@@@.@@...............@@@......@@........@.@@@@@
@@@@@@@......@....@...@@.......@@@.........@@@@@
@@@@@@@...@@@.......................@......@@@..
..@@@@@................................@@@..@@..
....@..................................@@@..@@..
.............@.....@@....@..@..............@@...
.@..@........@.....@@..........@.......@........
...............................@..........@@....
................................................
..............@.....@@.......@@.@@......@..@@...
................@...@@.......@@@@@..............
.........@@@........@@@...@@@@@@@..............@
....@@@..@@@...@.....@.....@@@@@@........@.....@
......@@@@@@@.............@@@@@@...............@
......@@@@@@...@.......@@@@@@@@@...............@
.@..@.@@@@@@..@.@.@....@@@@@@@@................@
....@@@@@@@@@@@.......@@@@@@@@............@@...@
8
18 29 0
46 42 0
2 36 0
5 29 0
44 45 0
35 17 0
44 47 0
17 20 0

26 15 0
36 42 0
8 23 0
5 30 0
28 2 0
3 45 0
19 6 0
44 47 0
