width 48
height 48
@@@@@@@@@@@@@@@@@@@@.@@@@@@@@@@@@@@@@@@@@@@@@@@@
@@@@@@@@@@@@@@@@@@@@.@@@@@@@@@@@@@@@@@@@@@@@@@@@
@@@@@@@@@@@@@@.@...@.@@@@@@@@@@@@@@@@@@@@@@@@@@@
@@@@@@@@@@@@@......@.@@@@@@@@@@@@@@@@@@@@@@@@@@@
@@@@@@@@@@@..........@@.@@@@@@@@@@@@@@@@@@@@@@@@
@@@@@@@@@@@.....@.......@@@@@@@@@@@@@@@@@@@@@@@@
@@@@@@@@@@@@....@..........@@@@@@@@@@@@@@@@@@@@@
@@@@@@@@@@............@....@@@@@@@@@@@@@@@@@@@@@
@@@@@@@@@............@@.....@@@@@@@@@@@@@@@@@@@@
@@@@@@@@@@@..........@..@..@.@@@@@@@@@@@@@@@@@@@
@@@@@@@@@@@..................@@@@@@@@@@@@@@@@@@@
@@@@@@@@@@@@............@....@@@@@@@@@@@@@@@@@@@
@@@@@@@@@@@@@...........@....@@@@@@@@@@@@@@@@@@@
@@@@@@@@@@@@..........@......@@@......@@@@@@@@@@
@@@@@@@@@@@@@@@@..@...................@@@@@@@@@@
@@@@@@@@@@.@@@@...@@@......@@............@@.@@@@
@@@@@@@@@@...............................@@.@@@@
@@@@@@@@@@.................@.........@........@@
@@@@@@@@@@.........@@...........................
@@@@@@@@...........@@..........@...@@...@.......
@@@@@@@@.....................@@@..@@@..@@@......
@@@@@@@@.....................@@@...@@.@@@@......
.....@@@@...................@@@@...@@.@@@@@..@..
.....@@@@@@...@@........@..@@@@@@@@@.........@..
....@@@@@@@.................@@@@@@@@.@......@@..
....@@@@@@@@@.........@...@@@@@@@@@......@@@@@..
...@@@@@@@@..............@@@@@@@@........@@@@@..
......@@@................@@@@@@@....@....@@@@@@@
.........................@@...............@@@@@@
.....................@@..@@..............@@@@@@@
.....................@@........@.......@.@@@@@@@
..................@..@@......@...........@@@@@@@
......@@..@............@.................@@@@@@@
..........@.....@......@@......@.........@@@@...
.......@........@...@..........@....@.....@.@...
...................@...@@@@...................@.
.@.@..........@.@@.@.@@@@@@....@................
........@..........@@@@@@@@..........@..........
...................@@@@@@@@.....................
@@....@............@@@@@@@@@....................
@@@@@@@.....@@......@@@@@@@@@....@............@.
@@@.................@@@@@@@@@@@................@
@@@................@@@@@@@@@@@@@@@@@...........@
@@@................@@@@@@@@@@@@@@@@@...........@
@@@....@............@@@@@@@@@@@@@@@.......@@@..@
...........@@@.......@@@@@@@@@@@@@@@......@@@@@@
..........@@@@......@@@@@@@@@@@@@@@@....@@@@@@@@
......@@..@@@@@...@@@@@@@@@@@@@@@@@@..@@@@@@@@@@
8
33 30 0
21 13 0
41 41 0
7 43 0
31 16 0
41 42 0
23 20 0
44 39 0

1 47 0
15 28 0
24 8 0
26 19 0
24 19 0
35 16 0
0 47 0
7 41 0
