width 48
height 48
@@@@.@.@@@@................@@@@@@@.@@@@....@@@@@
@@@....@@@.................@@@@@@@.@@@@.....@@@@
@@@....@@@.@................@@@@@@.@@@......@@@@
@@......@.........@....@....@@@@@@...@@....@@@@@
@@@..........@@@.............@@@@@@...@@@..@@@@@
.............@@......................@........@@
.@..........@@@.......................@....@..@@
...........@@@@...@..@@.@@....................@@
.............@@...@...@..@........@..........@@@
........................@@.............@........
................................................
.......................................@@.......
...........................@...@.......@.......@
...@.....@@......@......@...........@.....@.....
.......@..@@@...........................@@@.@...
@.........@@@@@........@..@@.........@..@...@@..
......@...@@@@@......................@..........
...........@@...........@......@................
...................................@@...........
..@@@...............@@.@@........@.@@...@.......
@.@@...........@.....@.@@@.........@......@.....
@@@....@.........@......@@...................@..
@@.@.@....@..........................@..........
@@...@..@@@......@.........@...........@@@.....@
@....@..@@@@@....@.....@@@@@@..........@@@@..@..
..........@@@..............@@@@.................
...........................@@@.................@
............................@@@@..........@....@
................@......@..@.@@@.............@@@@
....................@@@@@@@..@@...............@@
........@...@@......@@@@@@@...........@........@
.......@@...@@......@@@@@@@..@@@@.............@@
...........@...@......@@@@@@.@@@@............@@@
......@........@@@@...@@@@@@@@@@@........@@.@@@@
..........@.....@@....@@@@@@@@@@@@..........@@@@
......@...@.@....@....@@@@@@@@@@@@....@.....@@@@
.......@....@@.....@@@@@@@@@@@@@@@....@.....@@@@
............@@@@@@@@@@@@@@@@@@@@@.....@.@.....@@
...........@@@@@@@@@@@@@@@@@@@@@@...........@.@@
..........@@@@@@@@@@@@@@@@@@@@@@@...@..........@
@@...@.@@@@@@@@@@@@@@@@@@@@@@@@@@@@@@@..........
....@@@@@@@@@@@@@@@@@@@@@@@@@@@@@@@@@@@@........
....@@@@@@@@@@@@@@@@@@@@@@@@@@@@@@@@@@@@@@@.....
...@@@@@@@@@@@@@@@@@@@@@@@@@@@@@@@@@@@@@@@@.....
..@@@@@@@@@@@@@@@@@@@@@@@@@@@@@@@@@@@@@@@@@.....
..@@@@@@@@@@@@@@@@@@@@@@@@@@@@@@@@@@@@@@@@@@....
@@@@@@@@@@@@@@@@@@@@@@@@@@@@@@@@@@@@@@@@@@@@@...
@@@@@@@@@@@@@@@@@@@@@@@@@@@@@@@@@@@@@@@@@@@@@...
8
19 30 0
45 11 0
6 39 0
16 7 0
27 20 0
35 13 0
16 5 0
7 39 0

46 43 0
33 39 0
46 44 0
44 39 0
24 16 0
35 12 0
12 10 0
9 38 0
