width 24
height 24
@@@@@@@@@@@@@@@.....@...
@@@@@@@@@@..@@@.........
@@@@@@@@@@..@@@.........
@@@@@@@@@@..@@..........
@@@@@@@@@@.............@
@@@@@@@@...............@
@@@@.....@..............
@@@@@...................
@@@@@.@@@@..............
@@@@@@@@@..........@@...
@@@@@@@@................
@@@@@@@@............@.@.
@@@@@@...@.............@
@@@@@@......@...........
@...@@...............@@@
@....................@@@
............@........@.@
........@@..@....@.....@
.......................@
........................
.....@@.@@..........@@..
..@.@@@@@@@@@@@@...@....
@@@@@@@@@@@@@@..........
@@@@@@@@@@@@@@..........
8
13 5 0
14 7 0
7 7 0
18 1 0
11 10 0
20 15 0
13 8 0
14 19 0

7 14 0
18 21 0
10 5 0
11 18 0
23 23 0
15 1 0
12 10 0
9 10 0
