width 24
height 24
@@@@@@@@@@.@.........@@@
@@@@@@@@@@............@@
@@@@@@@@@@@.............
@.@......@@.............
..@.......@............@
..@............@.......@
........................
...........@@...........
....................@...
........@.......@.......
.......@@@...@..........
.......@@@.........@....
.......@@.@.............
..........@.@..@...@....
@...........@..@........
....@....@.@@@..........
.....@@..@.@@...........
@...@@@.................
....@.........@.........
....@...................
........................
.................@......
........................
..............@......@@@
8
11 1 0
13 9 0
6 10 0
15 18 0
21 21 0
12 3 0
2 22 0
13 16 0

0 23 0
1 3 0
19 21 0
11 6 0
10 15 0
18 9 0
23 10 0
14 6 0
