width 24
height 24
@@.@@...@@@@@@@@@@@@@@@@
@@....@...@@@.@@@@@@@@@.
......@..........@@@@@..
..................@.@@..
@......................@
@@...@.........@........
@....@@@.......@.....@..
@....@@@...@@...........
@......@................
@@......@@@...@...@.....
@@......@@........@@....
@@.......@....@........@
@@@@@@@@@..............@
@..@@@@@@......@@.....@@
...@@@@...............@@
@..@@@@.@..........@.@@@
.....................@@@
..........@.....@....@@@
.@@...................@@
..@...................@@
......@................@
......................@@
@@@.@@................@@
@@@.@@.@@@@..@...@@@...@
8
19 7 0
3 11 0
17 14 0
12 11 0
12 6 0
21 20 0
16 4 0
12 19 0

6 23 0
3 10 0
8 21 0
15 23 0
20 17 0
22 5 0
13 22 0
0 21 0
