width 20
height 37
@@@.................
@.....@.............
.............@...@..
....................
@...@....@..........
.............@@@@.@.
...@...........@@...
.....@..............
.......@............
..@..........@......
..........@.@.......
.......@........@...
.....@....@..@......
@...@.@.............
....................
...............@....
.@.......@........@.
....................
....................
.@@@@@..............
..@.....@.....@@....
..............@.....
@....@..........@...
..@...@..@..........
....@.........@.....
.............@......
.......@..@....@....
........@...........
.@.@.............@..
.@....@.....@.@.....
@...@.............@.
@..@......@.@.......
@....@..............
@.........@.....@@@.
...@................
.....@.....@@@......
..........@@@.......
6
11 2 0
11 23 0
5 28 0
18 34 1
6 15 1
16 23 1

8 30 0
11 23 0
18 7 0
8 33 1
7 14 1
6 5 1
