width 20
height 37
@@@@...@@@@.........
@@......@@..........
@...................
@....@....@.........
@...............@...
@..@.............@..
@..........@........
........@..@........
....@....@..........
.....@........@.....
....................
....................
...@....@..@........
@....@..............
..........@........@
...@..............@.
............@.......
.........@..........
.....@.@............
.@..........@...@...
......@.............
...@................
....@...............
.@......@...@..@..@.
.......@............
.............@.@....
..@..............@..
....................
...............@....
....@...............
........@.@.........
.........@.....@..@.
..@...@.............
.....@.....@........
...@...........@@...
...............@@...
.....@@@............
6
17 4 0
0 15 0
9 5 0
4 21 1
16 26 1
3 22 1

9 20 0
0 18 0
0 30 0
19 2 1
13 32 1
18 2 1
