width 20
height 37
....................
.@@.................
....................
....................
...@.@.@.....@......
..............@.....
............@.......
..@.................
.@..@...@...........
.........@...@..@...
.................@..
........@...........
.........@...@......
..............@..@..
....@........@.@....
.........@..........
............@.@.....
..@.............@...
.....@..............
..@....@........@...
..@........@..@.....
....................
.@..........@.......
.............@......
....................
@..@....@.....@...@.
@...................
........@...@.......
........@@..........
...@..............@.
..@........@.@.@....
.....@.@............
..@............@...@
......@..@........@@
......@...@..@......
......@.............
....................
6
14 28 0
7 17 0
11 5 0
9 26 1
0 14 1
7 20 1

6 22 0
8 29 0
13 17 0
9 18 1
17 31 1
10 23 1
