width 20
height 37
....................
....................
.........@..........
@..@...@...........@
.....@...@..@.......
........@..@.@...@.@
....................
.........@..@.......
...........@..@.@...
....@...............
......@......@......
..............@..@..
........@...........
......@.............
..........@..@......
.....@...........@..
...@......@..@......
.........@.......@..
..@..............@..
.....@..............
..........@......@..
.....@......@.......
....@........@......
.@..................
..........@.@.......
..@.....@......@....
.......@.....@...@@.
....................
.......@.......@....
.....@....@.........
..............@.....
....................
.....@@.@...........
............@.......
...........@..@.....
....@@..@...........
....@@........@.....
6
16 29 0
17 24 0
9 25 0
2 7 1
10 22 1
7 19 1

0 15 0
17 22 0
2 5 0
18 30 1
13 9 1
18 1 1
