width 20
height 37
....................
........@...........
..@................@
..........@.@..@..@@
..............@...@@
...........@......@@
...@..........@...@@
.....@............@@
..........@.........
............@..@....
................@.@.
....................
....@.....@.........
......@..@.........@
..@..........@....@@
...@......@.........
....................
.@....@......@.....@
@...@..........@....
@.....@...@.........
@@..@......@..@.....
@...............@.@.
....................
.............@......
...@..@.............
....@..@.@.....@....
....................
.......@...@.@.@....
......@.............
.@@......@..........
..@...........@.@..@
..@..@.@....@.......
....@....@..........
.@..................
...........@..@.@...
................@...
....................
6
14 1 0
16 1 0
7 14 0
19 36 1
6 15 1
19 8 1

3 25 0
3 14 0
14 0 0
13 34 1
16 26 1
16 8 1
