width 20
height 37
@@..........@.......
@@@.......@....@....
@@..@............@..
.......@..@.........
..............@.....
..@..........@......
.........@....@..@..
..@...@...@.........
.@...........@......
.....@............@.
........@...........
..........@...@.....
....@...@....@....@.
......@..........@..
.@..............@...
...........@...@....
..@.....@.....@.....
.....@.@............
.................@..
....................
..@...@.@...........
...........@........
......@......@.....@
....................
@..............@....
..@.@..............@
..........@.@.......
........@...........
...@......@.........
.........@...@......
....................
.....@...@.@........
............@....@..
..@.................
.@............@.....
.......@.......@....
....................
6
17 35 0
8 28 0
12 13 0
12 19 1
17 20 1
1 32 1

4 6 0
17 3 0
0 16 0
13 11 1
3 0 1
18 6 1
