width 20
height 37
...................@
...................@
..@.........@.....@@
.....@..............
....................
..........@..@......
........@..........@
......@.......@.....
.............@.....@
.@..@.......@.......
........@......@..@.
@..@................
@...................
.............@..@...
........@...@.......
...............@....
......@...@.........
....................
..............@.@...
...@...@............
....................
.@.....@..@.........
.............@.@..@.
....@............@@@
...@..@....@.....@@@
............@@.@..@@
............@@@.....
............@.......
..@..@.@....@...@...
@...@...............
.........@...@......
................@..@
..............@..@.@
.....@...@..........
...........@.@....@.
...............@....
....................
6
4 31 0
17 3 0
15 18 0
1 29 1
12 17 1
18 4 1

4 33 0
8 1 0
3 20 0
16 19 1
18 6 1
14 2 1
