width 20
height 37
@@..................
@...................
.@.@................
.....@.@..@.....@...
..@...........@.....
.....@..............
............@.......
....................
.@......@....@.@....
....@....@..........
..@..@..............
..........@.@...@...
....................
.....@...@..........
.@....@.@.......@...
...............@....
@.@.........@.......
....@.....@..@......
...............@....
.................@..
.@..................
................@...
...@................
.@.............@....
.......@......@.....
....................
.......@..@.........
....@...............
..........@.@.......
......@.............
........@@.....@....
..@....@...........@
.............@....@@
.....@..@........@@@
.........@.@.....@@@
....@...........@@@@
.............@@@@@@@
6
5 16 0
15 20 0
10 10 0
16 16 1
14 29 1
18 2 1

15 34 0
14 13 0
9 29 0
1 15 1
0 7 1
3 1 1
