width 20
height 37
....................
.....@..............
...@..........@..@..
..@..@..@...........
.......@............
.........@..........
..............@..@..
.........@..@......@
...@...............@
......@.............
....@.............@.
.........@..@.......
.@............@.....
..@............@....
......@..@.@........
.......@...........@
..@......@.........@
....@...............
@..........@........
@@......@.......@@.@
...................@
..........@.........
......@...@.@.......
....................
................@...
..@......@..........
....@...............
.@....@.......@.....
...........@........
..@......@.......@..
...................@
....@........@......
.@.......@..........
@.................@.
.......@....@....@..
.............@...@..
.................@..
6
17 14 0
11 9 0
11 13 0
10 10 1
8 17 1
10 17 1

10 19 0
8 14 0
2 36 0
1 34 1
18 31 1
0 36 1
