width 20
height 37
.........@..........
..@........@........
......@........@....
.........@........@.
......@.@.@..@......
....................
......@..@..........
....................
............@.@....@
..@..@...........@@@
.........@.......@@@
...@.......@..@.....
.......@............
...........@......@.
....................
.@...............@..
..@.@@.@............
....................
......@.@..@..@.....
.....@..............
....................
........@...........
..@............@....
...@.@.....@......@.
....................
.@......@...........
...........@...@....
....................
..@.................
.........@......@...
.....@...........@..
.......@@...........
......@.............
..@.@.......@..@....
.....@........@..@..
...........@........
....@...............
6
5 8 0
3 27 0
0 7 0
17 0 1
17 26 1
0 24 1

17 31 0
19 4 0
13 28 0
17 8 1
4 20 1
0 24 1
