width 20
height 34
...................@
......@........@....
.@.....@@...........
.......@@...........
..@....@@...........
...@...@.@...@..@...
...........@...@....
...@................
....@.@..@..........
..........@.........
....@.........@.....
.........@......@...
.....@.@..@.........
..............@.....
.....@......@....@..
...@.............@.@
.......@......@....@
..........@........@
......@......@......
...@.@..............
..............@...@.
.......@............
................@...
....................
....@.@..@..........
................@...
@...................
.@.....@...@....@...
.@..................
.................@..
...@...@.....@......
....................
@...............@...
....................
6
10 30 0
9 25 0
3 8 0
7 9 1
2 15 1
17 2 1

0 0 0
9 20 0
11 16 0
7 8 1
0 10 1
5 13 1
