width 20
height 34
@.................@.
@...................
@@@@.........@....@.
@@@@.@......@@......
@@@@.......@........
@@.@............@...
@@.@@...............
.......@...@....@...
..@...@.............
..........@......@..
....@...............
................@...
@.....@.............
@...................
......@..@.@.....@..
................@...
..@.@.....@...@.....
............@.....@.
.............@......
....@............@..
...@................
....................
.........@..........
............@.@@....
....................
....................
..............@.....
.........@..........
........@........@@@
...@.....@..@.....@.
......@.............
@@.............@....
@@..................
@@..................
6
19 7 0
9 9 0
18 6 0
0 14 1
19 1 1
6 10 1

0 30 0
7 21 0
18 6 0
11 33 1
2 33 1
15 33 1
