width 20
height 34
....................
..........@.........
....@.......@..@....
.......@.....@......
...@................
..@...............@.
..........@..@.@....
......@..@.@..@.....
........@...........
......@.............
....@.....@....@....
...........@....@...
..@...........@.....
@....@@.............
..........@..@......
.................@..
@....@............@.
@@@.....@....@......
@@@.................
@@@@.......@...@...@
@@@@..@.............
@.@@................
.....@.....@........
..............@.....
....................
........@.@....@....
.......@...@.....@..
....................
..............@.....
.....@.@.......@....
..........@.@.......
....................
..@..........@.....@
..@@...............@
6
19 13 0
5 11 0
5 21 0
16 5 1
15 23 1
4 9 1

19 10 0
0 24 0
19 4 0
0 30 1
11 24 1
8 12 1
