width 20
height 34
@@@..@..............
@@@.................
.................@..
......@.............
@.............@.....
..@.....@......@....
........@.......@...
..@...@...@...@.....
....................
....................
...@............@...
.........@...@......
.......@............
........@...........
..@..@....@....@....
....................
.....@..............
....@.@.@...........
.@.@.......@..@.@...
....................
....@.....@.........
@@.............@....
...@..........@....@
...........@.@....@@
..@.....@...........
...@...@............
.........@.....@....
..............@.....
..........@.........
....@..............@
....................
.........@.@........
........@....@.....@
......@..........@@@
6
9 29 0
12 32 0
1 2 0
9 19 1
11 12 1
10 23 1

19 16 0
8 29 0
0 7 0
10 23 1
14 9 1
7 6 1
