width 20
height 34
........@...........
.......@........@..@
.............@.....@
.....@............@@
@.................@@
..@.....@...........
....................
@.....@.....@.......
..@.............@@@@
.......@....@.......
...@................
...@.............@..
....@....@.@........
@@........@......@..
@@..................
........@...@...@...
....................
.@..................
............@.@.....
....@..........@.@..
....................
.........@..@.@@....
....@@..@.@....@@...
....................
....@.............@.
........@...........
.@.........@.@..@...
......@.............
...@.....@..........
........@...........
.........@..........
....@............@..
........@.@.........
....................
6
7 31 0
6 12 0
2 23 0
14 32 1
6 19 1
17 18 1

6 28 0
5 7 0
3 23 0
16 19 1
18 5 1
18 17 1
