width 54
height 54
@@@@@@@@@@@@@@@@@@@@@@@@@@@@@@@....@@@@@..............
@@@@@@@@@@@@@@@@@@@@@@@@@@@@@@@.......@@...@.....@....
@@@@@@@@@@@...@@@@@@@@@@@@@@@@@..................@....
@@@@@@@@@@@...@@@@@@@@@@@@@@@.@...............@.......
@@@@@@@@@....@@@@@@@..@@@@@@@.................@.......
@@@@@@@@@.....@@@@@@.....@@@@..........@@@........@...
..@@...@.......@@@@@@....@@@............@..@..........
..@@...@@@......@@......@@@@@@@..@@...................
@......@@@@@@...........@@@@@.@.@@.............@@.....
.......@@@@@@.........@.@@@@...@@..........@....@@....
.......@@@.@.........@@@@......@@..@..................
......@@@............@@@....@@@@@..@@.............@..@
.....................@@@....@@@@@..@@@.......@.@......
.....................@@@......@@.....@...........@@...
..@................@..@@......@@.....@....@@......@...
...............@.....@@@..........@.......@.........@@
@@...........@........@.................@............@
......................@...................@...........
.....@...................................@@...........
....@@@....@@.........@...@................@..........
...@@@@..................@@...........................
@@@@@@@@...........................................@..
@@@@@@@@......................@.......@...............
@@@@@@@@............@@................................
@@@@.@@@...........@....@@..@...........@@..@@@.@.@...
@....@@@...@@@.............@.................@........
......@...@@@..............................@..........
...........@@..........@.......@@..........@.........@
......@....@@...................@@...................@
...........@....................@@...........@.@......
@.......@@@@....@@..@@.@....@@...@@@................@@
@@@.....@@@@.......@@@@@.........@@@@.............@...
@@@.@.@@@@@@@@@@@.@@@@@..........@@@@@................
@@@@@@@@@@@@@@@....@@@@@.@@@........@.......@...@.....
@@@@@@@@@@@@@@.......@.@..@@...@................@@@...
@@@@@@@@@@@@@@............@@.@........@@@.......@.@...
@@@@@@@@@@@@@@............@@.@.........@.............@
@@@@@@@@@@@@@@@@@........@@@.....@@@...@............@@
@@@@@@@@@@@@@@@@@........@@.........................@@
@@@@@@@@@@@@@@@@@.........@.........................@@
@@@@@@@@@@@@@@@@@@........@@.........@@@..........@@@@
@@@@@@@@@@@@@@@@@@@@......@.................@@@...@@@@
@@@@@@@@@@@@@@@@@@@@........................@@@@...@@@
@@@@@@@@@@@@@@@@@@@@@.@.........@.@..........@..@@@@@@
@@@@@@@@@@@@@@@@@@@@@..@..........@....@....@@..@@@@@@
@@@@@@@@@@@@@@@@@@@@@@.@.@.......................@@@@@
@@@@@@@@@@@@@@@@@@@@@@.........@.........@........@@@@
@@@@@@@@@@@@@@@@@@@@@@@@.......@.........@....@@..@@@@
@@@@@@@@@@@@@@@@@@@@@@@.......@@.....@....@........@@@
@@@@@@@@@@@@@@@@@@@@@@@@.@.....@@.........@........@@@
@@@@@@@@@@@@@@@@@@@@@@@@@@@.@..@.........@@....@@@@@@@
@@@@@@@@@@@@@@@@@@@@@@@@@@@..@....@..@@@@@@....@@@@@@@
@@@@@@@@@@@@@@@@@@@@@@@@@@@@.........@@@@@@@..@@@@@@@@
@@@@@@@@@@@@@@@@@@@@@@@@@@@.....@.@.@@@@@@@@@.@@@@@@@@
8
31 45 0
15 19 0
35 33 0
0 9 0
25 39 0
7 18 0
23 17 0
44 1 0

40 7 0
30 39 0
18 15 0
29 48 0
52 13 0
37 30 0
52 22 0
43 3 0
