width 54
height 54
@@@@@@@@@@@@@@@@@@@@@@@@@@@@@@@@@@@@@@@@@@@@@@@@@@@@@@
@@@@@@@@@@@@@@@@@@@@@@@@@@@@@@@@@@@@@@@@@@@@@@@@@@@@@@
@@@@@@@@@@@@@@@@@@@@@@@@@@@@@@@@@@@@@@@@@@@@@@@@@@@@@@
@@@@@@@@@..@@@@@@@@@@@@@@@@@@@@@@@@@@@@@@@@@@@@@@@@@@@
@@@@@.@@...@@.@@@@@@@@@@@@@@@@@@@@@@@@@@@@@@@@@@@@@@@@
@@@....@...@..@@@@@@@@@@@@@@@@@@@@@@@@@@@@@@@@@@@@@@@@
@@@............@@@@@@@@@@@@@@@@@@@@@@@@@@@@@@@@@@@@@@@
@@..............@@@@@@@@@@@@@@@@@@@@@@@@@@@@@@@@@@@@@@
@...................@@@@@@@@@@@@@@@@@@@@@@@@@@@@@@@@@@
@............@......@@@@@@@@@@@@@@@@@@@@@@@@@@@@@@@@@@
@.........@@.......@@@@@@@@@@@@@@@@@@@@@@@@@@@@@@@@@@@
@.................@@@@@@@@@@@@@@@@@@@@@@@@@@@@@@@@@@@@
.............@.......@@@@@@@@@@@@@@@@@@@@@@@@@@@@@@@@@
.....@..............@@@@@@@@@@@@@@@@@@@@@@@@@@@.@@@@@@
@...@@..............@@@@@@@@@@@@@@@@@@@@@@@@@@..@@@@@@
@@@@@@....@....@......@@@@@@@@@@@@@@@@@@@@@@....@@@@@@
@@@@@@@.........@@..@.@@@@@@@@@@@@@@@@@@@@@@....@@@@@@
@@@@@@@.......@.@@..@@@@@@@@@@@@@@@@@@@@@@@@.@@@@@@@@@
.@@@@@@.....@@@@.....@@@@@@@@@@@@@@@@@@@@@....@@@@@@@@
.....@.......@@@......@..@@.@@@@@@@@@@@@@@....@@@@@@@@
.............@@..........@@....@@@@@@@@@@@@....@@@@@@@
@...............@....@...@@@..@@@@@@@@@@@@.....@@@@@@@
..........................@@...@@@@@@@@.........@@@@@@
................@.........@@....@@@@@.@..........@@@@@
......................@........@@..@@...@@@......@@@@@
..@@.......@@...@.....@.......@@@...@@..@@@......@@@@@
..........@@@...@@....@.................@@@...@..@.@@@
...........@@...@@.....................@@@@..@.....@@.
......@.........@@..@..................@@@@....@@.....
@....@@....@....@@................@..@.@@@@..........@
...........@@......@@.............@....@@@@.........@@
.........@@@@.....@@..........@...@....@@@...@.....@@@
.....@..@@@@@....@@@............@.@@................@@
........@@@......@@@.......@........................@@
.....@...@@@@........@....@......................@@@@@
....@@...@@@@..................................@.@@@@@
...@@@@@@@@@.....@@.@......................@.....@@@..
...@@@@@@@@@@....@@...........@............@.....@@...
...@@@....@@......@......@....@............@....@@....
@..@@@....@@@@@..@@@............................@@@...
@@...@@...@@@@@@@@@.........@..............@.....@@...
@........@@@@@@@@@@..............@.............@......
....@....@@@@@@@@@@@...........@......................
..........@@@@@@@@@@@@......@.............@.@........@
..........@@@@@@@@@@@@@@@.......@.........@@........@@
@.........@@@@@@@@@@@@@@@..........................@@@
..........@@@@@@@@@@@@@@@..@@@..@@..............@@@@@@
@@...@@..@@@@@@@@@@@@@@@@@.@@...@...........@....@@@@@
@...@@@...@@@@@@@@@@@@@@@@@@@@.@@......@....@.@@...@@@
..........@@@@@@@@@@@@@@@@@@@@@@..............@.......
...........@@@@@@@@@@@@@@@@@@@@@...@@.@@@@............
...........@@@@@@@@@@@@@@@@@@@@@.@@@@@@@@.............
@..@@@....@@@@@@@@@@@@@@@@@@@@@@@@@@@@@@@..@@@........
@..@@@@@@@@@@@@@@@@@@@@@@@@@@@@@@@@@@@@@....@.........
8
24 36 0
21 33 0
26 33 0
10 17 0
7 42 0
46 32 0
23 40 0
46 20 0

3 51 0
35 36 0
1 53 0
2 35 0
7 18 0
46 23 0
13 6 0
36 34 0
