width 54
height 54
@......@@@@@..@@@@@@@@@..@@@@@@@@@@@@........@@..@@@@@
.........@@...@@@@@@@@@...@@.@@@@@@.........@@....@@@@
..............@...@@@@.......@@@@@@........@@......@@@
........@..................@...@@..........@@.@....@@@
......@@@..................@...@@.........@@@......@@@
....................@..@.............@....@@.......@@@
.............@...@@........................@@@@....@@@
.......@@........@......................@...........@@
........@.@...................@......@...@@.....@...@@
........@@@.........@................@...@@.....@....@
......@.@@@................@.........@@@@@@.....@.....
@@...@@@@@@@.......@@.....@@........@@@@@@@@@@@@@@@...
@@..@@@@@@@@.....@..................@@@@@@@@@@@@@@@...
@@@@@@@@@@@@.....@@@@..............@@@@@@@@@@@@@@@....
@@@@@@@@@@@@....@@@@@@............@@@@@@@@@@@@@@@@@@@.
@@@@@@@@@@@@.......@@............@@@@@@@@..@@@@@@@@@@.
@@@@@@@@@@@@............@@.......@....@@@..@@@@@@@@@@@
@@@@@@@@@@@@............@@.@@..............@@@@@@@@@@@
@@@..@@@.@@@...............@@...............@@@@@@@@@@
@@.......@@................@@...@@........@@@@@@@@@@@@
@@@..@........................@...........@@@@@@@@@@@@
@@...@......................@@@........@..@@@@@@@@@@@@
@@@..@@.......@.............@@@...........@@@@@@@@@@@@
@.@.@@@.......@..........@@.@@......@@@....@@@@@@@@@@@
...@....................@@@.........@@@....@@@@@@@@@@@
.........................@..........@@@....@..@@@@@@@@
...................@@...............@@@.......@@@@@@@@
.......@@..........@@.......@@......@@@....@..@@@@@@@@
...@@@.@.............................@....@@..@@@@@@@@
..@@@@@@.............@.................@@....@@@@@@@@@
..@@@@@@......................................@@@@@@@@
@@@@@@@@@@......@......@@..@..........@.....@@@@@@@@@@
@@@@@@@@@@@...........@@@.........@@......@@@@@@@@@@@@
@@@@@@@@@@@..@....@...@@...............@@@@@@@@@@@@@@@
@@@@@@@@@@@..@@@.@@..@@@.............@.@@@@@@@@@@@@@@@
@@@@@@@@@@@@@@@@@@@@.@@@@@.........@.@@@@@@@@@@@@@@@@@
@@@@@@@@@@@@@@@@@@@@.@@@@@...........@@@@@@@@@@@@@@@@@
@@@@@@@@@@@@@@@@@@@@@@@@@.........@..@@@@@@@@@@@@@@@@@
@@@@@@@@@@@@@@@@@@@@@@@@..@..@....@@@@@@@@@@@@@@@@@@@@
@@@@@@@@@@@@@@@@@@@@@@....@........@@@@@@@@@@@@@@@@@@@
@@@@@@@@@@@@@@@@@@@@...............@@@@@@@@@@@@@@@@@@@
@@@@@@@@@@@@@@@@@..................@@@@@@@@@@@@@@@@@@@
@@@@@.@@@@@@@.@@@.................@@@@@@@@@@@@@@@@@@@@
@@@...@@@@@@@.@@@.................@@@@@@@@@@@@@@@@@@@@
@@@@......@....@@......@..........@@@@@@@@@@@@@@@@@@@@
@@@.....@.....@@@@............@.....@@@@@@@@@@@@@@@@@@
@@@.....@..@...@@..........@..@.@@@@@@@@@@@@@@@@@@@@@@
@@@@..@........@...........@@@@@@@@@@@@@@@@@@@@@@@@@@@
@@@@..........@@@..........@@@@@@@@@@@@@@@@@@@@@@@@@@@
@@@@................@@@@...@@@@@@@@@@@@@@@@@@@@@@@@@@@
@@@@@.......@.......@@.@...@@@@@@@@@@@@@@@@@@@@@@@@@@@
@@@@@......................@@@@@@@@@@@@@@@@@@@@@@@@@@@
@@@@...................@@@.@@@@@@@@@@@@@@@@@@@@@@@@@@@
@@@@.................@@@@@@@@@@@@@@@@@@@@@@@@@@@@@@@@@
8
44 7 0
33 25 0
9 44 0
6 21 0
8 23 0
26 29 0
17 8 0
14 24 0

17 50 0
33 26 0
31 11 0
39 31 0
5 42 0
3 12 0
17 49 0
35 26 0
