width 54
height 54
@@@@@..@@@....@@......@..@@@@@@@@@@@@@@@@@@@@@@@@@@@@@
.@@@@..@.@.@..............@@@@@@@@@@@@@@@@@@@@@@@@@@@@
.@@@@@...@...................@@@@@@@@@@@@@@@@@@@@@@@@@
.@@@@....@...............@..@@@@@@@@@@@@@@@@@@@@@@@@@@
..@@@@................@@@@.@@@@@@@@@@@@@@@@@@@@@@@@@@@
..@@@@................@@@@@@@@@@@@@@@@@@@@@@@@@@@@@@@@
@.@@@@..@........@..@@@@@@@@@@@@@@@@@@@@@@@@@@@@@@@@@@
..@@@........@...@..@@@@@@@@@@@@@@@@@@@@@@@@@@@@@@@@@@
....@......@.........@@@@@@@@@@@@@@@@@@@@@@@@@@@@@@@@@
@@........@@......@.....@@@@@@@@@@@@@@@@@@@@@@@@@@@@@@
@@@..@@....@............@@@@@@@@@@@@@@@@@@@@@@@@@@@@@@
@....@................@.@@@@@@@@@@@@@@@@@@@@@@@@@@@@@@
.....@....@.........@....@@@@@@@@@@@@@@@@@@@@@@@@@@@@@
@..........@@............@@@@@@@@@@@@@@@@@@@@@@@@@@@@@
@@........@@@........@@..@@@@@@@@....@@@@@@@@@@@@@@@@@
.@....@@....@.@.......@.@@@@@@@@@@...@@@@@@@@@@@@@@@@@
.....@@@.@............@...@@@@@@@@......@@@@@@@@@@@@@@
.....@@@@@@@@@@@..........@@@@@@@@....@@.@@@@@@@@@@@@@
@@@@@@@@@@@@@@@@@..........@.@...@.@@@@....@@@@@@@@@@@
@@@@@@@@@@@@@@@@@..................@@@.....@@@@@@@@@@@
@@@@@@@@@@@@@@@....@@......@@@.....@@@...@...@.@@@@@@@
@@@@@@@@@@@@@.....@........@.@..@..@@@@@.@.....@@@@@@@
@@@@@@@@@.@@@....@........@@.@.@@@@@@@@@@@@..@@@@@@@@@
@@@@@@@@..@@@............@@@...@@@@@@@@@@...@@@@@@@@@@
@@@@@@@@..@..............@.......@@@@.@@@.....@@@@@@@@
@@@@@@@@@.........@@..@......@@..@....@@@.....@@@@@@@@
@@@@@@@...........@@..........@...............@@@@@@@@
@@@@@@@........................................@@@@@@@
@@@...@@...........................@@@@..........@@@@@
@@@@..@...........@.....@@....@..@.@@@@..........@@@@@
@@@..............@@.....@@....@......@@@@@........@@@@
@@@.....................@.............@@.@........@@@@
@@@.@...................@..@..........@@..........@@@@
@@@.........@...........@..@..@.......@...........@@@@
@@@.........@@...............@@@@@...............@@@@@
@@@.......@@@..@@@@............@@.@..............@@@@@
......................@........@@................@@@@@
..................@.............@.....@@.........@@@@@
.@......@.............@..@....@.......@@..@....@@@@@@@
.....@..@......@........@..............@@...@@@@@@@@@@
........@......@.......................@@@@@@@@@@@@@@@
.........@......@...........@@.....@...@@@@..@@@@@@@@@
.........@@@....@......................@@@@@..@@@@@@@@
..........@@..............@..............@.....@@@@@@@
...........@......@@@.@.........@......@.......@@@@@@@
...........@......@@@@@............@@@.@.......@@@@@@@
.........@......@..@@@@@............@.............@@@@
.........@@.....@@@@@@@@...@@@@@..................@@@@
..@@...@@.....@@@@@@@@@@.....@@@@@.........@@@@...@@@.
..@@@@@@@@@@@.@@@@@@@@@..@...@@@@@@@@....@@@@@@...@@..
@@@@@@@@@@@@@@@@@@@@@@@.....@@@@@@.........@@@@.......
@@@@@@@@@@@@@@@@@@@@@@@@@@@@@@@@@@....@@@..@@@@......@
@@@@@@@@@@@@@@@@@@@@@@@@@@@@@@@@@@@@.@@@@@@@@@@@@@@@@@
@@@@@@@@@@@@@@@@@@@@@@@@@@@@@@@@@@@@@@@@@@@@@@@@@@@@@@
8
22 42 0
16 32 0
18 43 0
31 26 0
16 37 0
24 18 0
22 19 0
6 32 0

17 3 0
46 34 0
26 40 0
12 9 0
14 27 0
44 46 0
32 43 0
22 42 0
