width 98
height 98
@@@@@@@@@@@@@@@@@@@@@@@@@@@@@@@@@@@@@@@@@@..........@@@@@..@@@@@@@@.....@@@@.@@...@@@@@@@@@@@@@..@
@@@@@@@@@@@@@@@@@@@@@@@@@@@@@@@@@@@@@@@@@@...........@@@....@@@@@@@.....@@@@..@.@..@@.....@@@.@.@@
@@@@@@@@@@@@@@@@@@@@@@@@@@@@@@@@@@@@@@@@@@.....@@............@@@@@@.......@@....@@@@..........@.@.
@@@@@@@@@@@@@@@@@@@@@@@@@@@@@@@@@@@@@@@@@.......@@@..........@@@@@@@......@@.........@............
@@@@@@@@@@@@@@@@@@@@@@@@@@@@@@@@@@@@@@@@@.....@@@@...........@@@@@@@@.....@..........@@..@....@...
@@@@@@@@@@@@@@@@@@@@@@@@@@@@@@@@@@@@@@@@@.....@@@@........@@.@@@..@@@.......@.......@@@.......@...
@@@@@@@@@@@@@@@@@@@@@@@@@@@@@@@@@@@@@@@@@@@...@@@@.@.@....@@.@@.....@@.@@@@@@@....................
@@@@@@@@@@@@@@@@@@@@@@@@@@@@@@@@@@@@@@@@@@@....@@@@......@@@.@@..........@@@@@@....@..............
@@@@@@@@@@@@@@@@@@@@@@@@@@@@@@@@@@@...@@@@@@..........................@@@@@@@@@@@..@..............
@@@@@@@@@@@@@@@@@@@@@@@@@@@@@@@@@@@....@@@@@@........................@@@@@@@@@@@@.................
@@@@@@@@@@@@@@@@@@@@@@@@@@@@@@@@@@......@@@@@@..@.........@.........@@@@@@@@@@@@@@..........@.....
@@@@@@@@@@@@@@@@@@@@@@@@@@@@@@@@@@@@...@@.@@@..@.................@..@@@@@@@@@@@@@@................
@@@@@@@@@@@@@@@@@@@@@@@@@@@@@@@@@.........@.................@@...@@...@@@@@.@@@...................
@@@@@@@@@@@@@@@@@@@@@@@@@@@@@@@@@@........@@........@......@@@..@@@..@@@@....@........@@.........@
@@@@@@@@@@@@@@@@@@@@@@@@@@@@@@@@@@.....@@.@@@@......@@......@@.......@@@@.........@...@@@.........
@@@@@@@@@@@@@@@@@@@@@@@@@@@@@@@@......@@@@@@.@.@...@@.......@@...................@@...@@@.@.....@@
@@@@@@@@@@@@@@@@@@@@@@@@@@@@@@@@....@@@@@@@@....@@@@........@@.............@@@@......@@@..........
@@@@@@@@@@@@@@@@@@@@@@@@@@@@@..........@@..@.@..@..@....@@@.............@.............@@..........
@@@@@@@@@@@@@@@@@@@@@@@@@@.@@..........@@..............@@@@@......@@@............@....@........@@@
@@@@@@@@@@@@@@@@@@@@@@@@@@......@.....@...........@.......@......@@@@@.........@...............@@@
@@@@@@@@@@@@@@@@@@@@@@@@@...............................@........@@@@@.................@@...@@.@@@
@@@@@@@@@@@@@@@@@@@@@@@@@.......@...........@................@.@..@@@@.@....@@.@........@...@@@@@@
@@@@@@@@@@@@@@@@@@@@@@@@............@................@...@...@....@@@@@@....@................@@@@@
@@@@@@@@@@@@@@@@@@@@@@@@.................................@...@@....@@@@....@@@......@@@..@...@@@@@
@@@@@@@@@@@@@@@@@@@@@@@@...................................@..@.....@.@@@................@...@@@@@
@..@@@@@@@@@@@@@@@@@@@@@...................@...............@......@@@..@@.............@@@....@@@@@
...@@@@@@@@@@@@@@@@@@..@................@@.....@@@@..@...............................@@@@@......@@
..........@@@@@@@@@@@@..................@@.....@@@@@.@........@@...@.................@@@@@......@@
@........@@@@@@@@@@@@@....@...@@........@........@@...@...........@@.......@........@@@@@@...@@@@@
@........@@@@@@@@@@@@............................@@...@...............@......@.......@@@@@..@@@@@@
@........@@@@@@@@@@@@.............@...................@......................@@@.....@@@@@....@@@@
@@@......@@@@@@@@@@@@................................@@@...............@.....@@@@.....@@@@@...@@@@
@@@......@@@@@@@@@.........@@............@........@..@@@@....................@@@@.....@@@@@@.@@@@@
@@@.......@@@@...@.........@.......@.....@....@@....@@@........@@@.........@@@@@@.@...@@@@...@@@@@
....@......@@.........@...........@@....@......@@...@@@...@.............@.@@@@@@@...@@@@@@...@@@@@
...................@@.........@@.@@...........@@@.......@@@@@@..........@@@@@@@@..............@@@@
.................................@.....@...@@@@@@..@....@@@@@@..........@@@@@@@@..............@@@@
............@...............................@@@@@...@.....@@.....@...@..@@@@@@@@@@...............@
.........@@.@@..............................@@@@@@..............@@..@@@@@@@@@@@@@@........@@.....@
..........@@...@............................@@@@@@..............@@@.@@@@@@...@@@@@.............@@@
.....@....@@.....@@@@@...@.................@@@.@@@.....@.............@@@@@@..@@@@@............@@@@
.......@.@.......@@@@@.....................@@@.@.@@@.........@.........@@@@...@@@@..............@@
.................@@@.@............@.......@@.....@@@.............@.....@@.....@@@@...............@
................@@@.......................@@.......@...................@@.....@.@@..@@.........@@@
............@...@@@@..................@.....................@@@@......@...........@.....@@.....@@@
@..............@@@...............................@.......@@@@@@...................@..@..@@.....@@@
@................................................@@.......@@@@@@@@.....................@@.........
@@.........................@@......@.......@....@@@.......@@@@@@@@@@...................@...@@@@..@
@.........@.@....@.....@.@@........@@......@...@@@.........@@@@@@@@@@@.....................@@.....
...............@@@....@@@..........@@...........@@........@@@@@@@@@@@@...........@....@@@@.@@.....
..................@@...@@...........@......@........@.....@@@@@@@@@@@@@@.....@..........@@..@.....
.......@@@.........@@@.............@@......@...........@.@@@@@@@@@@@@@@@...@..@.......@.....@....@
....@..@.@@........@@..........@@.......................@@@@@@@@@@@@@@.........@....@.@.....@...@@
.........................@@.....@@@..................@..@@@@@@@@@@@@@@..............@...........@@
..........................@.....@..............@.....@.@@@@@...@@@@@@@@...@@............@@.....@@@
....................@........@..@@............@@@....@@@@@@@...@@@@@@.........@...............@.@@
.......@@................@...@.@..............@@.....@@@@@@@....@@@@@.@.....@....................@
...@..@@@@@.....@.........@..@@..................@@..@@@@@@@...@@@@.................@@..@.........
.......@@@@@....@......@@@@...........................@@.@@@...@@@............@.....@@@@@@@@......
.........@@@@...@@@@.@@@@@@..................@@.......@........@@............@......@@@@@@@@@.....
.........@@@@...@@@@@@@..@@...................@@..............@@@........@@..........@@@@@@@@.....
..........@@@.@..@@@@@.............@..............@.....@......@@@......@@........@.@@@@@@@.......
...........@@.....@@@.............................@@....@...............@@...........@.@@@@...@...
@@......@..@@.............................@............@@@...@.........@.@..............@@@.....@@
@.......@..@.............@...............@@............@...................@....................@@
@.......@................................@.@@..........@@.......................................@@
......@.@....@.......@................@....@@@@.......@@@@..............................@.......@@
....@@@.@......@.........................@@@@@@.......@@@@@...........................@@@..@.....@
..@.@@@@@......@....@.................@................@@@@...............@......@@..@@@@........@
.@...@@@@..@....................@....@@@............@.@@@@...........@...........@....@@@@......@@
...........@@..................@.....@@@..............@@@..@@.............@....@......@@@.......@@
...........@..................@@.......................@@.................@...@@@....@@@..........
..............................@@....................@@..@@......................@....@@.......@...
......@@..............@.......@.....@.......@.....@................@@@...............@@.......@...
......@............................................................@@@@..........@................
@.....@....................@.@....@.@@@........@...................@@@@....@@@@@.................@
@.........................@@.....@...............................@@@@@....@@@@@@.............@...@
@@...@..........@.....@....@.................@@.....@............@.@@@....@@@@@@.............@....
.@...@.........@@@..@......@@.............@...................@@@@..@@@....@@@@@..@@....@..@@.....
......@......@@@@@@..................@.....................@..@@@@........@@@@@@@@@@@.@....@@@@...
.....@@........@.......@............@...@..@...........@......@...........@@@@@@@@@@@.............
@@@...@.....@@.........@................@........@@.......@@.............@@@@@@@@@@@@.............
@@..........@....................................@..@..@..@..@@.......@@@@@@@@@@@@@@@@@.@@@......@
@@@@...........@@.............@..............@..@...@@......@@@........@@@@@@@@@@@@@@@@@..@......@
@@@....@@@..@@@@@.@@@.........@@@................@...........@@@.......@@@@@@@@@@@@@@@..........@@
@@@..@..@@@@@@@@@..........@@@.@@@@@........@..@@@@....@..............@@@@@@@@@@@@@@@@.......@@.@@
@@@..@..@@@@@@@@.......@@@@@@..@@@.........@@..@@@@....@..............@@@@@@@@@@@@@@@@.......@@@@@
@@......@@@@@@@@.......@@@@@@@..@....@@..........@.............@@@...@@@@@@@@@@@@@@@@@.@@@@@@@@@@@
@.......@@@@@@@@.......@@@@@@........@...........@......@.@@@......@@@@@@@@@@@@@@@@@@@@@@@@@@@@@@@
@.........@@@@@@.......@@@..@............@................@@@@....@@@@@@@@@@@@@@@@@@@@@@@@@@@@@@@@
...........@@@@@...........................................@@@@...@@@@@@@@@@@@@@@@@@@@@@@@@@@@@@@@
............@@@@..............@@..........@@....@.@.......@@@@@@.@@@@@@@@@@@@@@@@@@@@@@@@@@@@@@@@@
......@......@@@@.............@@..........@@@@@.@.......@@@@@@@@@@@@@@@@@@@@@@@@@@@@@@@@@@@@@@@@@@
.....@.......@@@@.............@@........@.@@@@......@@.....@@@@@@@@@@@@@@@@@@@@@@@@@@@@@@@@@@@@@@@
..............@@..@@@@@......@@@........@@@@@@@.....@....@@@@@@@@@@@@@@@@@@@@@@@@@@@@@@@@@@@@@@@@@
...........@.......@......@@@@@....@....@@@@@@@@@...@....@@@@@@@@@@@@@@@@@@@@@@@@@@@@@@@@@@@@@@@@@
..@........@@..............@@@@.........@@@@@@@@@.......@@@@@@@@@@@@@@@@@@@@@@@@@@@@@@@@@@@@@@@@@@
......@..@.@@@.............@@@@.....@..@@@@@@@@@.......@@@@@@@@@@@@@@@@@@@@@@@@@@@@@@@@@@@@@@@@@@@
8
45 91 0
50 6 0
94 53 0
45 65 0
24 74 0
16 46 0
75 45 0
73 30 0

69 58 0
2 90 0
86 21 0
91 23 0
82 66 0
60 67 0
78 24 0
68 57 0
