width 98
height 98
@@@@@..@@@@@@@@@@@@@@@@@@@@@@@@@@@@@@@@@@@@@@@@@@@@@@@@@@@@@@@@@@@@@@@@@@@@@@@@@@@@@@@@@@@@@@@@@@@
@@@@@@..@@@@@@@@@@@@@@@@@@@@@@@@@@@@@@@@@@@@@@@@@@@@@@@@@@@@@@@@@@@@@@@@@@@@@@@@@@@@@@@@@@@@@@@@@@
@@@@@...@@@@@@@@@@@@@@@@@@@@@@@@@@@@@@@@@@@@@@@@@@@@@@@@@@@@@@@@@@@@@@@@@@@@@@@@@@@@@@@@@@@@@@@@@@
@@@@@....@@@@@@@@@@@@@@@@@@@@@@@@@@@@@@@@@@@@@@@@@@@@@@@@@@@@@@@@@@@@@@@@@@@@@@@@@@@@@@@@@@@@@@@@@
@@@@@..@..@@@@@@@@@@@@@@@@@@@@@@@@@@@@@@@@@@@@@@@@@@@@@@@@@@@@@@@@@@@@@@@@@@@@@@@@@@@@@@@@@@@@@@@@
@@@......@@@@@@..@@@@@@@@@@@@@@@@@@@@@@@@@@@@@@@@@@@@@@@@@@@@@@@@@@@@@@@@@@@@@@@@@@@@@@@@@@@@@@@@@
@@@@.....@@@@@@..@@@@@@@@@@@@@@@@@@@@@@@@@@@@@@@@@@@@@@@@@@@@@@@@@@@@@@@@@@@@@@@@@@@@@@@@@@@@@@@@@
@@@..@....@@@@...@@@@@@@@@@@@@@@@@@@@@@@@@@@@@@@@@@@@@@@@@@@@@@@@@@@@@@@@@@@@@@@@@@@@@@@@@@@@@@@@@
@.....@....@@.....@@@@@@@@@@@@@@@@@@@@@@@@@@@@@@@@@@@@@@@@@@@@@@@@@@@@@@@@@@@@@@@@@@@@@@@@@@@@@@@@
...........@@...@@@@@@@@@@@@@@@@@@@@@@@@@@@@@@@@@@@@@@@@@@@@@@@@@@@@@@@@@@@@@@@@@@@@@@@@@@@@@@@@@@
........@.........@@@@@@@@@@@@@@@@@@@@@@@@@@@@@@@@@@@@@@@@@@@@@@@@@@@@@@@@@@@@@@@@@@@@@@@@@@@@@@@@
.............@.....@@@@@@@@@@@@@@@@@@@@@@@@@@@@@@@@@@@@@@@@@@@@@@@@@@@@@@@@@@@@@@@@@@@@@@@@@@@@@@@
.....@@........@...@@@@@@@.@@@@@@@@@@@@@@@@@@@@@@@@@@@@@@@@@@@@@@@@@@@@@@@@@@@@@@@@@@@@@@@@@@@@@@@
...................@@@@@@@.@@@@@@@@@@@@@@@@@@@@@@@@@@@@@@@@@@@@@@@@@@@@@@@@@@@@@@@@@@@@@@@@@@@@@@@
@..................@@@@@@@.@..@@@@@@@@@@@@@@@@@@@@@@@@@@@@@@@@@@@@@@@@@@@@@@@@@@@@@@@@@@@@@@@@@@@@
@...................@....@....@@@@@@@@@@@@@@@@@@@@@@@@@@@@@@@@@@@@@@@@@@@@@@@@@@@@@@@@@@@@@@@@@@@@
@@...........@..................@@@@@@@@@@@@@@@@@@@@@@@@@@@@@@@@@@@@@@@@@@@@@@@@@@@@@@@@@@@@@@@@@@
......@...@......@@...........@@@@@@@@@@@@@@@@@@@@@@@@@@@@@@@@@@@@@@@@@@@@@@@@@@@@@@......@@@..@@@
.................@............@@@@@@@@@@@@@@@@@@@@@@@@@@@@@@@@@@@@@@@@@@@@@@@@@@@@@...........@@@@
..@..............@...........@@@@@@@@@@@@@@@@@@@@@@@@@@@@@@@@@@@@@@@@@@@@@@@@@@@@@......@.....@@@@
..............@..@...........@@@@@@@@@@@@@@@@@@@@@@@@@...@@@@@@@@@@@@@@@@@@.............@......@@@
..@@......................@@@@@@@@@@@@@@@@@@@@@@@@@@@....@@@@@@@@@@@@@@@@@.....................@@@
.@@@@@.......@.......@@...@@@@@@@@@@@@@@@@@@@@@@@@@@@.........@@@@@@@@@@@@@@@...............@@@@@@
@@@@@@@......@.......@@.@@@@@@@@@@@@@@@@@@@@@@@@@@............@@@@@@@@@@@@@@@................@@@@@
@@@@@@@.@.........@@@@@.@@@@@@@@@@@@@@@@@@@@@@@@@@............@@@@@@@@@@@@@................@@@....
@@@@@@...@..@......@@@@.@@@@@@@@@@@@@@@@@@@@@@@@@@...........@@@@@@@@@@@@@@..................@....
@@@@@@...@..@.......@@@.@@@@@@@@@@@@@@@@@@@@@@@@@@..@.......@@@@@.@@@@.@..@.......................
@@@@@...@...@@.......@.@@.@@@@@@@@@@@@@@@@@@@@...@..........@..@@..@@@.@....................@.....
@@@.........@@.......@.@..@@@@@@@@@@@@@@@@@@@....@..............@..@......@...................@@..
@@@..................@.....@@@@@@@@@@@@@@@@@@@.....................@.................@@........@..
..@...........@......@......@@@@@@@@@@@@@@@@@@..@.......@.@..........................@......@.....
..@........@.........@@.....@@@@@@@@@@@@@@@@@...........@.@.............@..................@......
@.@...........@.........@@..@..@@@@@@@@@@@@@@...@@........@..........@@@@@@.......................
......@....@...........@@......@@@@@@@@@@@@@@@.......@...............@....@@......................
...................@@...........@@@@@@@@@@@@@@@@@....@.......@......@..................@...@......
...................@............@@@@@@@@@@@@@@@....@@....@.@....@.................................
...............................@@@@@@@@@@@@@@@@.....@.....@@....@.................................
..................................@@@@@@@@@@@@.............................@............@..@......
...........@....................@...@@@@@@@@@@@..........@@....@...........@..........@...@@@....@
..@@.......................@......@.@@@@@@@@@@@@@.....@....................@@....................@
.@@@......................@@.........@@@@@@@@@@@@.@@.@@.............@...............@...........@@
.@@@.................................@@@@@@@@@@@@@@@........@@......@........@......@@..........@@
@@@@..@@...............@.....@@@.....@@@@@@@@@..@@@@.........@..................@...@..........@@@
@@@@..@@@.@..........@@@.....@@@.....@@@@@@@@@.@@@@@...............@....@@..@..........@..........
@@@....@@.............@@.............@@@@@@@@@...@@@...............@.....................@@.......
@@@................@..@@...........@@@@@@@.@@.....@@.................@...................@@@......
@@@@@......@...@..@@..............@@@@@@@@..@...........@......@........@....@...........@@.......
@@@@@..@.@@@.@@@@@...........@....@@@@@@@@...@.......@.............@.........@@.........@@@.......
@@@@@......@@@@@@@.........@@@.........@@@...........................@....@..@........@@@@@.......
@@@@@.@....@@@@@@@.@...........@@@.....@.............@@.....@.@...@.............@.....@...........
@@@@@.@@@..@@@@.@@@@@@.........@@@..........................@...............@@.............@......
@@@@@@@.....@...@@@@@@.....................@........@@.......@.........@@..@.@.....@..............
@....@@.........@@@@@@@@..............@................................@@..@..@@.......@..........
......@@.@..@.@..@@@@@@@@@@..................@@........................@@..@.......@............@@
.........@@@@@@...@@@@.@@@@@................@@.............@..@.@@@..@@..........@...@.....@...@@@
........@.@@@@@@..@.........................@...@.@@@@.....@.....@@@@@@@.....................@@@@@
@@......@....@.......@.............@....@@......@...@...@@@......@@@@@@@@...@......@....@@@@@@@@@@
@@@.@..............................@............@........@......@@@@@@@@@...@@.....@....@@@@@@@@@@
@@@.......@@...........@..........@@............................@@..@@@@@@.@@@.@@..@....@@.....@@@
@@@@......@@.......................@@@........@@...........@...@@....@@@@@@@@@..@@....@.........@@
.@@@@....@@@@.......@....................@@...@....@..@@@@....@@@.@..@@@@@@@@@...@...........@...@
....@....@@@@..@..@.....................@@@............@@@...@@.......@@@@.@@@...@..@..........@@@
...............@...................@..@...@@.............@..@.@.............@@@........@.......@@@
@.........@.......@.....@@.................................................@@@@......@............
@@@..........@....@.@@...........................................@@.....@..@@........@@...........
@@@..........@@.....@@@......................@..............@...........@...@...@@...............@
@@@............@..@@@@@.......................@@.................................................@
@@@..........@@..@@@@@@.........@....@.....................................@@@@@.................@
@@...........@@...@@@@@.....................@....................@.......@@@@@@@.....@@...........
.............@@.@@@@@@@@@............@@@...@.............................@@@@@@@@.................
@@........@@.@@@@@@@@@....@.......@.@@@@.....@...@@.@@@................@@@@@@@@@@@.@@@@.@........@
@@........@@@@@@@@@@.@.......@.......@@..........@..@@............@....@@@@@@@@@@@@@@@@@@@.......@
.@@........@@@@@@@@@..@..........................@.@...................@@@@@@@@@@@@@@@@@@....@..@@
..@........@@@@@....@.@@@@@.....@....@@@....@@......................@..@@@@@@@@@@@@@@@@@@@......@@
............@@@..@....@@@@@@@@......@@@@....@.............@.....@...@@@@@@@@@@@@@@@@@@@@@@@...@@@@
............@@@@.@@...@@@@@@@@@.....@@@@@...@....@......@@@@...@@...@@@@@@@@@@@@@@@@@@@@@@@@@@@@@@
............@@........@.....@@.....@@@@@@....@@..@......@@@@...@@@@@@@@@@@@@@@@@@@@@@@@@@@@@@@@@@@
...........@.................@......@@@@.....@...@.....@@@@@..@@@@@@@@@@@@@@@@@@@@@@@@@@@@@@@@@@@@
.....@...@@@@@......................@@..................@@@@@@@@@@@@@@@@@@@@@@@@@@@@@@@@@@@@@@@@@@
.........@@@@.........@@@@.....................@........@@@@@@@@@@@@@@@@@@@@@@@@@@@@@@@@@@@@@@@@@@
..........@@.......@.....@............@..........@......@@@@@@@@@@@@@@@@@@@@@@@@@@@@@@@@@@@@@@@@@@
...............@.....................@@.@@.......@.......@@@@@@@@@@@@@@@@@@@@@@@@@@@@@@@@@@@@@@@@@
..........................@............................@@@@@@@@@@@@@@@@@@@@@@@@@@@@@@@@@@@@@@@@@@@
.........................@@@@@@@..........@........@@@@@@@@@@@@@@@@@@@@@@@@@@@@@@@@@@@@@@@@@@@@@@@
......................@.@@@@@@@@...................@@@@@@@@@@@@@@@@@@@@@@@@@@@@@@@@@@@@@@@@@@@@@@@
@............@......@....@@@@@@........@....@......@@@@@@@@@@@@@@@@@@@@@@@@@@@@@@@@@@@@@@@@@@@@@@@
.....@.......@@.....@...@@@@@@.......@...........@@@@@@@@@@@@@@@@@@@@@@@@@@@@@@@@@@@@@@@@@@@@@@@@@
..............@@........@@@@@.............@.....@@@@@@@@@@@@@@@@@@@@@@@@@@@@@@@@@@@@@@@@@@@@@@@@@@
@......@........@@@......@@@......@........@@@@@@@@@@@@@@@@@@@@@@@@@@@@@@@@@@@@@@@@@@@@@@@@@@@@@@@
@.........@@....@@@........................@@@@@@@@@@@@@@@@@@@@@@@@@@@@@@@@@@@@@@@@@@@@@@@@@@@@@@@
..........................@@.....@.@......@@@@@@@@@@@@@@@@@@@@@@@@@@@@@@@@@@@@@@@@@@@@@@@@@@@@@@@@
...@..........@......@@...@@.............@@@@@@@@@@@@@@@@@@@@@@@@@@@@@@@@@@@@@@@@@@@@@@@@@@@@@@@@@
...@@..................................@@@@@@@@@@@@@@@@@@@@@@@@@@@@@@@@@@@@@@@@@@@@@@@@@@@@@@@@@@@
...@@@@@@..............................@@@@@@@@@@@@@@@@@@@@@@@@@@@@@@@@@@@@@@@@@@@@@@@@@@@@@@@@@@@
...@@@@@...........@..................@@@@@@@@@@@@@@@@@@@@@@@@@@@@@@@@@@@@@@@@@@@@@@@@@@@@@@@@@@@@
.........................@.............@@@@@@@@@@@@@@@@@@@@@@@@@@@@@@@@@@@@@@@@@@@@@@@@@@@@@@@@@@@
.........................@@.............@@.@@@@@@@@@@@@@@@@@@@@@@@@@@@@@@@@@@@@@@@@@@@@@@@@@@@@@@@
........@@..@@@...@.....@@........@@@@.....@@@@@@@@@@@@@@@@@@@@@@@@@@@@@@@@@@@@@@@@@@@@@@@@@@@@@@@
8
54 53 0
76 49 0
56 47 0
77 52 0
73 37 0
96 51 0
12 56 0
16 94 0

33 51 0
5 62 0
6 62 0
38 55 0
59 24 0
6 45 0
80 64 0
36 84 0
