width 98
height 98
@@@@@@@@@@@@@.......@@@@@@@@@@@@@.....@@@..@@@@@@@@@@@@@@@@@@@@@@@@@@@@@@......@@@@@@.@.@@@@@@@@@@
@@@@@@@@@@@@....@...@..@@@@@@@@.....@......@@@@@@@@@@@@@@@@@@@@@@@@@@@@@@@.........@..@.@@@....@@@
@@@@@@@@@@@@.............@@@.........@......@@@@@@@@@@@@@@@@@@@@@@@@@@@@@.........@@..@.........@@
@@@@@@@@@.....@..........@@...................@@@@@@@@@@@@@@@@@@@@@@@@@@@@.....@..@...........@@@@
@@@@@@@@....@.@.........@@@................@@@@@@@@@@@@@@@@@@@@@@@@@@@@@@@.@@@@@........@..@@@@@@@
@@@@@@@@....@@....@@@...@@@@@@...@............@@@@@@@@@@@@@@@@@@@@@@@@@@@@.@@@@@..........@@@@@@@@
@@@@@@@@@@........@@@....@@@@@@@@@@..........@@@@@@@@@@@@@@@@@@@@@@@@@@@@@..@@@@............@@@@@@
@@@@@@@@@@.....@@......@.@.@@@@@@@@@@@@.@@...@@@@@@@@@@@@@@@..@@@@@@@@@@@@.....@@.......@.........
@@@@@@@@@@....@@....@@@@....@@@@@@@@@@.........@@@@@@.@@@@@@..@@@@@@@@@@@@@@@...................@.
@@@@@@@@@@.@@.@......@@@...@@@@@.@..............@@@@..@@@@@...@@@@@@@@@@@@.@@...@@................
@@@@@@........@......@@.@..@@@@..@@@....@....@........@@.@.......@@@@@@@@..@@.................@...
@@@..........@@...........@@@@@.........@........................@@@@@@@@..@@.....@@@............@
@@@@....................@@@@.........@..@............@..............@@@@..........@@@...........@@
@.@@...........@..........@.......@@..@@@@@@.........@@..........@@@@@@@@........@@@@........@...@
..@@...........@..........@.....@@@@...........@...................@@@@@@.......@@@@@............@
..........@...@..................@@@..........@@@@.......@...@............................@......@
............@@@.....@............@@@.@.....@...@@@................................................
..........@@...@.@..@.............@@.......@@@@@@@@.......@............@.........@................
............................@@..........@...@@@@@@@.....@.......................@@@.............@@
...@...@....................@@..................@@@................@.............................@
......................@............@....@.......@......................@..@..................@..@@
...@@.......@..@@..................@....@.......@....................@.......................@@.@@
................@.....@.................@.@.@...@...........................@....................@
.............@.......@........@.............@...@.........................@@@....@................
@@...........@..@@......@........................@........................@@@....@@............@@@
@@@.........@......@...@@.@................@@@...@@@......................@@@....@.....@@@@....@@@
@@@....................@@@@..............@@@@@.......@.......................@@..@....@@@@@@@..@@@
@@@...........@...........@................@@@...................@...........@@.....@@@@@@@@@@.@@@
@@@...@.....@@@@.....@@@........@@.........@@@................................@.@....@@@@@@@@@@@@@
@@@..........@@......@@@@@............@...@@.@........@@@..................@........@@@@@@@@@@@@@@
@@@..@@@@........@..@@@@@.............@...........@..@@............@.....@............@@@@@@@@@@@@
@....@@@@@....@@@@.@@@@@@...@@....@.@@...............@............@@....@.............@@@@@@@@@@@@
@@@..@..........@@...@..@..@@........@@.....................@....@@@...@@........@.....@.....@@@@@
..@@..........@..@.@......@@@.........@@@...................@....@...@@@@@@..@...@@...........@@@@
..............@@@@@.......@@@......@...@@................@@.@.........@@@@@.....@@....@.......@@@@
.............@@@@@@.....@.....@........@@................@@@@.......@@@@@.@................@.@@@@@
.......@@....@...@@@..............................@......@@@@..@....@.@@@...........@..........@@@
@@.@@..@@.......@@@...............................@.......@@@@.....@@.@@@@...@......@.@........@@@
@@..@.........@..@@.......................................@@@@.........@@....@......@@......@..@@@
...........@...@@@@@@..................................@...@@.@....@@....@.......@..@@.........@@@
...........@....@@@@@.....@.....@..........................@.......@..@..@...........@@@.........@
@..@.......@......@@.....@@@@...@.....................@@..................@....@.................@
@@@@......@......................................@......@@................@@......................
@@.....@.............@.......@.............@@.............................@.....@......@.....@...@
@@.............@..........@...................@@.........@@..............@@.....@......@@....@@@@@
...............@...@.......@@@..@.....@@.....@@................................@@@...@@@@..@@@@@@@
...........................@@@@@@..@........@@@...@....@@@....................@@@@..@@@@@@@@@@@@@@
...........@..@........@@....@@@@@.........@@@...@@@@....@@@@..@...@...@.......@@...@@@@@@@@@@@@@@
.....@.....@..@.............@@@@@@.........@@@...@@@@....@@@..@@...@@@......@@@....@@@@@@@@@@@@@@@
...........@.................@@@@...........@@...@@......@@........@@@@@@@@@@@@@@@@@@@@@@@@@@@@@@@
..............................@@@...........@....@...................@@@@@@@@@@@@@@@@@@@@@@@@@@@@@
........@@...........@@@@@@....@@....................@......@.........@@@@@@@@@@@@@@@@@@@@@@@@@@@@
@@......@..............@@@@........@............@@@..@@.....@@@.@@...@@@@@@@@@@@@@@@@@@@@@@@@@@@@@
@@......@@@@@...........@@@..@...................@@..@@@@.......@@@...@@@@@@@@@@@@@@@@@@@@@@@@@@@@
@....@..@.@@@@@@@...@...@@@..............@............@@@..............@@@@@@@@@@@@@@@@@@@@@@@@@@@
@..........@@@@@@..@.....@@...........@....@.....@...@@@@.............@@@@@@@@@@@@@@@@@@@@@@@@@@@@
............@@....@@.....@@........@.......@@..@....@.@@.....@@.......@@@@@@@@@@@@@@@@@@@@@@@@@@@@
............@@.....@..@............@.......@@..............@@.@........@@@@@@@@@@@@@@@@@@@@@@@@@@@
........@....@....@@....@..............@@...@...............@.@@..@....@@@@@@@@@@@@@@@@@@@@@@@@@@@
@@.....@......@...@@............................@@@@.............@@...@@@@@@@@@@@@@@@@@@@@@@@@@@@@
@......@...............@.......@....@..................@@@............@@@@@@@@@@@@@@@@@@@@@@@@@@@@
@@.....@@.......@....................@@.....@@..................@....@@@@@@@@@@@@@@@@@@@@@@@@@@@@@
....@@..@.@@@@@.............................@@.@.....................@@@@@@@@@@@@@@@@@@@@@@@@@@@@@
...@@@..@@@............@...@......@..........@......@............@.......@@@@@@@@@@@@@@@@@@@@@@@@@
..@@@@..@@.............@@..@.........@.....................................@@@@@@@@@@@@@@@@@@@@@@@
@@@@@..................@..........@@@....................................@@@@@@@@@@@@@@@@@@@@@@@@@
@@@@@.........@@@...@.............@@@@..........@.............@..@@@....@@@@@@@@@@@@@@@@@@@@@@@@@@
@@@@@.......@@..................@@@.@@........................@...@@......@@@@@@@@@@@@@@@@@@@@@@@@
@@@@@......@@@......................@...................@.@..........@....@@@@@@@@@@@@@@@@@@@@@@@@
@@@@@.......@@..@@@...@..@................@@@....@@.....@...@...@........@@@@@@@@@@@@@@@@@@@@@@@@@
@@@@@.......@....@@.@@@.@@...@@@.......@..@@...........@......@.@.........@@@@@@@@@@@@@@@@@@@@@@@@
@@@@@.......@..@.....@@@@@..@@.@.......@.....................@............@@@@@@@@@@@@@@@@@@@@@@@@
@@@@@....@@....@....@@@@@@@@@@.......@.........@..@@@....................@@@@@@@@@@@@@@@@@@@@@@@@@
@@@@@.....@..........@@@@@@@@@@@...@@..........@...@..@..@...............@@@@@@@@@@@@@@@@@@@@@@@@@
@@@@@.....@......@...@.@@@@@@@@@..............@....@....................@@@@@@@@@@@@@@@@@@@@@@@@@@
@@@@@@@..@@@@........@.@@@@@@@@@@@..........................@..........@@@@@@@@@@@@@@@@@@@@@@@@@@@
@@@..@@@.@@@@.......@@...@@@@..@@.......@...........................@..@@@@@@@@@@@@@@@@@@@@@@@@@@@
@@..................@@............@@@...............................@..@@@@@@@@@@@@@@@@@@@@@@@@@@@
@@@........@@.@@....@@.............@@............@@......................@@@@@@@@@@@@@@@@@@@@@@@@@
@@@.......@@@.@@.....@.....@@......@@...@@@..................@..@.........@@@@@@@@@@@@@@@@@@@@@@@@
@@@.@@....@@................@@@@@..@@@...................@@@.......@......@@@@@@@@@@@@@@@@@@@@@@@@
@@@.....@..................@@@@@@..@@@@@.......@@........@@..............@@@@@@@@@@@@@@@@@@@@@@@@@
...@....@..................@@......@@@@@@................@@.....@.........@@@@@@@@@@@@@@@@@@@@@@@@
.......@@..............@@@.........@@@@@@@...@..........@@@........@.......@@@@@@@@@@@@@@@@@@@@@@@
.................@....@@..........@@@@@@@@@..@@.........@@@@@...........@..@@@@@@@@@@@@@@@@@@@@@@@
.................@....@@.........@@@@@@@@@@@............@@@@@..............@@.@@@@@@@@@@@@@@@@@@@@
........@....@@@@........@.....@.@@@@@@@..@@....@..@.....@.@@....@@@........@.@@@@@@@@@@@@@@@@@@@@
.....@.......@.@@@....@@.......@..@@@@@@.......@......@@...@@.@...@@@@........@@@@@@@@@@@@@@@@@@@@
....@@.....@........@@.........@..@@@@................@@.....................@@@@@@@@@@@@@@@@@@@@@
.@@@@...@@@@........@............@....@......@@@@......@....................@@@@@@@@@@@@@@@@@@@@@@
.@@@@@@@@@@@.................................@.@@@.....@.....@............@...@@@@@@@@@@@@@@@@@@@@
@@@@@@@@@@@........@@@@...........@..........@.@@@@...........................@@@@@@@@@@@@@@@@@@@@
@@@@@@@@@@..........@@@...........@@....@@@.....@@@........@...................@@@@@@@@@@@@@@@@@@@
@@@@@@@@@@@...........@...........@@..@@......@@.@@........@@......@..............@@@@@@@@@@@@@@@@
@@@@@@@@@@@@...@@@@..............@@.........................@..@........@.........@@@@@@@@@@@@@@@@
@@@@@@@@@@.....@@@@..@@..........@@.........@@..............@...@@@@@..............@@@@@@@@@@@@@@@
@@@@@@@@@..................@@....@...........@@@...........@@@@@@@@@@..@.@@...........@@@@@@@@@@@@
@@@@@@@@@@@...@.....@......@................@@@@....@@....@@@@@@@@@@@@@@@@@.@@........@@@@@@@@@@@@
8
84 10 0
44 82 0
72 45 0
39 23 0
17 8 0
43 74 0
69 39 0
38 70 0

19 72 0
46 85 0
8 41 0
15 96 0
21 11 0
39 80 0
59 58 0
29 38 0
