width 98
height 98
@@@@@@@@@@...@@@........@@@@@@@@@@@@@@@@@@@@@@@@@@@@@@@@@@@@@@@@@@@@@@@@@@@@@@@@@@@@@@@@@@@@@@@@@@
@@@@@@@@@@..............@@@@@@@@@@@@@@@@@@@@@@@@@@@@@@@@@@@@@@@@@@@@@@@@@@@@@@@@@@@@@@@@@@@@@@@@@@
@@@@@@@@@@@.............@@@@@@@@@@@@@@@@@@@@@@@@@@@@@@@@@@@@@@@@@@@@@@@@@@@@@@@@@@@@@@@@@@@@@@@@@@
@@@@@@@@@@@.........@.@@@@@@@@@@@@@@@@@@@@@@@@@@@@@@@@@@@@@@@@@@@@@@@@@@@@@@@@@@@@@@@@@@@@@@@@@@@@
@@@@@@@@@@.............@@@@@@@@@@@@@@@@@@@@@@@@@@@@@@@@@@@@@@@@@@@@@@@@@@@@@@@@@@@@@@@@@@@@@@@@@@@
@@@@@@@@@@............@@@@@@@@@@@@@@@@@@@@@@@@@@@@@@@@@@@@@@@@@@@@@@@@@@@@@@@@@@@@@@@@@@@@@@@@@@@@
@@@@@@@@@@.............@@.@@@@@....@@@@@@@@@@@@@@@@@@@@@@@@@@@@@@@@@@@@@@@@@@@@@@@@@@@@@@@@@@@@@@@
@@@@@@@@@@@.............@.@@@.......@@@@@@@@@@@@@@@@@@@@@@@@@@@@@@@@@@@@@@@@@@@@@@@@@@@@@@@@@@@@@@
@@@@@@@@@@@.............@.@@.........@@@@@@@@@@@@@@@@@@@@@@@@@@@@@@@@@@@@@@@@@@@@@@@@@@@@@@@@@@@@@
@@@@@@@@@@@.......................@......@@@@@@@@@@@@@@@@@@@@@@@@@@@@@@@@@@@@@@@@@@@@@@@@@@@@@@@@@
@@@@@@@@.......................@........@@@@@@@@@@@@@@@@@@@@@@@@@@@@@@@@@@@@@@@@@@@@@@@@@@@@@@@@@@
@@@@@@@@@...@...........@.........@.....@@@@..@@@@..@@@@@@@@@@@@@@@@@@@@@@@@@@@@@@@@@@@@@@@@@@@@@@
@@@@@@@@@@.....@@.....................@.......@@@@..@@...@@@@@@@@@@@@@@@@@@@@@@@@@@@@@@@@@@@@@@@@@
@@@@@@@@@@@...........................@.....@........@...@@@@@@@@@@@@@@@@@@@@@@@@@@@@@@@@@@@@@@@@@
@@@@@@@@@@@@.@....@..........@.....................@@@...@@@@@@@@@@@@@@@@@@@@@@@@@@@@@@@@@@@@@@@@@
@@@@@@@@@@@@@@....@..............@@............@...@.....@@@@@@@@@@@@@@@@@@@@@@@@@@@@@@@@@@@@@@@@@
@@@@@@@@@@@@@@@...@.@......@......@.....@....@...@.......@@@@@@@@@@@@@@@@@@@@@@@@@@@@@@@@@@@@@@@@@
@@@@@@@@@@@@@@............@@.....................@.@........@.@@@@@@@@@@@@@@@@@@@@@@@@@@@@@@@@@@@@
@@@@@@@@@@@@@@@@......@...@@...............................@@..@@@@@@@@@@@@........@@@@@@@@@@@@@@@
@@@@@@@@@@@@@@@@@@@....@..@.....@......................@@..@@..@@@@@@@@@@@@.......@@@@@@@@@@@@@@@@
@@@@@@@@@@@@@@@@@@@..@@@....@...@.@........................@@..@@@@@@@@@@@@.......@@@@@@@@@@@@@@@@
@@@@@@@@@@@...@@....@@@@....@@.@@............@@@@@............@@@@@@@@@@@@......@..@@@@@@@@@@@@@@@
@@@@@@@@@@@.........@@.......@..@...........@@@..@@...........@@@@@@@@@@@@.@.......@@@@@@@@@@@@@@@
.@@@@@..@@....@.....@@..........@@@.....@.@@@@@.........@..@@@@@@@@@@@@@.@.@@@@....@@@@@..@@@@@@@@
.@@@@@...@...@..............@....@@...@@..............@..@@@@@@@@@@@@......@@@@....@@.@@@..@@@@@@@
.@@@@@................@@.........@@........@.............@@@@@@@@@@@@...@...@@@.@............@@@@@
.@@@...@...............@.....@@@@@@........@.............@@@@@@@@@..........@@@@@........@....@@@@
..@..............@.............@@..........@.............@@@@@@@@@@..@..........@.............@@@@
......@...@...@@@@......@@......@@.......@...............@@@@@@@.....@.........................@@@
.........@@..@@@............@...@...........@@.............@@@@@...@....@...@..................@@@
@@.......@@@@@@@...@@@@..@@.@@@@@............@............@@@@@@............@@..@...........@@@@@@
@@@......@@.@@...@@@@@@@.@@@@@@@@@@@...........@@@...@.@..@@@@@@.@........@@@@.............@@@@@.@
@@@@.............@@@@@@@@@@@@@@@@@@@...@......@@@@.....@....@@@.........@@@@@@............@@@@...@
@@@@@.............@@@@@@@@@@@@@..@@@..........@@@@@@@@@@.....@@.........@@@@@..@............@@.@.@
@.@@@.............@@@@@@@@@@@@@@...............@@@@@@@@@..@........@@@@@@@.....@..........@.@@..@@
..@@@.............@@@@@@@@@@@@@@@...........@@@@@@@@@@@..........@@@@@@@@.........................
.............@...@@@@@@@@@@@@@@@@@@.........@@@@@@@@@@@..........@@@@@@@@............@...........@
...................@@@@@@@@@@@@@@@@@.@....@.@@@@@@@@@@@............@@@@@@@.................@..@@@@
...................@@@@@@@@@@@@@@@@.........@@@@@@@@@@....@..@.....@@@@@..........@...........@@@@
@@@................@@@@@@@@@@@@@@@@@.@.......@@@@@@@....@....@.....@@@@@..........@............@@@
@@@@@@@@.............@.@@@....@@@@@..........@@@@@@@....@.......@..@@........@@...................
@@@@@@@@@....@.........@@@.....@@............@@@@@@@@..............@@........................@@...
@@@@@@@@..@............@............@@..........@@@@@..@.......................................@..
@@@@@@...@@.............@@...@.@@...@@...........@@@@@@@.............................@..........@.
...@@@...@@.@.....@@........@@.......@..@........@@@@@@@................................@.........
....@.................@@........................@@@...@@.....@@.@..................@.@@.@.....@.@@
....@..........@....@@.............@@.............@@......@.....@@@................@@.@@@...@@..@@
............@.........@@......@@@..........@.@....@@..................@.@..............@..@.@@..@@
............@@........@@..@@...............@@@........................@@@......@...@@.......@.....
..........@@@@@............@.......@...@....@@@..@......@.........@....@...........@@...@.........
..........@@@...@@......@@@@...............@@@@.@@@@@...........@.....@...@........@@@.....@......
.....@..........@@@....@@@@@......@.......@@@@@@@@@@@...@.......................@.................
.......@..@............@@@@.................@@@@@@@@@@@.................................@.........
..........@...........@@@....@@.@@..........@@@@.@@@@@@..........@.......@@@.................@....
.....................@@@@.......@@...............@@@.@@...@@.....................@...@............
..@@..........@.......@@@...@.............@......@@@.......@...@..........@@......@@@@@.....@@@@@@
...@@@@@@.....@@@......@@..@@@..........@........@@@...............@.....@@@...@..@@@@@.@...@@@@@@
@@.@@@@................@@@@@@....@...@............@...........@..@@@.....@@...@@@@@@@@@......@@@@@
.@...@................@@@@@@@.............@...@...@......@...@@..@@@@.........@@...@@@@......@@@@@
...@.@.............@....@@@@@..........................@@@@......@.@@@............@@@@@.@....@....
@..................@@....@@@..@....@@...................@@......@@.................@@.....@..@....
@@..@.............@@@.@..@...........@@.........@.......@.......@@.......................@@@......
@@..@.....@.@....@@@.........@@..........@@@@..@......@@........@@..@@@..................@@.......
@...@.......@.....................@@....@@@@@.@@....................@@@.......@..........@@@@@....
@............@@..........@@@@......@...........................@@@..@@@..................@@@@@@...
...........@@@@@.........@@@@@@....@.......................@...@.@..@@....................@@@@@@@.
...........@@@@@@@@@@@....@@@@@@...@....................@......@...@@.....@......@............@@..
@.........@@@@@@@@@@@@....@@@@@........................@@@....@@.................@..@....@.....@..
@...@....@@@@@@@@@@@@@....@@@@@@..............@@@.......@@...@@@..@@.............@@.@.............
@.......@@@@@@@@@@@@@......@@@@@...@.....@..@@...........@....@@................@@..@.............
@..@@...@@@@@@@@@@@@@...@@..@@@@...@......@.@@......@.........@...............@.................@@
@@@@@.....@@@@@@@@@@@.......@@.@..........@.@@@@@@..............................................@@
@@@@.....@..@@@@@@@@...................@....@@@@@@@................@..@.........................@@
@@@.........@@@@@@@@.......@...@....@.......@.@@@@.@..............................@...@.....@...@@
@@@...@....@@@@@@@@@..@@.........@.............@@.......@.....@.@@....................@@..@@@@@@@@
@@@.@...@..@@@@@@......@.........@@.....@...............@.....@..............@............@@@@@@@@
@@@.....@@@@@@@@.................@@...........................@..@@@........@@.....@......@@@@@@@@
........@@@@@@@........@.@.....@.@@.........@@@@.....@.....@..@..............@...........@@@@@@@@@
..@@@@@..@@@@@@......@......@@@@@@@@@@......@@@@@.....@....@.@@.@@.......@@........@.....@@@@@@@@@
@@@@@@...@@@@@@......@..@..@@@@@@@@@........@@@@@.@...@@.....@@.@@.......@@............@@@@@@@@@@@
@@@@@@...@@@@@@.....@@.....@@@@@@@@@........@@@@@@@...@......@@.@@@.......................@@@@@@@@
@@@@@@.@@@@@@@@....@.....@@@@@@@@....@.....@@.@@@@..............@@@................@.....@@@@@@@@@
@@@@@@@@@@@@@@@@.......@@@@@@.@...............@@@.........@.....................@..@.@...@@@.@@@@@
@@@@@@@@@@@@@@@@@.......@@@@...................@@.........@.....................@..........@.@@@@@
@@@@@@@@@@@@@@@@@@...@..@@@@.@.................@......@@@.......@.........@............@.....@.@@@
@@@@@@@@@@@@@@@@@@@@@@@@@@@@..........................@@@...............@.................@....@@.
@@@@@@@@@@@@@@@@@@@@@@@@@@@@....@@@@.@.........@....@@@@@...............@....................@@@..
@@@@@@@@@@@@@@@@@@@@@@@@@@@@@...@@@@@.@........@@.@..@@@@@@@@@.......@.....@@............@...@@...
@@@@@@@@@@@@@@@@@@@@@@@@@@@......@............@@@@@..@@@@@@@@@@@@@@........@@.......@@...@........
@@@@@@@@@@@@@@@@@@@@@@@@@@@.@@..@@............@@@@@@@@@@@@@@@@@@@@@........@@.......@.............
@@@@@@@@@@@@@@@@@@@@@@@@@@@@@@..@@.............@@@@@@@@@@@@@@@@@@@@.........@@......@@@..........@
@@@@@@@@@@@@@@@@@@@@@@@@@@@@@@..@@...........@@@@@@@@@@@@@@@@@@@@@@.................@@...........@
@@@@@@@@@@@@@@@@@@@@@@@@@@@@@@@@...........@@@@@@@@@@@@@@@@@@@@@@@....@.....@......@@@@@@...@.....
@@@@@@@@@@@@@@@@@@@@@@@@@@@@@@@...........@@@@@@@@@@@@@@@@@@@@@@@@.........@@....@@@@@@@@@@@@@@...
@@@@@@@@@@@@@@@@@@@@@@@@@@@@@@@@@@@.....@@@@@@@@@@@@@@@@@@@@@@@@@@@.............@....@@@@@@@@@@...
@@@@@@@@@@@@@@@@@@@@@@@@@@@@@@@@@@@....@@@@@@@@@@@@@@@@@@@@@@@@@@@@@@.........@.....@@@@@@@@@@@@@@
@@@@@@@@@@@@@@@@@@@@@@@@@@@@@@@@@@@....@@@@@@@@@@@@@@@@@@@@@@@@@@..@@@......@........@@@@@@@@@@@@@
@@@@@@@@@@@@@@@@@@@@@@@@@@@@@@@@@@@@@@@@@@@@@@@@@@@@@@@@@@@@@@@@........@@..@@@.......@@@@@@@@@@@@
8
76 45 0
28 8 0
17 6 0
55 26 0
55 81 0
72 54 0
11 57 0
85 64 0

41 77 0
27 30 0
18 75 0
56 42 0
42 80 0
14 6 0
6 50 0
85 75 0
