width 98
height 98
@@..@@@@..@....@@@@@..@@@@@@@@@@@@@@@@@@@@@@@@@@@@@@@............@@@@@@@.@@@@@@@@@@@@@@@@@@@@@@@@@
.@...@@@.......@@@....@@@@@@@@@@@@@@@@@@@@@@@@@@@@...@...............@@@...@@@@@@@@@@@@@@@@@@@@@@@
.@...@@@@..@..@@@@@...@@@@@@@@@@@@@@@@@@@@@@@@@@.....@.......@@......@@@....@@@@@@@@@@@@@@@@@@@@@@
.....@@@......@@@@....@@@@@@@@@@@@@@@@@@@@@@@@@@@...........................@@@@@@@@@@@@@@@@@@@@@@
.....@@......@@@@@@...@@@@@@@@@@@@@@@@@@@@@@@@@@@.......@@@........@.....@....@@@@..@@@@@@@@@@@@@@
@....@@......@........@@@@@@@@@@@@@@@@@@@@@@@@@@@......@....@@@.@...@....@....@....@@@@@@@@@@@@@@@
...................@....@@@@@@@@@@@@@@@@@@@@@@@@@@..........@.....@@@....@.........@@@@@@@@@@@@@@@
..............@..........@@@@@@@@@@@@@@@@@@@....@........................@@........@@@@@@@@@@@@@@@
.@............@@@.........@@@@@@@@@@.@@@@@@......@@..................@.........@...@@@@@@@@@@@@@@@
.........@...@........@..@@@@@@@@..@..........@..............@......@@..........@...@@@@@@@@@@@@@@
.@@.@@......@@......@@@@@@@@@@@@@....................................@.............@@@@@@@@@@@@@@@
.@@......@.........@@@@@@@@@@@@.@...@.....@@@....@@........@@........@......@......@@@@@@@@@@@@@@@
..@.....@@@......@@@@@@@@@@@..@...............@...................................@@@@@@@@@@@@@@@@
..@@....@@@......@@@@@@@@@@...@..............@..........@.............@@...@.....@@@@@@@@@@@@@@@@@
.@...........@.@@@@@@@@@@@...................@.....@.........@.@...............@@@@@@@@@@@@@@@@@@@
.............@.@@@@@@@@@@@..@@.....@......................@...................@@@@@@@@@@@@@@@@@@@@
@@..........@@@@@@@@@@@@@.........@@..........................................@@@@@@@@@@@@@@@@@@@.
@@..@....@.@@@@@@@@@@@@...........@...........@@@@.........................@.@@@@@@@@@@@@@@@@@@@@.
@@.....@..@@@@@@@@@@@@@...........@...........@@@@@@........................@@@@@@@@@@@@@@@@@@@@@.
@@....@@..@@@@@@@@@@@@@....@............@....@@@@@@@....................@...@@@@@@@@@@@@@@@@@@@@..
.......@..@.@@@@@@@@@@@.........@...@..........@@................@@@........@@@@@@@@@@@@@@@@@@@...
......@@....@..@@@@@@@.....@..........@...@....@..................@@@@....@@@@@@@@@@@@@@@@@@@@@@.@
.................@@@@.....................@.......................@@@....@@@@@@@@@@@@@@@@@@@.....@
..@@@@...@........@@@...........................@................@@@.....@@@@@@@@@@@@@@@@@@@.....@
....@.....@...@........@@...........@@...@.@@@@@@..........@......@.....@@@@@@@@@@@@@@@@@@@@.@....
....................................@....@.@@@@@@...................@@.@@@@@@@@@@@@@@@@@@@@......@
.......................@@@@@..@..............@@@@...................@@@@@@@@@@@@@@@@@@...........@
..@...............@....@@@@@@............@@..@@@@.......@.......@...@@@@@@@@@@@@@@@@@@...........@
..@@...........@..@...@@@@@@@.............@..@@@.......@@@......@@@@@@@@@@@@@@@@@@@@@@.@@@@@.....@
...@...........@@@@@...@@@@@@................@@........@@@@....@@@@@@@@@@@@@@@@@@@@@@@@@@@@@.....@
.........@......@@@@....@@.....@.@@@@@.......@@@.......@@@@.....@@@@@@@@@@@@@@@@@@@@..@@@....@....
..........@@..@..@@@@..........@@.@@@@.@@.....@@.........@@@....@@@@@@@@@@@@@@@@.@.@..@.@.........
..............@..@......@..........@@@@@@.....@@.........@@@@@..@@@@@.@@@@@@@@@@........@@@.......
@.........@@..@....................@@@@@@@....@@.........@@@...@@@@@..@@..@@@@@@........@@@.....@@
................................@@@@@@@@@@.................@.....@@.......@@@@@@.........@@....@@@
...............@.................@@@.@@@@@@................@......@.......@@@@.................@.@
...............@.......@..........@@.@@@@@@................@....@@@...@...@@@@...@...............@
@......................@...........@.@@..@@.....................@..........@@@...............@...@
.........@.@@@..........@..@...@.....@...@@@....................@.@..@.....@@@..............@@@@..
.@......@@..........@...........@........@@@................................@@..........@@..@@@@@@
...................@@@@@@@@@...................@..........@.........@@..@@..@.........@@@..@@@@@@@
.......@......@...@@@...@@@@@............@.....@.............@......@@@.....@.....@.........@@@@@@
.....@@@.........@................................................................@..........@@@@@
....@@.......@.......................@........@........@......................................@@@@
...@........@@@@@.............................@........@................@...................@@@@@@
...@@.........@@..............@..................@@..@.@@..@.............@.....@...........@@@@@@@
....@........@@@...@..@.....@....................@@@@@..........@.....@....@................@@@@@@
.......@.....@........@.@@.............@.........@@@@...........@......@.......@.........@.@@@@@@@
................@@@....@@...................@@@@@@@@@@.................@.............@.....@@@@@@@
..........@.....@@@..............@.....@..@.@@@@@@@@@@......@@@..................@@@......@@@@@@@@
.................................@...........@@@@@@@@@...@.......@................@@......@@@@@@@@
@.@............................@@@............@@@@@@@............@................@@......@@@@@@@@
@@@@................@.....@..............@....@@@@@@@@.....@@.@..............@....@@@....@@@@@@@@@
@@@@.@@......@....................@.....@@@@@...@.@@@........................@@.....@....@@@@@@@@@
@@@@@@@...@@@@...................@@....@@@@@@.@.....@.....@..................@@.....@@@@@@..@@@@@@
@@@@@@...........@@.@............@...@@@@@@@........@........................@@.......@@@@...@@@@@
@@@@@@....................@@@..@......@@@@@@....................@@........@.@.........@@....@@@@@@
@@@.@..............@..@@..@@@@@@....@@@@@@@@.....@@..........@...@...........@........@@....@@@@@@
@@............@.....@..@..@@@@@@@@..@@@@@@@@...@.@..@@@.@....@...............@.@@.............@@@@
@@............@..........@@@@@@@@@....@@@@@@.@...@..@@@.@.........@.............@..@@.........@@@@
@...............@....@@@@@@@@@@@@@........@@@@.........@@.......@...................@......@@@@@@@
@...............@@.@@@@@@@@@@@@@@..........@............@.......@.@@.......@...............@@@@@@@
@@....@..........@@@@@@@@@@@@@@@........................@.........@@@....@....@.......@.@@@@@@@@@@
.....@.......@@..@@@@@@@@@@@@@@@@@@@........@...........@.@@.....@@@@....@.............@@@@@@@@@@@
........@....@@..@@@@@@@@@@@@@@@@@@@@....@..@@@.....@@@...@@.....@@@@@.......@.......@.@@@@@@@@@@@
..@@@@@@@....@@..@@@@@@@@@@@@@@@@@@@@.......@@@......@@@@@.......@@.@................@.@@@@@@@@@@@
@@......@..@@@@@@@@@@@@@@@@@@@@@.........@@@@@@@.......@@@...@..@...@..@.............@@@.@@@@@@@@@
@..........@@@@@@@@@@@@@@@@@@@@@@@........@@@@@.........@@@@....@..........................@@@@@@@
@..........@@@@@@@@@@@@@@@@@@@@@@@.....@.@@@@@..........@@...................................@@@@@
@......@...@@@@@@@@@@@@@@@@@@@@@@@@......@@@@@...@...........................................@@@@@
@..........@@@@@@@@@@@@@@@@@@@@@@@@@.....@@@@@...@@@...................@.................@@..@@@@@
....@........@@@@@@@@@@@@@@@@@@@@@@@....@@@@@@..@@@@@...........@......@@@.....@..............@@@@
.......@....@@@@@@@...@@@@@@@@@@@@@@....@@@@@@....@@@@...@@....@@@.....@@@............@.....@@@@@@
......@@....@@@@............@@@@@@@@.....@@@@....@@@@@......@@@@@@.....@@@...@..............@@@@@@
@.....@@.@@@@................@@@..@...@@.@@@@.@......@.......@@@@@.........@...@....@........@@@@@
@@@....@.@@@@..............@...........@..@@..............@@@@@@@@@............@....@.....@@@@@@@@
@@@@@@.@..@@@@..........@..@@...........@.....@...........@.@@@@@@......@..@@@.@@@..@......@@@@@@@
@@@@@@@@...@@@.............@@........................@........@@@@...@.....@@@.....@@.........@@@@
@@@@@@@@....@@...@............@@.@@..........................@@@@....@.....@...@@..@@@@@......@@@@
@@@@@@@@@....@.................@.@@..........................@@@@....@............@@@@@@..@....@@@
@@......................@@.@......@.........................@@@@@.....................@@@@@...@@@@
........................@@....@@@@@..............@.....@@...@@................@@@.....@@@@....@.@@
....@..@@@..@..@...............@@@......................@.................@@@@@@@.@.@...@@....@.@@
.@.@@..@@@@@@@@...........@........@................@.....@...............@@@@@@@@@.............@@
......@@@@@@@@@...........@.............@.....@.@.......@@@.............@.@@@@@@@@................
.@..@..@@@@@@@@............@............@@@...@.........................@@@@@@@@@@......@.........
.@@@@@@@@@@@@@...........@..............@.................@..........@..@@@@@@@@@@@.@@............
@@@@@@@@@@@@@@@......................@@@@@...............@@..........@@@@@@@@@@@@@@..........@....
@@@@@@@@@@@@@@@@.....@@.@@@...........@@........@@.@....@@@..........@@@@@@@@@@@@@@.....@.........
@@@@@@@@@@@@@@@@@@.@.....@.......@..@@..................@@@....@........@@@@@@@@@@................
@@@@@@@@@@@.@@@@@@.@..............@@@...........@..............@........@@@@@@@@@@..@......@@@@@..
@@@@@@@@@...@@@@@@.......@@..@..@............@.....@..@.......@......@..@@@@@@@@@@@........@@@@@..
@@@@@@@@@.....@@.........@@.@................@@@@..@@.@@.............@@@@@@@@@@@.......@@@@@@@@@@@
@@@@@@@@@................@@@@@.....@@......@@@@@@................@....@@@@@@@@@......@@@@@@@@@@@@@
@@@@@@@@........@........@@@@@.....@@......@@@@@@.....................@@@@@@@@@......@@@@@@@@@@@@@
@@@@@@@@..@...............@@@@......@@@@...@@@@@@..@..................@@@@@@@@@......@@@@@@@@@@@@@
@@@@@@@@@.................@@@@@@@....@@@.@@@@@@@@@@@..................@@@@@@@@@......@@@@@@@@@@@@@
@@@@@@@@@..@@...........@@@@@@@@@......@@@@@@@@@@@@..@@.@...........@@@@@@@@@@.......@@@@@@@@@@@@@
8
90 77 0
8 78 0
13 60 0
41 32 0
25 52 0
35 56 0
90 58 0
80 51 0

17 27 0
97 16 0
88 53 0
17 7 0
1 45 0
88 35 0
12 2 0
24 8 0
