width 98
height 98
@@@@@@@@@@@@@@@@@@@@@@@@@@@@@@@@@@@@@@@@@...@@@.....@@@@@@........@@@@@@@@@@@@@@@@@@@@@@@@@@@@@@@@
@@@@@@@@@@@@@@@@@@@@@@@@@@@@@@@@@@@@@@@@@.........................@@@@@@@@@@@@@@@@@@@@@@@@@@@@@@@@
@@@@@@@@@@@@@@@@@@@@@@@@@@@@@@@@@@@@@@@@@...........................@@@@@@@@@@@@@@@@@@@@@@@@@@@@@@
@@@@@@@@@@@@@@@@@@@@@@@@@@@@@@@@@@@@@@@......@@@...@.............@...@@@@@@@@@@@@@@@@@@@@@@@@@@@@@
@@@@@@@@@@@@@@@@@@@@@@@@@@@@@@@@@@@@@@@........@...........@...@.....@@@@@@@@@@@@@@@@@@@@@@@@@@@@@
@@@@@@@@@@@@@@@@@@@@@@@@.@@@@@@@@.@@@@@...........@............@.@...@@@@@@@@@@@@@@@@@@@@@@@@@@@@@
@@@@@@@@@@@@@@@@@@@@@@@@...@@@@@@..@@@@......@.@..@@.................@@@@@@@@@@@@@@@@@@@@@@@@@@@@@
@@@@@@@@@@@@@@@@@@@@@@@@....@@@@@.................@@@.@....@@@@......@@@@@@@@@@@@@@@@@@@@@@@@@@@@@
@@@@@@@@@@@@@@@@@@@@@@@@.@..@@..@@.........................@.@.......@@@@@@@@@@@@@@@@@@@@@@@@@@@@@
@@@@@@@@@@@@@@@@@@@@@@@@@@..@.......................................@@@@@@@@@@@@@@@@@@@@@@@@@@@@@@
@@@@@@@@@@@@@@@@@@@@@@@@@@....@.....@................@..@@@.........@@@@@@@@@@@@@@@@@@@@@@@@@@@@@@
@@@@@@@@@@@@@@@@@@@@@@@@@@..........................@@@@@@@@........@@@@@@@@@@@@@@@@@@@@@@@@@@@@@@
@@@@@@@@@@@@@@@@@@@@@@@@@.............@.............@@@@@@@@@......@@@@@@.@@@@@@@@@@@@@@@@@@@@@@@@
@@@@@@@@@@@@@@@@@@@@@@@@@.............@.............@@@@@@@@@....@.@@@@@@.@@@..@@@@@@@@@@@@@@@@@@@
@@@@@@@@@@@@@@@@@@@@@@@@@.............@............@@@@@@...@@...@.@@@@@@.@@@...@@@@@@@@@@@@@@@@@@
@@@@@@@@@@@@@@@@@@@@@@@@@@.........@@.............@@@@@@@@@..@@@..@@@@@@.........@@@@@@@@@@@@@@@@@
@@@@@@@@@@@@@@@@@@@@@@@@............@@@@@..........@@@@@..@...@.......@@.....@..@@@@@@@@@@@@@@@@@@
@@@@@@@@@@@@@@@@@@@@@@@@............@@@@...........@@.@...@@..@@.@....@@.........@@@@@@@@@@@@@@@@@
@@@@@@@@@@@@@@@@@@@@@@@@.......@...@@@@.......@....@@.........@@...........@...@..@@@@@@@@@@@@@@@@
@@@@@@@@@@@@@@@@@@@@@@..............@@.............@...........@..................@@@@@@@@@@@@@@@@
@@@@@@@@@@@@@@@@@@@@@@@@@@.........................@......................@@......@@@@@@@@@@@@@@@@
@@@@@@@@@@@@@@@@@@@@@@@@@@@@............................@@.....@............@@...@@@@@@@@@@@@@@@@@
@@@@@@@@@@@@@@@@@@@@@@@@@@@..@............@.........................@@.............@@@@@@@@@@@@@@@
@@@@@@@@@@@@@@@@@@@@@@@@@@@@.@.@.@...............................@@.................@@@@@@@@....@@
@@@@@@@@@@@@@@@@@@@@@@@@@@@@@......@.@........................@@..@.................@@.@.@@@....@@
@@@@@@@@@@@@@@@@@@@@@@@@@@@@@@..@............@@...............@...........@..............@@@....@@
@@@@@@@@@@@@@@@@@@@@@@@@@@@@@@@..............@....@...@@....@.@..........@@......@..............@@
@@@@@@@@@@@@@@@@@@@@@@@@@@@@@@@@......@@@.@...@.@.@.@@@@@@@@@.@.................................@@
@@@@@@@@@@@@@@@@@@@@@@@@@@@@@@@@@.....@@@...............@.@@..@..@.@..@........................@@.
@@@.@@@@@@@@@@@@@@@@@@@@@@@@@@@@@........@.....@@..@.@@..........@.......................@.....@..
@@..@@@@@@@@@@@@@@@@@@@@@@@@@@@@@@@@@..........@@@.@@@.............@....@@...........@...........@
.....@@@@@@@@@@@@@@@@@@@@@@@@@@@@@@@@..........@@...........@..@..@@......@.....@....@......@@....
....@@@@@@@@@@@@@@@@@@@@@@@@@@@@@@@@...........@@@............@@@..@........................@.....
...@@@..@....@@@@@@@.@@@@@@@@@@@@@@@..........@@@@@@...............@@.................@@@.........
..@.@.........@.@@...@@@@@@@@@@@@@@@@...........@..............@.........@...........@@@@@........
..............@.......@@@@@@@@@@@@@@@..@@@@@....@.....@............@............@....@@@@@........
..............@......@@@@@@@@@@@@@@@@@.@@@......@........................@....@.@.....@@@@......@@
.......@@.........@.@@@@@@@@@@@@@@@@@..@....@@....@.@...........................@.......@.......@@
............@.......@@@@@@@@@@@@@@..........@@.@@@@..............................@......@......@@@
....................@@@@@@@@@@@@@@..............@@@......@@..@@......@@@...@...............@.@@@@@
@@............@@.....@@@@@@@@@@@@............@@@@@@.@.......@.@...............@......@@.........@@
@@...........@@........@@@@@@@@@.........@@@@@@@@@....@.......@..@@@...@...........@@@@.........@@
@.........................@@..@....@......@@@@@@@..@@............@@@.@.............@@@@@@@@.....@@
@..................................@......@@@@@@@@@...............@..@..........@@@@@@@@@@@.......
@.......................@...............@@@@@@@@@@@@@...@@...............@......@@@@@@@@@@@@@..@@.
.................................@@.....@@@@@@@.@@@@....@@.@@@..................@@@@@@@@@@..@..@@.
................................@@.....@@@@@@...........@@.@@.......@.........@@@@@@@@......@..@@@
.........................@......@@......@@@@@@...............................@@@@@@@@@......@...@@
......................@.@@..............@..@@...@...................@.......@@@..................@
...........................................@@@.@....@.......@......@.............................@
@....@@@@......@@........@.@..........@......@..............@@@..@@@...........@@@@.............@@
@...@@@@@@..@@..@@....@.....................@@........@.....@@@..@@@.@.........@@@@@@@@.........@@
@@@@@@@@@@@@..........@@..@......@@...@...............@@@...@@@@...@@@.......@@@@@@@@@@.........@@
@@@@@@@@@@@@@.......@@@@@.........@.....@@...........@@@....@@@@............@@@@@@@@@@@...@......@
.@@@@@@@@@@@@@......@@@...................@...........@....@@@@.....@.....@@@@@@@@@@@...@........@
.@@@@@@@@@@@@.....................@@...........@.@....@.@@.................@@@@@@@@@@@............
.....@@@@@@@@.......@....@@..@@...@@...........@@@@@.......................@@@@@@@@@@@..@.......@.
.....@@@@@@@@.@..........@@.......@@..@.......@@@@@@.......................@@@@@@@@@@@@@@@........
@@....@@@@@@............@@@@@......@@.........@@@@@..........@........@..@@@@@@@@@@@@@@@@@...@....
@@....@@@@@@......@...@..@@@@...............@@@@@..........@.@@.......@....@@@@@@.@@@@@@@.........
@......@@@.@@.....@.@@@@@@@.............@...@@@@@@.......................@@@@@@@@.@.@@@...........
......@@@@......@.@..@@@@@.............@@...@@@@@@..................@@......@@@@..................
@....@@@@.......@@@@@@@@@..@...........@@..@@@@@@@@@................@......@@@@@.....@............
@@....@@@.......@@@@@@.....@.....@..........@@@@@@@@....@......................@.............@....
@@................@.@@......................@@@@@@@...@.@.............@......@............@@......
.................@................@..........@@@@@@..@..@@@@..@.........@.................@.......
.............@@....@.........................@@@@@@@......@@............@.................@@@@@...
......@@.........@.@.....................@.@@@@@@@@@@.....@...................@.........@.@@@@...@
.......@@@.........@.....................@@@@@@@@@@@@@@...@..........@........@.......@@@@@@@@@@@@
@.............@@.........................@@@@@@@@@@@@@@.......@...........@.@.........@@@@@@@@@@@@
@@....@.........................@........@@@@@@@@@@@@@@@........@.........@@@@@@....@.@@@@@@@@@@@@
@@...@@@.........@@@@........@@..........@@@@@@@@@@@@@@@.................@@@@@@@.@..@@@@@@@@@@@@@@
@@.@..@.......@@..@@@........@.........@@@@@@@@@@@@@@@@@.@....@@....@.....@@..@@@@@@@@@@@@@@@@@@@@
@@@@.......@..@@...@@...................@@@@@@@@@@@@@@....@@........@.........@@@@@@@@@@@@@@@@@@@@
..............@@...@@@.........@...........@@@@@@@@@@@.@..@.....@...@@..@....@.@@@@@@@@@@@@@@@@@@@
..@@@..............@@@...........@@.........@@@@@@@@@@..............@@@........@@@@@@@@@@@@@@@@@@@
....@@............@@@@.........@..@........@@@@@@@@@@@@...@..........@......@@.@@@@@@@@@@@@@@@@@@@
....@.............@@@@..........@@@@@......@...@@@@@@@@.....................@@@@@@@@@@@@@@@@@@@@@@
.@.........@......@@............@@@@@............@@@@@@@.......@..........@@@@@@@@@@@@@@@@@@@@@@@@
.....@@..........................@@@@@@@........@@@@@..........@@..@@.@.@@@@@@@@@@@@@@@@@@@@@@@@@@
....@@@..@...........@............@@@@............@..........@@@@..@@@@@@@@@@@@@@@@@@@@@@@@@@@@@@@
..@..........@........@.........@...@@..@...@..........@@@....@@@@@@@@@@@@@@@@@@@@@@@@@@@@@@@@@@@@
.......@........@@....@@................@.....@........@@......@@@@@@@@@@@@@@@@@@@@@@@@@@@@@@@@@@@
....@..@.............@...........................................@@@@@@@@@@@@@@@@@@@@@@@@@@@@@@@@@
................................@.................................@@@@@@@@@@@@@@@@@@@@@@@@@@@@@@@@
......................@.......@.@...@............................@@@@@@@@@@@@@@@@@@@@@@@@@@@@@@@@@
....@...................@............................@..@@.......@@@@@@@@@@@@@@@@@@@@@@@@@@@@@@@@@
..........@@.......@....@...............................@.......@@@@@@@@@@@@@@@@@@@@@@@@@@@@@@@@@@
........................@...@....@.......@.......@..............@@@@@@@@@@@@@@@@@@@@@@@@@@@@@@@@@@
.......................@@.@......@.......@...@.......@@@.@@.....@@@@@@@@@@@@@@@@@@@@@@@@@@@@@@@@@@
..........................@@.........@@.........@......@@@@.....@@@@@@@@@@@@@@@@@@@@@@@@@@@@@@@@@@
.................@@@.................@@.............@@.@@@@......@@@@@@@@@@@@@@@@@@@@@@@@@@@@@@@@@
.................@@@.................@@@...@@@.....@@@@@@@@@@@.@@@@@@@@@@@@@@@@@@@@@@@@@@@@@@@@@@@
.............@@@@@@@.......@.....@@@@@@@@...@@....@..@@@@@@@@@.@@@@@@@@@@@@@@@@@@@@@@@@@@@@@@@@@@@
.......@@@.@@@@@@@@@@.@.......@@@@@@@@@@@...@.....@@...@@@@@@@@@@@@@@@@@@@@@@@@@@@@@@@@@@@@@@@@@@@
.......@@@@@@@@@@@@@@@@.......@@@@@@@@@@@...............@@@@@@@@@@@@@@@@@@@@@@@@@@@@@@@@@@@@@@@@@@
........@@@@@@@@@@@@@@@........@@@@@@@@@@...............@@@@@@@@@@@@@@@@@@@@@@@@@@@@@@@@@@@@@@@@@@
........@@@@@@@@@@@@@@@@@@..@.@@@@@@@@@@@@@@@@......@@..@@@@@@@@@@@@@@@@@@@@@@@@@@@@@@@@@@@@@@@@@@
8
77 14 0
63 2 0
38 72 0
5 44 0
95 63 0
29 95 0
43 39 0
66 64 0

21 81 0
24 85 0
31 10 0
61 82 0
69 37 0
58 26 0
43 39 0
60 43 0
