width 98
height 98
......@@@@@@@@.................@@..@@.......@@...@....@@@@@@@@@@@@@@.......@@@@@@@@@@@@@@@@@@@@@@@
.@.@...@@@@@@@....@...........@@........................@@@@@@@@@@@@...@.....@@@@.@@@@@..@@@@@@@@@
........@@.@@@@@..................@........@...............@@@@@@@@@........@@..@.@@@@@..@@@@@@@@@
.@..........@@@@@.................@@.....@..............@..@@@@@@@@@..@@..@@@......@@@...@@@@@@@@@
....@.......@@@@@......................@.@....@....@.......@@@@.@@@@...@@..........@.....@@@@@@@@@
@@@.........@@@@@........................................@@@@@@.@...............@.......@@@@@@@@@@
@@@.........@@@@..............@@.@@@.........@@@@.........@@@@@...........................@@@@@@@@
@@@.........@@....@...@@......@..@@@@...@......@@........@@@@@@..........@@@@@......@.....@@@@@@@@
@@@@@..................@...@@@@..@@@@..@....@.@.........@@@@@@@..........@@@..............@@@@@@@@
@@@@@.......................@....@@@@..@....@@@@.@@.....@@@@@@@.@.........@@......@..........@@@@@
@@@@@@.............................@@....@@.@@@@@@@@....@@@@@@@...........@@............@......@@@
@@@@@@.............................@......@@@@@@@@@.......@@@@............@@...@..................
@@@@@@@@..................................@.@@@@@....@....@@@...........@@@@......................
@@@@@@@@@......@........@@..................@@@@.........@@@@@..........@@...........@............
@@@@@@@@@@..........@...@@@@.........@......@.@@........................@.....@@...............@@@
@@@@@@@@@.@............@@..@@.......................@.............@..@.@@.....@@.................@
@@@@@@@@@..@@..................@...................................@.@.......................@.@.@
@@@@@@@.@.......@.............@@..............@@...................................@@@@@@....@@@.@
@@@@@@@.................@@........................@....................@@@....@@....@.@@@....@.@@@
@@@@@........@....................@...............@@.........@.......@.@@@.....@....@.............
@@@..........@.@.................@@................@...................@............@.....@......@
@@@@..@...@......................@......................@@.........@......@.................@.....
@@@......................@@...............@@............@@...@....................................
................@@@.......@..........@@.........@......@@@..................@@...@..@.........@..@
.............@..@@@....@.@@.....@..@.@@@..@...@........@@@@.@...@...@@@@@@..........@@@@..........
...@@.......@@..@@@......@@........@@@........@.......@@@@@@@@.@.........@@.........@@@@...@......
.@..........@@.@......@...@.......@@@@........@.......@@@@@@@.@@............@........@@@@.@@......
............@@@@@....@@..........@@@@@....@@..................@@............@.@...@@.@@@@.......@@
..@.........@.........@........@@@@@.......................@..................@......@@.@....@@@@@
..@.........@....@.............@@@@@......@.......@@@......@..................................@@@@
..@..................@@...........@.......@....@...@.....................@....................@@@@
..@.............@....@....................@@....@........................@@....@...@..........@@@@
............@...@...@@..................@......................................@@@@@........@.@@@@
.........@@@...@@.@.@@..........................................................@@@@.......@@@@@@@
...................@@@@@..........@.................@.@.......@@................@@@........@@@@@@@
........@.......@...@@@......................@...............@@@..................@....@...@@@@@@@
.......@@....@..........@@.......@..........@@......@..@....@@@@@.................@....@.....@@@@@
......@@....@@..........@..@................@@@@@@..@....@...@@@@.@..@..@............@.@.....@@@@@
....@@@@..@....@.........@.@.@.......@.....@@@......@........@@@@@...@@...........@..........@@@@@
..@.@@@@...............@@@@@@.......@......@@@@@..................@..@........................@@@@
@@@@@@..........@@..@.@@@@@@@...@@@....@.@@@@@@@................................@........@..@.@@@@
@@@@@@.......@....@.@.@@@@@@@..@@@@......@@@@@........@@@@@............................@.......@@@
@@@@@@................@@@@@@@@@@@@@.@..@@@@@@@@@@.....@@@@@...@..@......@@...@@...@.......@...@@@@
@@@@@@.......@..........@@@@@@@@.......@@@@@@@@@@.@...@@........@@...........@@.@.@@@..........@@@
@@@@@@.......@@@@.....@@@@@@@@@@.........@@@@@.@@.@...@@@......@@@..@@.......@@............@...@.@
@@@@@@..........@@.....@@@@@@@@@...@.....@@@@@......@@@@......@@@@..@@.....@..@....@........@....@
.....@@@@@@.....@@@...@@@@@@@@@.........@@@@@@@.......@@.@....@@....@@..@.....@........@.........@
......@@........@@@....@@@@@@@@...@@....@@@@@@@...@...........@@@@....................@@........@.
.@@....@................@@@@@.@........@@@@@@@@...............@@@@....@.@..............@@.........
@@@.@...................@@@@@...........@@@@@@@@......@.....@@.......................@@@@@.@......
@...@...................@@@@@............@.@@@@@....@....@@.@@..........@............@@@@@@@@@@@@.
@.........@....@@.....@.@@..........@......@@@@@.@..@..@@......@.@...@.@@...........@@@@@@@@@@@@@@
.....@....@@...@@@......@@...@.............@@@@@@@.@@@@@@.@......@....@@...........@@@@@@@@@@@@@@@
..........@@..............................@@@@@@@@@@@@@@@@@@.....@....@@...........@@@@@@@@@@@@@@@
..........@.....@.......................@@@@@@@@@@@@@@@@@@@@@..@.@..................@@@@@@@@@@@@@@
..@..........@..................@@@...@@@@@@@@@@@@@@@@@@@..@@..........@............@@@@@@@@@@@@@@
......................@@@.....@.........@@@@@@@@@@@@@@@@@..@.......@................@@@@@@@@@@@@@@
.....@..............@..@@@................@@@@@@@@@@@@@@........@.......@.@........@@@@@@@@@@@@@@@
..........@............@@...................@@@@@@@@@@@@.........................@.@@@@@@@@@@@@@@@
...@...................@....................@@.@@@@@@.@@@@......@.@@.@..............@@@@@@@@@@@@@@
.......@..........@...@@.......................@@@@@@.@@@.........@@................@@@@@@@@@@@@@@
.......@............................@...........@@@@@.@............................@@@@@@@@@@@@@@@
.......@.@...@.....................@@....@..........@........@@@..............@@@@@@@@@@@@@@@@@@@@
.........@@@........@........@...........@...@..............@@@@.......@..@@@@@@@@@@@@@@@@@@@@@@@@
..@...........@..@........@.@@......@.....................@@@@@@@@.........@@@@@@@@@@@@@@@@@@@@@@@
.......@..................@.@............................@@@@@@@@@.......@..@@@@@@@@@@@@@@@@@@@@@@
.........@.@.@@@....@.......................@.........@@..@@@@@@@@.@@....@@@@@@@@@@@@@@@@@@@@@@@@@
.............@@..@.........................@@@........@@@...@@@@@@@@...@@@....@@@@@@@@@@@@@@@@@@@@
.............................@.............@@@@@......@@@...@@@@@@@@..@@@@...@@@@@@@@@@@@@@@@@@@@@
.....@@.....................@@@......@@.@.............@@@@..@@@@@@@@@@@@@@...@@@@@@@@@@@@@@@@@@@@@
@...@@@@...........@@@......@@@.@....@...@.............@@@..@@@@@@@@@@@@@@...@@@@@@@@@@@@@@@@@@@@@
@...@@@@............@......@@@...................@.....@@....@@@@@@@@@@@@@....@@@.@@@@@@@@@@@@@@@@
....@@....@@........@.....@@@@@@@.............@.@.............@@@@@@@@@@@@............@@@@@@@@@@@@
....@@@...@@..@...........@@@@@@@@@@.........@..@@..............@@@@@@@@@@.............@@@@@@@@@@@
......@..@@@......@@......@@@@@@@@@@...........................@@@@@@@@@@@...@.........@@@@@@@@@@@
......@..@.@.....@@.......@@@@@@@@@...@@..@..........@......@@@@@@@@@@@...@@......@...@@@@@@@@@@@@
..............@..@........@@@@@@....@@@@@@..............@...@@@@@@@.@@@@..............@@@@@@@@@@@@
.........................@@@@@@@....@@@@@@@.....@@..@@.@@....@@@@@@.@@@........@....@@@@@@@@@@@@@@
.......@....@@@..........@@@@@@@@...@@@@@@@.....@@..@...@...........@@@.........@@.@@@@@@@@@@@@@@@
..@....@.................@@@@@@@@...@@@@@......@@@..@@@............@@@@@@..@........@@@@@@@@@@@@@@
@......@...@.......@.....@@@@@@@.......@@....@@@@@..@@............@@@@@@............@@@@@@@@@@@@@@
.......@@..@.................@@...........@..@@@@@@...............@@@@@@@...........@@@@@@@@@@@@@@
........@..@..@@...........@@@@@.............@@@@@@@.@............@...@@@@.........@@@@@@@@@@@@@@@
..............@....@@..@...@@@@@@.............@@@@@@@@..@..@..........@@..........@@@@@@@@@@@@@@@@
................@@@@@.......@@@.@........@.@..@@@@@@....@.@@.....................@@@@@@@@@@@@@@@@@
......@....@@...@@@@@.......@@@.@.@......@@@...@@@@@.@..............................@@@@@@@@@@@@@@
...@.@@@....@....@@@@.......@...........@@@....@@@@@.................@..............@@@@@@@@@@@@@@
....@.......@.......@@.....@@...........@@@...@@@@@@.................................@@@@@@@@@@@@@
...@@...............@....@................@...@@@@@@......@..........................@@@@@@@@@@@@@
@..@@@.....................@...........@......@@@@@@......................@@@.........@@@@@@@@@@@@
@..@...........@...........@...........@.......@@@@@.......@........@@.@@.@@@........@@@@@@@@@@@@@
@.......@......................................@@@.............@......@@@.@......@@..@@@@@@@@@@@@@
@.@@.@............@.............@........@.....@@@.........@......@...@@@@.......@...@@@@@@@@@@@@@
@@@@@@............@..........@@..........@.....@@@...................@@@.@..@...@..@.@@@@@@@@@@@@@
@@@@@@@@@.@@@....@......................@@...@..@@.............@.........@......@....@.@@@@@@@@@@@
@@@@@@@@@@@@........................@........@.....................@...................@@@@@@@@@@@
@@@@@@@@@@@@........................@........@.......................@@......@.........@@@@@@@@@@@
@@@@@@@@@@@@.@......@@.......@.....@@.....................................@...........@@@@@@@@@@@@
8
72 9 0
41 38 0
79 52 0
40 6 0
32 94 0
66 35 0
2 59 0
53 41 0

74 50 0
49 38 0
60 79 0
5 22 0
68 40 0
10 22 0
57 28 0
51 37 0
