width 98
height 98
@@@@@@@@@@@................@@@@@@@@@@@@@.@@@@@@@@@@@@@....@@....@.........@@...@@@@..@@@@@@@@@@@@@
@@@@@@@@@@@..@.....@.......@@@@@@@@@@@@...@@@@@@@@@@@@....@@...........@.......@......@@@@@@@@@@@@
@@@@@@@@@@@......@.........@@@@@@@@@@@@....@@@@@@@@@@@..................@......@.....@@@@@@@@@@@@@
@@@@@@@..@@................@..@@@@@@@@.@......@@@@@@@@.@@.....................@@@....@@@@@@@@@@@@@
@@@@@@@...@............@...@@..@@@@@@@.......@@@@@@@@@@@@@@........@..........@@@@....@@@@@@@@@@@@
@@@@@@......................@..@@@@@@........@@@@@@@@@@..@@......@..............@.....@@@@@@@@@@@@
@@@@.............................@@@.........@@..@@@@@@......................@..........@@@@@@@@@@
@@@@...........@@................@@@.......@@@...@@@@@@.....................@@..........@..@@@@@@@
@@@@@@@@.......@@..................@@@@@@....@............@@..........@@...............@@...@@@@@@
@@@@@@@@..................@........@@@@@@@................@@..........@@..@.................@@@@@@
@@@@@@@@..........................@@@@@@@......@..........@@....@@...@@@@@.........@........@@@@@@
@@@@@@@@@.@@......@................@@@@@........................@@@@@@@@.........@..........@@@@@@
@@@@@@@@@.@@..........@............@@@@.........................@@@@@@@..........@@@@.......@@@@@@
@@@@@@@@@.........................@@@@@......@..@.@..............@@@@@@..........@@@........@@@@@@
@@@@@@@@@......@.@..........@@..@@@@@@......................@.....@@@@.......@................@@@@
@@@@@@@@@@@..@...@............@@@@@@@...........@...........@....@@@................@.........@@@@
@@@@@@@@@@@.@@@@@@.....@@.....@@@@@@@.....@........................@......................@..@@@@@
@@@@@@@@@@@@@@@@@@@@.........@@@@@@...............@.@@.............@.........@...............@@@@@
@@@@@@@@@@@@@@@@@@@@..........@@@.................@@@.@...@.......................@...........@@@@
@@@@@@@@@@@@@@@@@@@@..........@..............@@...@@@...............................@@@@@...@@@@@@
@@@@@@@@@@@@@@@@@@@@@.@.................@.........@@@....@..........................@@@@@@@.@.@@@@
@@@@@@@@@@@@@@@@@@@@@@@............@@@....@.....@.@@.......@.........................@@@@@@.@...@@
@@@@@@@@@@@@@@@@@@@@@@@@...@...@@...@@....@...@@..@....................@.............@@@@@@.....@@
@@@@@@@@@@@@@@@@@@@@@@@@...@@...............@@@@..................@...@@.............@@@@@@....@@.
@@@@@@@@@@@@@@@@@@@@@@@@...@@...............@@@@@@@..@@@..............@@...@@@@.......@@@@@...@@@.
@@@@@@@@@@@@@@@@@@@@@@@...@..............@@..@@@@@@@..@@@............@@.............@.@@@@@....@@.
@@@@@@@@@@@@@@@@@@@@@@....@..................@@@@@@@....@.................@......@.........@......
@@@@@@@@@@@@@@@@@@@@@@.....................@.@@@@@@@............................@@........@@......
@@@@@@@@@@@@@@@@@@@@@@..@....................@@@@@...............@....................@@..........
@@@@@@@@@@@@@@@@@@@@@@..................@..@@@@@.............................@........@......@....
@@@@@@@@@@@@@@@@@@@@@@.@@@@@@@...........@@@@.....................................................
@@@@@@@@@@@@@@@@@@@@@@.@@@@.......@.@..@.@@@.........@......@....@...................@@.....@...@@
@@@@@@@@@@@@@@@@@@@@@@@@@@@@@.....@@..@..@@@........@@@@.........@....@....@@................@..@@
@@@@@@@@@@@@@@@@@@@@@@@@@@@@@.....@......@.........@.@....................@@@...@......@.....@.@@@
@@@@@@@@@@@@@@@@@@@@@@@@@@@@@.@@.@...@@............@.........@............@@@...............@@.@@@
@@@@@@@@@@@@@@@@@@@@@@@@@@@@@@@@..................@@..........@.......@.@..@@.......@....@...@@@@@
@@@@@@@@@@@@@@@@@@@@@@@@@@@@@@@.................@........@............@.@..@@@.....@.........@@@@@
@@@@@@@@@@@@@@@@@@@@@@@@@@@@@@............@..@.....@....@@.........................@..........@@@@
@@@@@@@@@@@@@@@@@@@@@@@@@@@@..............@@@@@....@@...@@@......................@..........@@@@@@
@@@@@@@@@@@@@@@@@@@@@@@@@@@...............@@@@@.....@@@....@@@....@.......@......@@...............
@@@@@@@@@@@@@@@@@@@@@@@@@@................@@@@@.....@@............@..............@@...............
@@@@@@@@@@@@@@@@@@@@@@@@@@.@..............@.@@................@@...................@.@............
@@@@@@@@@@@@@@@@@@@@@@@@@@.........@.....@@......@@.....@......@@..@@...........@.................
@@@@@@@@@@@@@@@@@.@@@@.@@@@@.@....@@@..@.........@@....@@...........@..@......@......@@@@@@.......
@@@@@@@@@@@@@@@@@.@@@@.........@@@@@@@............@...............@................@.@@@@@........
@@@@@@@@@@@@@@@@@..............@@@@@@@@...@.........@@.......@@@...@@@...............@@@@@........
@@@@@@@@@@@@@@@@...@...............@@@..@@@.........@@@@......@@..@@@@@............@@@@@@..@@@...@
@@@@@@@@@@@@@@@@........................@@@...........@@@@........@@@@@....@...@@.@@@@@@....@.....
@@@@@@@@@@@@@@@@....@@@.....@.........@.@@...@@......@@@@@@......@@@@@@@@@@@@@......@@@@..........
@@@@@@@@@@@@@@@@@@@.@@@....@@@@@.......@@@...@...........@.......@@@@@@@@@@@@..@@..@@@@@@.........
@@@@@@@@@@@@@@@@@@@@@@@.....@@.....................................@@@@@@@@@.......@@@@@@@........
@@@@@@@@@@@@@@@@@@@@@@@.@@@@@.......@@...............................@@@@@@@.......@@@@@@@@....@..
@@@@@@@@@@@@@@@@@@@@@@@@@@@.........@..............@...........@.@...@@@@@@@.......@@@@@@@@....@@@
@@@@@@@@@@@@@@@@@@@@@@@@@@@..........@@............@@................@@@@@@.......@@@@@@@@.....@@@
@@@@@@@@@@@@@@@@@@@@@@@@@@.@.........@...@@.@..............@@.@...@@@@@@@@@............@@@@...@@@@
@@@@@@@@@@@@@@@@@@@@@@@@@@....@.........@...........@......@@@....@@@@@@@@@....@.......@@@@@@@@@@@
@@@@@@@@@@@@@@@@@@@@@@@@@@....@.....................@@.....@.....@@@@@@@@@@.....@.@......@@@@@@@@@
@@@@@@@@@@@@@@@@@@@@@@@@@@@...@...............@@@@@@@@@@...........@@@@@@.................@@@@@@@@
@@@@@@@@@@@@@@@@@@@@.@@@.......@.............@@@@@@@@@@@............@@@@@................@@@@@@@@@
@@@@@@@@@@@@@@@@@@@...@@@.@.@..............@@@@@@@@@@@@@@.@......@..@@@@...........@....@@@@@@@@@@
@@@@@@@@@@@@@@@@@@@@..........@.......@....@@@@@@@@@@@@@@...............................@@@@@@@@@@
@@@@@@@@@@@@@@@@@@@........@................@@@@@@@@@@@@@@....................@@......@@@@@@@@@@@@
@@@@@@@@@@@@@@@@@@@...............@...........@@@@@@@@@@@@........@@..........@....@@.@@@@@@@@@@@@
@@@@@@@@@@@@@@@@@@@@......@..................@@@@@@@@@@@@@@@.................@@.....@.@@@@@@@@@@@@
@@@@@@@@@@@@@@@@@@@@.........................@@..@@..@@@@@.....@........@@@..@@........@@@@@@@@@@@
@@@@@@@@@@@@@@@@@@@@@...@..............................@@@.............@@@.............@@@@@@@@@@@
@@@@@@@@@@@@@@@@@@@@@...@@@@...........@...............@@@@............@@@...............@@@@@@@@@
@@@@@@@@@@@@@@@@@@.......@@@@..........................@@@@....@....@@@@@@@..............@@@@@@@@@
@@@@@@@@@@@@@@@@@@@......@@@...@...@@@....@@...@@@....@@@@@..@......@@@@@@@..............@@@@@@@@@
@@@@@@@@@@@@@@@@@@@@@............................@@@@.@@@@........@@@@@@@.............@..@@@@@@@@@
@@@@@@@@@@@@@@@@.........................@@@..........@@@@.......@.@@@@@@.....@.........@@@@@@@@@@
@@@@@@@@@@@@@@@@@@.......@..........@....@@...@@......@............@@@@@@@@..............@@@@@@@@@
@@@@@@@@@@@@@@@@@@......@@..........@@.......@.@....................@@@@@@@@@@............@@@@@@@@
@@@@@@@@@@@@@@@@@@@......@@........@@@@@............@.......@.....@@@@@@@@@@@@...@...@@@..@@@@@@@@
@@@@@@@@@@@@@@@...@..@..@@@....@...@@@@@....@.....@.........@@@@@.@@@@@@@@@@@@....@.@@@@@.@@@@@@@@
@@@@@@@@.@@@@@@...@..@.@@..........@@@@@@...................@@@@@@@@@@@@@@@@@@@@@.@.@@@@@@@@@@@@@@
@@@@@@@@.@@@@@@........@@..........@@@@@@.@@...@............@@@@@@@@@@@@@@@@@@@@@@@@@@@@@@@@@@@@@@
@@@@@@@@...@.@@......@@@.........@@@@@@@@@@...........@@....@@@@@@@@@@@@@@@@@@@@@@@@@@@@@@@@@@@@@@
@@@@@@@@.................@........@@@@@@@@@@..........@.....@@@@@@@@@@@@@@@@@@@@@@@@@@@@@@@@@@@@@@
@@@@@@@.....@....................@@@@@@@@@@@@...............@@@@@@@@@@@@@@@@@@@@@@@@@@@@@@@@@@@@@@
@@@@@.....@.@..@@@............@@....@@@@@@@@@................@@@@@@@@@@@@@@@@@@@@@@@@@@@@@@@@@@@@@
@@@@@..@......@@@......@......@@@@..@@@@@@@@@.@...@.......@....@.@@@@@@@@@@@@@@@@@@@@@@@@@@@@@@@@@
..@...........@@...@.........@@@@@@@@@@@@@@@@..................@..@@@@@@@@@@@@@@@@@@@@@@@@@@@@@@@@
..@..@....@..@....@@..........@@@@@@@@@@@@@@@.......................@@@@@@@@@@@@@@@@@@@@@@@@@@@@@@
.............................@@@@@@@@@@@@@@@@....@@.....@...........@.@@@@@@@@@@@@@@@@@@@@@@@@@@@@
.......@.....................@@@@@@@@@@@@@@@@@@@.@@...@...............@@@@@@@@@@@@@@@@@@@@@@@@@@@@
............................@@@@@@@@@@@@@@@@@@@@@@@@............@......@@@@@@@@@@@@@@@@@@@@@@@@@@@
@..........................@@@@@@@@@@@@@@@@@@@@@@@@@...........@@......@@@@@@@@@@@@@@@@@@@@@@@@@@@
@.....@@.............@.....@@@@@@@@@@@@@@@@@@@@@@@@.........@@....@@@@@@@@@@@@@@@@@@@@@@@@@@@@@@@@
@..........................@@@@@@@@@@@@@@@@@@@@@@@@@..@.@...@@@@@.@@@@@@@@@@@@@@@@@@@@@@@@@@@@@@@@
.............@.............@@@@@@@@@@@@@@@@@@@@@@@@@........@@@@@.@@@@@@@@@@@@@@@@@@@@@@@@@@@@@@@@
............@@.............@@@@@@@@@@@@@@@@@@@@@@@@@@..@@@@@@@@@@@@@@@@@@@@@@@@@@@@@@@@@@@@@@@@@@@
.............@@..........@@@@@@@@@@@@@@@@@@@@@@@@@@@@@@@@@@@@@@@@@@@@@@@@@@@@@@@@@@@@@@@@@@@@@@@@@
...@@..............@@....@@@@@@@@@@@@@@@@@@@@@@@@@@@@@@@@@@@@@@@@@@@@@@@@@@@@@@@@@@@@@@@@@@@@@@@@@
....@@..@.....@....@@....@@@@@@@@@@@@@@@@@@@@@@@@@@@@@@@@@@@@@@@@@@@@@@@@@@@@@@@@@@@@@@@@@@@@@@@@@
@@@.@@...................@@@@@@@@@@@@@@@@@@@@@@@@@@@@@@@@@@@@@@@@@@@@@@@@@@@@@@@@@@@@@@@@@@@@@@@@@
@@@@@@....@.@...........@@@@@@@@@@@@@@@@@@@@@@@@@@@@@@@@@@@@@@@@@@@@@@@@@@@@@@@@@@@@@@@@@@@@@@@@@@
@@@@@@...@@.............@@@@@@@@@@@@@@@@@@@@@@@@@@@@@@@@@@@@@@@@@@@@@@@@@@@@@@@@@@@@@@@@@@@@@@@@@@
8
39 51 0
21 86 0
8 76 0
56 40 0
75 54 0
63 29 0
55 42 0
66 35 0

41 57 0
51 32 0
94 53 0
53 75 0
54 65 0
22 87 0
0 91 0
26 5 0
