width 45
height 45
@@@@..............@...@.@............@@@.....
@@.........@.............@...................
.......@.....................................
...............................@.@...........
............@.....@@@@@.@@.....@.@@..........
.................@@@@@..@@...................
.......@...@.......@@@..@............@......@
@....................................@@....@@
...........@...............@..@..@.........@@
...........@@.@.....@.........@............@@
.....@@.......@.....@.........@..........@...
@.@..................................@...@.@.
@....@...........................@...@..@@...
@...@@.....................................@@
@....@................@@@@@.@................
@........@@@.........@..@...................@
@........@@@...@........@................@...
.........@@@................@@.........@.@...
@@.......@@@....@..@@@........@.......@@@@@..
@@..............@.@@@@.......................
@@..........@.......@@....@@.......@@....@..@
@...................@...@@@..@......@.......@
.....@........@@@....@.@@@@..@..@...........@
.....@.........@@.....@@@@@.@@@.......@.....@
.@.............@.@.....@@@................@..
.................@@@....@@......@@....@...@@@
........................@@....@@@.........@@@
@@...@........................@.@........@@@@
@@@...........................@.........@@@@@
@@...@..........@.............@@@....@@@@@@@@
@@@..@@@.......@..@...........@.@......@@@@..
@@@@@@@@@@@...............@.....@.........@..
@@@@@@@@@@@@@@@...........@.....@............
@@@@@@@@@@@@@@@.............@.............@..
@@@@@@@@@@@@@@@@.@@..........................
@@@@@@@@@@@@@@@@.@@@@.@............@.........
@@@@@@@@@@@@@@@@@@@@@..........@.......@.....
@@@@@@@@@@@@@@@@@@@@@...@...@@@@..@@...@.@@@@
@@@@@@@@@@@@@@@@@@@@@........@@...@@.........
@@@@@@@@@@@@@@@@@@@@@@.......@@....@@........
@@@@@@@@@@@@@@@@@@@@@@@......@@@........@@...
@@@@@@@@@@@@@@@@@.@@@@@@.....@@@@......@@@@@.
@@@@@@@@@@@@@@@@@...@.@@.....@@........@@@@@@
@@@@@@@@@@@@@@@..............@@@@...@..@@@@@@
@@@@@@@@@@@@@@@..........@...@@@@...@@.@@@@@@
8
43 18 0
10 14 0
12 10 0
41 31 0
15 5 0
39 14 0
24 43 0
37 8 0

6 1 0
28 42 0
1 21 0
16 5 0
40 20 0
7 12 0
21 25 0
43 19 0
