width 45
height 45
@@@@@@@@@@@..@@@@@@@@@@@@@@@@@@@@@@@@@@@...@@
@@@@@@@@@@@..@@@@@.@@@@@@@@@@@@@@@@@@@@@...@@
@@@@@@@@@@@..@@@@@..@@@@@@@@@@@@@@@@@@.....@@
@@@@@@@@..@.........@@@@@@@@@@@@@@@@@......@@
@@@@@@@.........@@....@@@@@@@@@@@@@@@.......@
@@@@@@@@..............@@@@.@@@@@@@@@@........
@@@@@@@...............@@@@.@@@...@@.....@....
@@@@@@@@@.@@.........@@@@....@.............@@
@@@@@@@@@@@@..........@...@.............@.@@@
@@@@@@@@@@@@@@..@@...........@@........@@@@@@
@@@@@@@@@@@@@............@...@@.........@@@@@
@@@@@@@@@@@@@@.....................@....@@@..
@@@@@@@@@@@@@........@..........@...........@
@@@@@@@@@@@......@...@..@@..@...............@
@@@@@@@@@@@@............@@@......@...........
@@@@@@@@@@@@....@......@@@@..................
@@@@@@@@@@@@.@..........@@@..................
@@@@@@@@@@@@@@.........@@....................
@@@@@@@@@@@@@..........@@..........@@........
@@@@@@@@@@@@@@....@..........@......@.......@
@.@@@@@@@@@.............@.@.........@@@@.....
..@@@@@@@@@........@...@@......@..@@@@@@@.@..
...@@@@@@@@@..........@@@........@..@@@@..@..
.....@@@@@@..........@@@.........@..@@@@..@@@
.@....@@@@............@@..............@@.....
.....@@@@@.......@...@@@@........@........@.@
.....@@@@@@......@...........................
.......@@@@......@...........................
@......@@@...................................
.......@@..@...@...............@.............
...@.....@.....@.............................
......................................@......
@...@@...@...................@...@.........@@
@....@...@@.............@..................@@
.........@@.@@.............................@@
............@@.............@...@@............
..@..@@.....@@....@......@@@.............@...
..@@@@@.@....@...........@@@.@@....@.........
@@@@@@@.@..@.@....@@.....@@@@@.....@.@.......
@@@@@@@@@................@@@@@@@.............
@@@@@@@@@................@@@@@@..............
@@@@@@@@@@...@..........@..@@@@..............
@@@@@@@@@@@@........@@@.@....@@..............
@@@@@@@@@@@@@@......@@.....@@@@.....@@.....@.
@@@@@@@@@@@@@@......@@@....@@@@.@@...@@..@@@.
8
11 40 0
15 41 0
15 44 0
27 16 0
38 38 0
14 6 0
29 25 0
4 29 0

42 38 0
1 31 0
42 7 0
13 32 0
41 32 0
26 9 0
28 27 0
1 34 0
