width 45
height 45
@@@@@@@@@@@@@@@@@.@@@..@.@.......@@@@@@@@@@@.
@@@@@@@@@@@@@@@@...@@......@........@@@@@.@@.
@@@@@@@@@@@@@@@@.......@...............@...@.
@@@@@@@@@@@@@@@@.................@.........@.
@@@@@@@@@@@@@@@@@@............@..@...........
@@@@@@@@@@@@@@@@@@.......@.............@@....
@@@@@@@@@@@@@@@@@@..........................@
@@@@@@@@@@@@@@@@@@@@@@......................@
@@@@@@@@@@@@@@@@@@@@@@.......................
@@@@@@@@@@@@@@@@...............@@@@...@@@@...
@@@@@@@@@@@@@@@...................@...@@@...@
@@@@@@@@@@@..................@@@.....@@@@@@@@
@@@@@@@@@....................@@......@@@@@@@@
@@@@@@@@.....@......@@......@@....@@@@@@@@@@@
@@@@@@@@...@@@..............@..@...@@@@@@@@@@
@@@@@@@@....@@@@.....@@............@@@@@@@@@@
@@@@@@@@.......@......@...@.......@@@@@@@@@@@
@@@@@.@@.......@@.......@.@.@.....@@@@@@@@@@@
@@@@..@@@.......@@@...............@@@@@...@@.
@@@@@..........@@@@................@@@@..@@@.
@@@@@.@........@@@@..@@@@....@.......@@..@@..
@@@@@..........@@@@..@@@.................@...
@@@@@...........@@@..@@@.........@....@......
@@@@.......@@....@@..@@@..@..................
@@@@.......@@.@..@@@@@@@.@@.......@..........
@@@@@@.....@@....@@@@@@@.....................
@@@@@@...........@@@@@@@..........@..........
@@@.@@.@.@.@@@@@.@@@@@@@............@@....@.@
.@@.@@...@@@@@@@.@@@@@@@@...@@.......@....@@@
.....@....@@@@...@@@@@......@@@........@..@@@
.....@....@@@@...@@.................@.....@@@
....@@......@....@@.................@.....@@@
.....@@@..........@..@@.............@@@@.@@@@
.......@.....@.......@@.........@@..@@@@@@@@@
....................@@@@@...@@...@...@@@@@@@@
.@.....@..@.......@@@@@@@...@.@........@@@@@@
@@@...@@..@@@....@@@@@@@@@.............@@@@@@
@@...@@@@........@@@@@@@@@....@.......@@@@@@@
@@....@..........@@@@.....@...........@@@@@@@
......@...................@.....@.....@@@@@@@
......@@@.......................@...@@@@@@@@@
@@...............@.............@@..@@@@@@@@@@
@@@@........@@...@.................@@@@@@@@@@
@@@@........@@...@......@....@@@@...@@@@@@@@@
@@@@@.......@@@...............@@@...@@@@@@@@@
8
36 23 0
22 2 0
26 21 0
16 33 0
14 39 0
24 29 0
7 19 0
16 42 0

32 24 0
22 8 0
28 33 0
43 6 0
36 6 0
25 29 0
29 7 0
13 23 0
