width 45
height 45
@@@@@@@@@@@@@@@.......@@@@@@@@@@@@@@@@......@
@@@@@@@@@..@@........@@@@@@@@@@@@@@@@@@.....@
@@@@@@@@.......@........@@@@@@@@@@@@@@@@@....
@@@@@@@..@.............@@@@@@@@......@@@@....
@@@@@@@...........@.....@@@@@@.......@@@@....
@@@@@@@.................@@@@@........@.......
@@@@@@@...........@.@....@@@@@.....@.@.......
@@@@@@...................@.@.................
@@@@@......@........................@@...@...
@@@@@.........@..@........@@.@@..@@..@.......
@@@@@@.@.....@...@.@......@..................
@@@@...........@...@@@.......................
@@@................@.@................@......
@@@.......................................@@.
@@@@.......@..@........@...............@@@@@.
@@@@@@@@.@@@@@.....@@............@....@@@@@@@
@@@@@@@@@@@@@.............@......@@....@@@@@@
@@@@@@@@@@@@@.............@.......@@...@@@@@@
@@@@@@@@@@@@@...................@..@.......@@
@@@@@@@@@@@@@..................@@@........@@@
@@@@@@@@@@@@@................................
@@@@@@@@@@@@@...............................@
@@@@@@@@@@@@@@@..............................
@@@.@@@@@@@@@@@.@........@...@@@.............
@@@.@@@@@@@@@.@.@........@@..@@..............
@@@..@@@@@@.........@@@......@@..............
@@....@@@@..................@@@.@............
@@...@@@@@....@@@@..........@@...............
@@@@..@@@@@...@......@@..@.@@@...............
@@@@@.....@@..@.......@....@@...........@....
@@@.......@@..........@....@@.......@.......@
@@@@@..@...@...............@@...............@
@@@@@........................@@..........@..@
@@@@....................@..................@@
@@@@@...@@@@.....@......@@...................
@@@@@.@@@@@@@....@@............@@.......@....
@@@@@.@@@@@@@.....@.@@@@@@...........@.@@....
@@@@@@@@@@@@@@@@@@@@@@@@@...........@@..@....
@@@@@@@@@@@@@@@@@@@@@@@@.@...........@.....@.
@@@@@@@@@@@@@@@@@@@@@@@@...........@.@.....@.
@@@@@@@@@@@@@@@@@@@@@@@@@............@.@@@..@
@@@@@@@@@@@@@@@@@@@@@@@@@@@.............@@...
@@@@@@@@@@@@@@@@@@@@@@@@@@@.............@.@..
@@@@@@@@@@@@@@@@@@@@@@@@@@..@....@.@......@..
@@@@@@@@@@@@@@@@@@@@@@@@@@.........@.@....@.@
8
11 32 0
17 30 0
39 26 0
38 23 0
35 27 0
4 25 0
32 41 0
30 8 0

13 24 0
42 5 0
28 42 0
7 4 0
33 3 0
4 25 0
3 24 0
44 41 0
