width 45
height 45
@@@@@@@@@@@@@........@@@@...@.@@@@...@@@@@@@@
@@@@@@@@@@@@@.........@........@@@.@@@@@@@@@@
@@@@@@@@@@@@@........@..........@@.@@@@@@@@@@
@@@@@@@@@@@.....................@@...@@@@@@@@
@@@@@@@@@@@.........@..@.....@..@.....@@@@@@@
@@@@.@@@@@..........@........@..........@@@@@
@@.....@@@@@............@@...............@@@@
@@@....@@@@.............@..................@@
@@@......@@...............@................@@
@@@...................@...@.....@@@..........
@@@...@@@...@@@.................@.......@@@..
.@@.....@.@@@@@..@@.......@.............@@@@@
..................@.........@@.........@@@@@@
...................@.....@........@....@@@@@@
........@............@.@..........@.....@@@@@
........@..............@..................@@@
....@....@@@..................@@.............
.........@@@@.............@@@@@@@............
.........@@@@.@@......@...@@@@@@@............
........@@@@@.........@@...@@@@@@..@.........
...@....@@@@@...............@@.@.@.@..@..@...
....@@@...@@@.........@@....@@....@@...@.....
...........@@.........@@@@........@@.........
............@@...@.....@@@....@..............
@@...@......@@..........@....@........@......
@...@@......@@@..........................@...
@.@..@.....@@@@....@@@...........@@@@@@@@@...
@.......@@.@.......@@@...........@@@@@@@@@@@.
@....@...@@....@..@@@@...........@@@@@@@@@@@@
....................@.........@@..@@@@@@@@@@@
.............@.@..............@@..@@@@@@@@@@@
.....................@....@@@@@@@@@@@@@@@@@@@
...........@@.............@@@@@@@@@@@@@@@@@@@
@.........@@@............@@@@@@@@@@@@@@@@@@@@
.........@@@@@@..@......@@@@@@@@@@@@@@@@@@@@@
@@@.....@@@@@@...@......@@@@@@@@@@@@@@@@@@@@@
........@@@@@@.......@@@@@@@@@@@@@@@@@@@@@@@@
......@@@@@@@@......@@@@@@@@@@@@@@@@@@@@@@@@@
@@@@..@@@@@@@......@@@@@@@@@@@@@@@@@@@@@@@@@@
@@@...@@@@@@@....@.@@@@@@@@@@@@@@@@@@@@@@@@@@
@@@@@@@@@@@@@@@....@@@@@@@@@@@@@@@@@@@@@@@@@@
@@@@@@@@@@@@@@..@@@@@@@@@@@@@@@@@@@@@@@@@@@@@
@@@@@@@@@@@@@.....@@@@@@@@@@@@@@@@@@@@@@@@@@@
@@@@@@@@@@@@@.@@.....@@@@@@@@@@@@@@@@@@@@@@@@
@@@@@@@@@@@@..@@@@...@@@@@@@@@@@@@@@@@@@@@@@@
8
24 20 0
15 8 0
31 12 0
14 33 0
30 9 0
28 26 0
28 24 0
39 17 0

19 44 0
17 15 0
38 6 0
15 42 0
1 17 0
16 2 0
1 31 0
1 15 0
