width 89
height 89
@@@@@@@@@@@@@@@@@@@@@@@@@@@@@@@@@@@@@@@@@@@@@@@@........@@@@@@@@......@....@@@..@@@@....@
@@@@@@@@@@@@@@@@@@@@@@@@@@@@@@@@@@@@@@@@@@@@@@@.........@.@@@@@@............@...@@@@@@@..
@@@@@@@@@@@@@@@@@@@@@@@@@@@@@@@@@@@@@@....@@@@@...@@.........@......@.....@@@....@@@@@@..
@@@@@@@@@@@@@@@@@@@@@@@@@@@@@@@@@@@@@@@.....@@@...@......@...@............@@@...@@@..@@.@
@@@@@@@@@@@@@@@@@@@@@@@@@@@@@@@@@@@@@@@@......@.........@@.......@.........@....@@@...@..
@@@@@@@@@@@@@@@@@@@@@@@@@@@@@@@@@@@@@@@@@@....@.....@........@.............@@.......@....
@@@@@@@@@@@@@@@@@@@@@@@@@@@@@@@@@@@@@@@@@...@@...........@...@.............@...........@@
@@@@@@@@@@@@@@@@@@@@@@@@@@@@@@@@@@@@@@@@@@.@@@@............@@@.............@@..........@@
@@@@@@@@@@@@@@@@@@@@@@@@@@@@@@@@@@@@@@@@@@...@@@...........@@@....@.@......@@@...........
@@@@@@@@@@@@@@@@@@@@@@@@@@@@@@@@@@@@@@@@@@...@@@............@@....@@@@...................
@@@@@@@@@@@@@@@@@@@@@@@@@@@@@@@@@@@@@@@@@...@@@.........@@@.........@...........@...@....
@@@@@@@@@@@@@@@@@@@@@@@@@@@@@@@@@@..@@@@@...@............@..........@...................@
@@@@@@@@@@@@@@@@@@@@@@@@@@@@@@@@@@..@@....@.@..@@...@..............@@....................
@@@@@@@@@@@@@@@@@@@@@@@@.....@@@.............@@@@...@@...............@.......@@@.........
@@@@@@@@@@@@@@@@@@@@@@@@.......@..............@@@@..@@@..........................@@......
@@@@@@@@@@@@@@@@@@@@@@@@@...@@................@@@@..@@..@@@.....@.............@..........
@@@@@@@@@@@@@@@@@@@@@@@@@.....@.@..........@..@@@@..@@...@@....@@....@........@...@......
@@@@@@@@@@@@@@@@@@@@@@@@@.......@..............@@........@@@.....@.............@...@@....
@@@@@@@@@@@@@@@@@@@@@@@@@@@.........................@.....@@................@..@.........
@@@@@@@@@@@@@@@@@@@@@@@@@@@......................@@......@@@................@............
@@@@@@@@@@@@@@@@@@@@@@@@@@........................@.....@@@@@.......@.@.....@......@..@..
@@@@@@@@@@@@@@@@@@@@@@@@@@...........@@.@@@............@@....................@@@@@@@.@...
@@@@@@@@@@@@@@@@@@@@@@@@@@...........@@.@.@...........@.............@.........@@@@@@@@...
@@@@@@@@@@@@@@@@@@@@@@@@@@...@..@..............@@...@.@..@@@@.@@..........@...@@@@@@@@@@@
@@@@@@@@@@@@@@@@@@@@@@@@@@.....@@@.............@@........@@@@.............@@......@@@@@@@
@@@@@@@@@@@@@@@@@@@@@@@@@@....@@@@@........@..............@@......@..........@..@@@......
@@@@@@@@@@@@@@@@@@@@@@@@@@@...@@@@@@..@..........@..@@@...@@......@..@@@................@
@@@@@@@@@@@@@@@@@@@@@@@..@....@@@@@@................@@@@..........@@@@@@...............@@
@@@@@@@@@@@@@@@@@@@@@@@@....@....@@@@.........@.....@@@@@............@@@...............@@
@@@@@@@@@@@@@@@@@@@@@@@.......@.....@.@@........@..@@@@@@.........@............@.......@@
@@@@@@@@@@@@@@@@@@@@@@..........................@@@@@@@...........@@...........@.......@@
@@@@@@@@@@@@@@@@@@@@@...........................@@@@@@@...........@............@@@@.@@@@@
@@@@@@@@@@@@@@@@@@@....................@........@@@@@@@@.............@@@@....@.@@@@@@@@@@
@@@@@@@@@@@@@@@@@@@@@.........@.......@@@.......@@@@@@@..........@@@@@@@@....@.@@@@@@@@@@
@@@@@@@@@@@@@@@@@@@@@@...@....@@@@.....@@........@@@.@..@@@@......@@@@@@@@.....@@@@@@@@@@
@@@@@@@@@@@@@@@@@@@@@......@...@@@.......................@@@........@@@@@@.......@@@@@@@@
@@@@@@@@@@@@@@@@@@@@...........@@@.........................@..@.......@@@.........@@@@@@@
@@@@@@@@@@@@@@@@@@@@..........@@@.........@.....@..........@...........@@.......@.@@..@@@
@@@@@@@@@@@@@@@@@@@@......@@.............................@........@...............@@...@@
@@@@@@@@@@@@@@@@@@@@......@@@.....................................................@@...@@
@@@@@@@@@@@@@@@@@@@@......@@@........@................@..@.@..............@..@@@@......@@
@@@@@@@@@@@@@@@@@@@@....@@@@@...............@........@..@.........@@...@@@...@@@.....@@@@
@@@@@@@@@@@@@@@@@@@@....@@@@@.......@.......@@....@................@@@.@@@@@@@@..........
@@@@@@@@@@@@@@@@@@@@@@..@@@@@@@........@@@@.@@@......@..........@..@@@@@@@@@@@@..........
@@@@@@@@@@@@@@@@@@@@@....@.@@@@........@@@...............@.........@@@@@@@@@@@@..........
@@@@@@@@@@@@@@@@@@@@@......@@@@@...@.@@..@.......@....@...........@@@@@@@@@@@@...@.......
@@@@@@@@@@@@@@@@@@@@.....................@@...@.......@...@........@@@@@@@@@@@@@......@..
@@@@@@@@@@@@@@@@@@@@@................@........@....................@@@@@@@@@@@@@.........
@@@@@@@@@@@@@@@@@@@@@....................@@@.@................@....@@@@@@@@@@@@@.@.......
@@@@@@@@@@@@@@@@@@@@@@...........@@@..................................@@@@@@@@@@@@....@@@
@@@@@@@@@@@@@@@@@@@@@@....@...........@......@.......@...................@@@@@@@@@.....@@
@@@@@@@@@@@@@@@@@@@@@@...@@..@@........@.@@@@@.......@...............@....@@@@@@@@.....@@
@@@@@@@@@@@@@@@@@........@@@@@.........@@..@@@...............@.@..........@@@.@@@@@.@@.@@
@@@@@@@@@@@@@@@@..@...@....@....@.......@@.@@@...........@....@@@@............@.........@
@@@@@@@@@@@@@@@@.........@....@............................@..@@@@......................@
@@@@@@@@@@..@@.............................@@..@...@...@@@@@@.@@@...............@........
@@@@@@@@@@..@.....@.....@....@@..@@@........................@..................@@@@.....@
@@@@@@@@@@@..........@.@......@@...@.........@........@........@.........@@.....@@@@....@
@@@@@@@@@@@....@...@..@@..@@@@@@.....................@.........@@.......@@@.@...@@@@.....
@@@@@@@@@@@@@..@@.........@@@@@@..........@....................@@.@.............@@@...@..
@@@@@@@@....@@.@..@......@@@@@@@..........@.....................@..............@@@@......
@@@@@@@@.......@..@......@.@...................................................@@@@......
@@@@@@@@.......@@............@..............................@.....@.............@........
@@@@@@@@.@.@.....................@@@@@.............@@@@@.................................
@@@@@@@@...@@......@.@............@@@@.......@.....@@@.........@@..........@@........@...
@@@@@@@@@..@@........@.............@@@..........@@..@......................@@@...........
@@@@@@@@@............@@@..........@@@@.......@..@@................@....@..@@@............
@@@@@@@@.......................@......@....@@@...@.........................@...........@@
@@@@@@@@................@.................@@@@...@..................@@.....@.............
@@@@@@@...........@...............@....@..@@@@..@@........@........@@....@@@.@@......@@..
@@@@@@@.@........................@@....@....@@..@..............................@@....@@..
@@@@@@@...........................@@........@@...........................@.....@@@@@@@@@@
@@@.........@..@.@@@@@@...........@@..............@.................@@..........@@@@@@@@@
@@..@@@@@@@.@.....@@.@@...........@...........@@...@@@@............@............@@@@@@@@@
@...@@@@@@@@@@..@@@.......@....@.................@...@.............................@@@@@@
@@...@@@@@@@@@@@@@@....................@...................@@@@@...@..@....@....@...@@@@@
@...@@@@@@@@@@@@@@@@..@.........@...........@....@@........@@@@....@@.........@.....@@@@@
@.@@@@@@@@@@@@@@@@@...@@@...................@....@@........@@@@....@.............@@@@@@@@
@@@@@@@@@@@@@@@..................@@.....@@@.....@.........@@@@@@@@@@@@............@@@@@@@
@@@@@@@@@@@@@@@..@..............@@@..@..@@....@@@@@@@@....@@@@@@@@@@@@@....@......@....@@
@@@@@@@@@@@@@@@@..........@@@@....@..@@@@@.@.@@@@@@@@@..@@@@@@@@@@@@@.....@@..@........@@
@@@@@@@@@@@@@@@@@........................@...@@@@@@@@@@@@@@@@@@@@@@@@@................@@@
@@@@@@@@@@@@@@@@@...@.......@@...........@@@@@@@@@@@@@@@@@@@@@@@@@@@.............@@..@@@@
@@@@@@@@@@@@@@@@@...........@@...........@@@@@@@@@@@@@@@@@@@@@@@@@@@.............@@....@@
@@@@@@@@@@@@..@@.........@........@......@@@@@@@@@@@@@@@@@@@@@@@@@@@.....................
@@@@@@@@@@@.........@@@..@............@...@@@@@@@@@@@@@@@@@@@@@@@@@@...@@................
@@@@@@@@@@@@........@@.......@..@.....@@@@@@@@@@@@@@@@@@@@@@@@@@@@@@..........@.........@
@@@@@@@@@@@@@....@@@.........@..@.....@@@@@@@@@@@@@@@@@@@@@@@@@@@@@@@.@...@@@@@..........
@@@@@@@@@@@@...@@@@..@...@@.....@...@.@@@@@@@@@@@@@@@@@@@@@@@@@@@@@@@@@@@@@@@@@..........
8
47 45 0
79 78 0
46 25 0
40 59 0
20 68 0
64 17 0
22 48 0
62 18 0

11 71 0
83 86 0
43 24 0
17 62 0
79 85 0
18 80 0
88 9 0
22 88 0
