width 89
height 89
@@@@@@@@@@@@@@@@@@@@......@@@.................@@@@@.@@@@@@@@@@@@@@@@@@@@......@@@...@@@@@
@@@@@@@@@@@@@@@@@@@.........@@....@............@@@@.@@@@@@@@@@@@@@@@@@@@.....@@@...@@@@@@
@@@@@@@@@@@@@@@@@@@...............@...................@@@@@@@@@@@@@@@@@.......@@....@@@@@
@@@@@@@@@@@@@@@@@@..........@...................@@@....@@@@@@@@@@@@@@@@@@..........@@@@@@
@@@@@@@@@@@@@@@@@...........@.................@@@@@...@@@@@.@....@@@@@@@@.@........@@@@@@
@@@@@@@@@@@@@.@@.....@...@.....................@@@.....@@@.......@@@@@@@@..........@@@@@@
@@@@@@@@@@@@@..@.@.....@.......@........@@@...@@@......@@@........@@@@@@@...........@..@@
@@@@@@@@@@@@@@.......................@@@....@@@@@......@.@...........@........@.....@..@@
@@@@@@@@@.@@@@..@....................@@@@@.............@...............................@@
@@@@@@@@@...............@...................@@.........@.@...........@................@@@
@@@@@@@@@@..........@@@@.......@..........@@@@@........@...........................@@@@@@
@@@@@@@@@@@@@....@@@@@@@@........@@@......@@@@@@..........@..................@....@@...@@
@@@@@@@@@@@@@..@@@@@@@@@@@@@.....@@@@@..@..@.@@.........@@@..................@.....@...@@
@@@@@@@@@@@@@@@@@@@@@@@@@@@......@@....@..............@@@@@..............................
@@@@@@@@@@@@@@@@@@@@@@@@@@@...@..@@@..................@@@@@.......@........@@............
@@@@@@@@@@@@@@@@@@@@@@@@.......@@..............@@@....@@@@@...............@@@..........@.
@@@@@@@@@@@@@@@@@@@@@@@@..............@....@.....@.....@@@............@@@@@@.............
@@@@@@@@@@@@@@@@@@@@@@@@.............@@....@.........@@@@@@....@@@.....@@@@@.............
@@@@@@@@@@@@@@@@@@@@@@@@.............@@....@........@@@@@@@@.@.@@@@@....@@@@@...........@
@@@@@@@@@@@@@@@@@@@@@................@.......@....@.@@@@@@@@@@@@@@@@@@@...@@@........@@@@
@@@@@@@@@@@@@@@@@@@@@.........@.....@@.@.........@@@@@@@@@@@@@@@@@@@@@@..@@@....@@...@@@@
@@@@@@@@@@@@@@@@@@@@@.............@..............@@@@@@@@@@@@@@@@@@@@....@.@@..@@@....@@@
@@@@@@@@@@@@@@@@@@@@@......@......................@@@@@@@@@@@@@@@@@@@..............@..@@@
@@@@@@@@@@@@@@@@@@..@.....@...............@@..@@@.@@@@@@@@@@@@@@@@@@@..........@.@....@@@
@@@@@@@@@@@@@@@@@@..@......................@..@@..@@@@@@@@@@@@@@@@@@@@@..............@@@@
@@@@@@@@@@@@@@@.....@...@.............@@@.........@@@@@@@@@@@@@@@@@@@@...............@@@@
@@@@@@@@@@@@@@.................@...@...@...........@@@@@@@@@@@@@@@@@@@...@.@.........@.@@
@@@@@@@@@@@@@@@@........@@@....@...................@@@@@@@@@@@@@@@@.@@@@.@@@.......@@@..@
@@@@@@@@@@@@@@@@.@......@@@....@@.............@....@@@@@@@@@@@@@@@@...@@@@@@@@...........
@@@@@@@@@@@@@@@.........@@@.....@@@......@..@.....@@@@@@@@@@@@@@@@@......................
@@@@@@@@@@@@@@.....@.....@@@.@...@@@.....@........@@@@@@@@@@@@@@@@@@.............@.....@@
@@@@@@@@@@@@@@.@...@@..@@@....@..@@........@......@@@@@@@@@@@@@@@@@.....@.....@@.@....@@@
@@@@@@@@@@@@@@@@@..@.@.@@@.......@.................@@@@@@@@@@@@@@@@.@.....@@@@@@.....@@@@
@@@@@@@@@@@@@@.......@@@@@.............@..............@@@@@@@@@@@@.......@..@@@@.@@.@@@@@
@@@@@@@@@@@@@@.....@@@@@@@@...................@@.....@@@@@@@@@.@@@.......@..@@@@@@..@@@@@
@@@@@@@@@@@@@@....@@@@@@@@@@@.........@@@.........@....@.......@@@............@@@@..@@@@@
@@@@@@@@@@@@@@...@@@@@@@@@@@@...................@......@..@....@@...................@@@@@
@@@@@@@@@@@@@@@..@@@@@@@@@@@@.........@@...........@.........@........@@............@@@@@
@@@@@@@@@@@@@@@@@@@@@@@@@@@@@@@........@......................@.@.....@............@@@@@@
@@@@@@@@@@@@@@@@@@@@@@@@@@@@@@.........@@@............................@......@......@@@@@
@@@@@@@@@@@@@@@@@@@@@@@@@@@@@@......@..@.....................@....@..................@@@@
@@@@@@@@@@@@@@@@@@@@@@@@@@@@@.......@....@@.......................@@...@@........@.@..@@@
@@@@@@@@@@@@@@@@@@@@@@@@@@@@............@@@......................@@@...@@...@........@@@@
@@@@@@@@@@@@@@@@@@@@@@@@@@@@@@............@@@.@.....@..................@@@@............@@
@@@@@@@@@@@@@@@@@@@@@@@@@@@@@@............@@@.@..@..........@...@.......@@..........@@@@@
@@@@@@@@@@@@@@@@@@@@@@@@@@@@@@@@@.........@@@...............@...........@@...@....@.@@@@@
@@@@@@@@@@@@@@@@@@@@@@@@@@@@@@@@@@...........................................@..@..@@@@@@
@@@@@@@@@@@@@@@@@@@@@@@@@@@@@@@@@@@...@@@@.........................@@.@............@@@@@@
@@@@@@@@@@@@@@@@@@@@@@@@@@@@@@@@@@@...@@@@..........@@.............@@@@.....@.....@@@@@@@
@@@@@@@@@@@@@@@@@@@@@@@@@@@@@..@@@...@..@@.......@@@@@.............@@..............@@@@@@
@@@@@@@@@@@@@@@@@@@@@@@@@@@@@.......@@............@@........@@@...........@.......@@@@@@@
@@@@@@@@@@@@@@@@@@@@@@@@@@@@@@......@@@.....@.........@.....@@............@@.....@@@@@@@@
@@@@@@@@@@@@@@@@@@@@@@@@@@@@@@@.....@@@....@@.......................@@@....@@.@@@@@@@@@@@
@@@@@@@@@@@@@@@@@@@@@@@@@@@@@@@.....@@......@@@..@@........@.@.@....@@.....@@.@@@@@@@@@@@
@@@@@@@@@@@@@@@@@@@@@@@@@@@@.@@..@............@.@@@@.....@@..@@@.....@.....@@.@@@@@@@@@@@
@@@@@@@@@@@@@@@@@@@@@@@@@@@..@@...............@........@@@@..@@@@@@..@@....@@.@@@@@@@@@@@
@@@@@@@@@@@@@@@@@@@@@@@................................@@@@..@@@@@@...@@@@@@@.@@@@@@@@@@@
@@@@@@@@@@@@@@@@@@@@@@@.................@@.............@....@@@@@@@......@@@@@@@@@@@@@@@@
@@@@@@@@@@@@@@@@@@@@@@....@.......@.....@@.@................@@@@@@.......@@@@@@@@@@@@@@@@
@@@@@@@@@@@@@@@@@@@@@@@@.@@................................@@@@@@..........@@@@@@@@@@@@@@
@@@@@@@@@@@@@@@@@@@@@@@..........@@.........@..................@..........@@@@@@@@@@@@@@@
@@@@@@@@@@@@@@@@@@@@@@@..........@@....................................@@@@@@@@@@@@@@@@@@
@@@@@@@@@@@@@@@@@@@@@@@@@........@@.........................@@@......@@@@@@@@@@@@@@@@@@@@
@@@@@@@@@@@@@@@@@@@@@@@@@........@...........................@.....@@@@@@@@@@@@@@@@@@@@@@
@@@@@@@@@@@@@@@@@@@@@@@@@.............................@......@.....@@@@@@@@@@@@@@@@@@@@@@
@@@@@@@@@@@@@@@@@@@@@@@@@.....@..................................@.@@@@@@@@@@@@@@@@@@@@@@
@@@@@@@@@@@@@@@@@@@@@................@@@.....@@....................@@@@@@@@@@@@@@@@@@@@@@
@@@@@@@@@@@@@@@@@@@@@................@@@.............................@@@@@@@@@@@@@@@@@@@@
@@@@@@@@@@@@@@@@@@@@@....................@@@.....@@..................@@@@@@@@@@@@@@@@@@@@
@@@@@@@@@@@@@@@@@@@@@.....................@@........................@@@@@@@@@@@@@@@@@@@@@
@@@@@@@@@@@@@@@@@@@@@.........@@....................................@@@@@@@@@@@@@@@@@@@@@
@@@@@@@@@@@@@@@@@@@@.........@@@................@..................@@@@@@@@@@@@@@@@@@@@@@
@@@@@@@@@@@@@@@@@@@..........@@@...................................@@@@@@@@@@@@@@.@@@@@@@
@@@@@@@@@@@@@@@@@.@......@...@@.......................@............@@@@@@@@@......@@@@@@@
@@@@@@@@@@@@@@@@@........@....@....................@....@....@.....@@@@....@......@@@@@@@
@@@@@@@@@@@@@@@.......@..@...@@.......@...@.........@........@...@@@@@@..........@@@@@@@@
@@@@@@@@@.......@.@...@@.....@@....@.........@@@....@.......@....@@@@@@..........@@@@@@@@
@@@@@@@@@...........@@@......................@@@...@@@.@......@..@@@@@@@.........@@@@@@@@
@@@@@@@@@@...............@.....................@..@@@@...........@@@@..@.........@@@@@@@@
@@@@@@@@@@.........@.....@.............@..........@@............@@@@...........@@@@@@@@@@
..@@@@@@@@@.........@..@..@..@......@.@@@..........@............@@@@@..........@.@@@@..@@
...@@@@@@@@...@@@...@........@....@....@@@@...@......@...........@@@@.....@......@.@@...@
.....@@@@@@....@.................@......@@@@@@@@...@@@..@@@......@@@.....@@.........@@...
.....@@@@@@.@..@..@..............@@........@...@@@@@@@...@@@.......@................@@...
.......@@@.................................@...@@@@@@@...@@@..........@..........@.......
...@...@@@.......@.................................@.....@@@@@..........@...............@
@.@@............@@@@..........................@.....@....@@@...........................@@
@@@@@..........@@@@........@.@......@....@...............@@@........@.................@@@
@@@@@..........@@@@.....@..@@@..@@@@................@..@@@@@@...................@.....@@@
8
50 67 0
63 74 0
76 78 0
41 51 0
58 75 0
80 36 0
52 85 0
26 3 0

52 73 0
64 72 0
33 1 0
52 12 0
47 75 0
77 35 0
19 80 0
34 24 0
