width 89
height 89
@......@@@@@@@...@@.........@@@@@.@@@@@@@@@@@@@@@@@@@@@@@@@@@@@@@@@@@@@@@@@@@@@@@@@@@@@@@
@@@.....@@@@@@@...@........@@@@@.......@@@@@@@@@@@@@@@@@@@@@@@@@@@@@@@@@@@@@@@@@@@@@@@@@@
@@@.......@@@@@............@@...........@@@@@@@@@@@@@@@@@@@@@@@@@@@@@@@@@@@@@@@@@@@@@@@@@
@@@@@...................@@.....@.......@@@@@@@@@@@@@@@@@@@@@@@@@@@@@@@@@@@@@@@@@@@@@@@@@@
@@@@@@@@........@@@.....@@.............@@@@@@@@@@@@@@@@@@@@@@@@@@@@@@@@@@@@@@@@@@@@@@@@@@
@@@@@@@@......@.@@......@@...........@@@@@@@@@@@@@@@@@@@@@@@@@@@@@@@@@@@@@@@@@@@@@@@@@@@@
@@@@@@@.........@@..@......@@@.@@....@@@@@@@@@@@@@@@@@@@@@@@@@@@@@@@@@@@@@@@@@@@@@@@@@@@@
@@@@@@@@@....@@@@...........@@@@@@..@@@@@@@@@@@@@@@@@@@@@@@@@@@@@@@@@@@@@@@@@@@@@@@@@@@@@
@@@@@@@@@@.@@@@...@@........@@@@@@@@@@@@@@@@@.@@@@@@@@@@@@@@@@@@@@@@@@@@@@@@@@@@@@@@@@@@@
@@@@@@@@@@@@@@@..........@...@@@@@@@@@@@@.....@@@@@@@@@@@@@@@@@@@@@@@@@@@@@@@@@@@@@@@@@@@
@@@@@@@@@@@@@@@@@.....@.......@..@@@@@@@@.....@@@@@@@@@@@@@@@@@@@@@@@@@@@@@@@@@@@@@@@@@@@
@@@@@@@@@@@@@@@@..................@@@.@@....@.@@@@@@@@@@@@@@@@@@@@@@@@@@@@@@@@@@@@@@@@@@@
@@@@@@@@@@@@@@@...................@.........@.@@@@@@@@@@@@@@@@@@@@@@@@@@@@@@@@@@@@@@@@@@@
@@@@@@@@@@@@@@@...........@@..@@..........@@@.@.@@@@@@@@@@@@@@@@@@@@@@@@@@@@@@@@@@@@@@@@@
@@@@@@@@@@@.........@....................@@@@...@@@@@@@@@@@@@@@@@@@@@@@@@@@@@@@@@@@@@@@@@
@@@@@@@@@@@...@........@....@.........@@.@@@@.@@@@@@@@@@@@@@@@@@@@@@@@@@@@@@@@@@@@@@@@@@@
@@@@@@@@@@............................@@.@.@@...@@@@@@@@@@@@@@@@@@@@@@@@@@@@@@@@@@@@@@@@@
@@@@@@@@@@.........@.@.................@@........@@@@@@@.@@@@@@@@@@@@@@@@@@@@@@@@@@@@@@@@
@@@@@@@@@@@@@...........................@........@@@@@@@..@@@@@@@@@@@@@@@@@@@@@@@@@@@@@@@
@@@@@@@@@@@@@.................@@.......@@.....@..@@@@@@@@..@@@@@@@@@@@@@@@@@@@@@@@@@@@@@@
@@@@@@@@@@@@@.@..............@.........@@......@@@@@@@.@@...@@@@@@@@@@@@@@@@@@@@@@@@@@@@@
@@@@@@@@@@@@......@.......@@...........@.......@@@@@...@@...@@@@@@@@@@@@@@@@@@@@@@@@@@@@@
.@@@@@@@@.................@@....@@@@@@.......@..@@@@........@@@@@@@@@@@@@@@@@@@@@@@@@@@@@
.@@@@@...@......@@.....@@@@@@...@..@@@.@....@@@@@@@@........@@@@@@@@@@@@@@@@@@@@@@@@@@@@@
.@@@.@............@.@@@@@@@@@.......@.......@@@@@@@@.....@@@@@@@@@@@@@@@@@@@@@@@@@@@@@@@@
...@...@@...........@@@@@@@@...............@@@@@@@@@....@@@@@@@@@@@@@@@@@@@@@@@@@@@@@@@@@
...@...............@@@@@@@@......@.............@@@@@....@@@@@@@@@@@@.@@@@@@@@@@@@@@@@@@@@
....................@@@@@@..@..@...............@@.@.......@@@@@@@@@@.@@@@@@@@@@@@@@@@@@@@
@......@....@.......@@@@@@@@@@@................@.......@...@@@@@@@@@..@@@@@@@@@@@@@@@@@@@
...................@@@@@@@@@@@.................@@@.@.......@@@@@@.....@@.....@@@@@@@@@@@@
.@.................@@@@@@@@@@...................@@.@........@.@@............@@@@@@@@@@@@@
@.........@.........@@@@@@@@@................@@...............@@...........@@@@@@@@@@@@@@
@@@................@@@@@@@@@......................@...........@@..........@@@@@@@@@@@@@@@
@@@@@........@@...@@@@@@@@@@..................@...............@@@.........@@@@@@@@@@@@@@@
@@@@@@@@@@........@@@@@@@@@@@@@............@..@...........................@@@@@@@@@@@@@@@
@@@@@@@@@.@.......@@@@@@@@@@@@@.....................@............@.@.......@@@@@@@@@@@@@@
@@@@@@@@@.....@..@@@@@@@@@@@@@@@.@..@@.@..@.....@@....@..@............@.....@@@@@@.@@@@..
@@@@@@@@...@@@@@@@@@@@@@@@@@@@@@..........@@@...@@.......@@.........@.@.....@......@@@...
@@@@@@@@...@@@@@@@@@@@@@@@@@@@@@........@......@@.........@.................@............
@@@@@@@@...@@@@@@@@@@@@@@@@@@@@@..@....@.......@.......@@................................
@@@@@@@.....@@@@@@@@@@@@@@@@@@@@..@...@........@...................@...........@.......@@
@@@@@@@@....@@@@@@@@@@@@@@@@..........@....@..........................@@@@....@.........@
@@@@@@@@@..@@@@@@@@@@@@@@@@@......@.@......@..........@.@@............@@@.....@..........
@@@@@@@@@..@..@@@@@@@@@@@..............@....@@......@...@.............@@@................
@@@@@@@@@@.....@@@@@@@@@..............@@@..@@....@@@@@@.@..............@@@@....@@........
@@@@@@@@@......@@@@@@@@@........@@@..@@@@@@@@......@@@..................@@@...........@@@
@@@@@@@@.@......@@@@@@@@@............@@@@@@......@.@.@..........@.....@@@@@@@...........@
@@@@@@@@.........@@@@@@@@@..........@@@@@@.......@..............@@......@..@............@
@@@@@@@@@@@........@@...@@..........@@@@@@.................@.@@@@@@........@..@@........@
@@@@@@@@@@@.........@................@@@.@......................@@@@@.........@@@...@@@@@
@@@@@@@@@@@@.....@.........@..@......@@.........................@..@@.@...............@..
@@@@@@@@@@@@........................@@@..@@@...@..@@..........@@@..@@.@..@....@.......@.@
@@@@@@@@@@@@.............@......@.....@..........@@@...........@..........@..............
@@@@@@@@@@@...........................@...........@@@..........@@...............@....@@@.
@@@@@@@@@@@.................@.......@@@.@.........@@@.........@................@@....@@@.
@@@@@@@.@@@...@...@.....@...........@@@@........@.@@@........@@.....@..........@..@@.@...
@@@@@@@......................@..@....@@@@.....@....@@.......@@@...........@@...@..@@....@
@@@@@@....@..@@..@..........@@........@@@...........@.......@.....@@..........@.@........
@@@@@@....@........@@......@@@.........@@..............................@........@........
@@@@@............@..@.@@.....@...........................................@..............@
@@@@@...............@..@.............................@..........................@@.....@@
@@@@.....@......@@@....@............@@@.......@.............@.............@.........@@@@@
@@@@.....@@.....@@....................@.....@@@@@.......@..@....@........@@@@.......@@@@@
@@@..............@@@.............@..........@@@.@.......@@..@...........@@......@@...@@@@
@@@..............@.@@.......................@@@.......@@@@..@@@...@@@...@@@.....@@@..@@@@
......................@@@@@@@@...............@...@.@@@@@@...@@@@........@@.......@...@@@@
.....@..@......@.....@@@@@@@..........@@.....@...@@@@@@@@@..@@@...............@.....@@@@@
@@@.....@@....@@..@...@.@@@........@..@@...@.....@....@@@@...@@..@..................@@@@@
@.....@.@@...@@@......@...............@@.@@......@...........@@...........@.........@@@@@
@............@@@.................@.....@@@......................@.......@@@@.......@@@@@@
...@.....@...@...@@..............@@....@@@@.............@@..............@..@.......@@@@@@
...@@@...........@@....................@@@.......@......@@@@..........@..........@@@@@@@@
...@@@@@@.........@...........@.....@..@@@...@@.@@.@..@@..@@..........@@..........@@@@@@@
@..@@@@@@.........@@..........@..........@..@@..@@........@@@.......................@@@@@
@@.@@@@@@@..@@.....@......@..............@...................................@@.@@@@@@@@@
@@@@@@@@@@.........@..@....................@....................@@@@....@.@.....@@@@@@@@@
@@@@@@@@@....@.............@........@@@@.........@@..........@...@@@....@........@@@@@@@@
@@@@@@@@@.@......@.....@@.....@@@@@.@@@@.........@...................@..@...@.....@@@@@.@
@@@@@@@@@@@@.......@...........@@@..@@@@@.........@@@........@...............@.....@....@
@@@@@@@@@@@@...........@.....................@....@@@@..................................@
@@@@@@@@@@@@.......@@@............@..............@@@@@.@......@..........................
@@@@@@@@@@@.........@@@@.........@@@@...@@.......@@@@.........@@........@................
@@@@@@@@@@@..................@@.@@@@@..........@.@@@.............@.......................
@@@@@@@@@@........@..@@......@@....@...........@@@@......@@@@..............@.......@.....
@@@@@@@@@......@.....@.............@@..........@@@.....@.@@@@@@@@..............@.........
@@@@@@@@@@.........................@@@.........@@..@......@@@@@@@@..........@@.@@@.......
@@@@@@@@@@@...@.........@.....@@...@@@@............@.......@@@@@@@@@@@@..@@@@@@@@@@......
@@@@@@@@@@@.......@@@....@@@.........@@...@@@@@.............@@@@@@@@@@@@@@@@@@@@@@@@@.@@@
@@@@@@@@@@@........@@...@@@@@.@@....@@@@.@@@@@.........@....@@@@@@@@@@@@@@@@@@@@@@@@@@@@@
8
58 21 0
52 76 0
49 34 0
72 33 0
79 79 0
82 47 0
39 60 0
30 33 0

56 17 0
27 69 0
67 43 0
85 86 0
16 13 0
17 79 0
9 2 0
38 28 0
