width 89
height 89
@@@@@@@@@@@@@@@@@@@@@@@@@@@@@@@@......@@@@@@....@@@@..@@@@@@@@@@@@@@@..@.@@@@...@....@@@@
@@@@@@@@@@@@@@@@@@@@@@@@@@@@@@@@@......@@@.....@@@@...@@@@@@@@@@@@@@@......@....@@@..@@@@
@@@@@@@@@@@@@@@@@@@@@@@@@@@@@@@@@....@@@@@.....@@.......@@@@@@@@@@@@@@@........@@@@@...@@
@@@@@@@@@@@@@@@@@@@@@@@@@@@@@@@@@.......@@..................@@@@@@@@@@@................@@
@@@@@@@@@@@@@@@@@@@@@@@@@@@@@@@@@........@..................@@.@@@@@@@@................@@
@@@@@@@@@@@@@@@@@@@@@@@@@@@@@@@@@.......................@@@....@@@@@@@........@..........
@@@@@@@@@@@@@@@@@@@@@@@@@@@@@@@@@.@.......................@.....@@.........@..........@@.
@@@@@@@@@@@@@@@@@@@@@@@@@@@@@@@@@..............@@........................................
@@@@@@@@@@@@@@@@@@@@@@@@@@@@@@@..........@@.@..@@.@.............................@.......@
@@@@@@@@@@@@@@@@@@@@@@@@@@@@@@@.......@@@@@.....@@@....@@...............@@@@.............
@@@@@@@@@@@@@@@@@@@@@@@@@@@@@@@.......@@@@@....@.@.....@@..............@@@@@.............
@@@@@@@@@@@@@@@@@@@@@@@@@@@@@..................@....@..@@.....@........@@..........@@@.@.
@@@@@@@@@@@@@@@@@@@@@@@@@@@@@...........@@@@........@..................@@....@.@@.....@..
@@@@@@@@@@@@@@@@@@@@@@@@@@@@@@@@@@@..........@@.....@...................@............@@@@
@@@@@@@@@@@@@@@@@@@@@@@@@@@@@@@@@@@....@......@.........@..@@....................@....@@@
@@@@@@@@@@@@@@@@@@@@@@@@@@@@@@@@@@...@.................@@..@@@...............@...@....@.@
@@@@@@@@@@@@@@@@@@@@@@@@@@@@@@@@@@@........@...........@@@@@.@@.......@......@..@@.......
@@@@@@@@@@@@@@@@@@@@@@@@@@@@@@@@@@..@..................@@@@@.@......@.....@..@...@@@....@
@@@@@@@@@@@@@@@@@@@@@@@@@@@@@@@@@@@........................@......@............@........@
@@@@@@@@@@@@@@@@@@@@@@@@@@@@@@@@@@......................................................@
@@@@@@@@@@@@@@@@@@@@@@@@@@@@@@@@@@@@.....@@.........@@@...........@@........@.@........@@
@@@@@@@@@@@@@@@@@@@@@@@@@@@@@@@@@@@..@...@@........@@.@....@...@@.@................@.@@@@
@@@@@@@@@@@@@@@@@@@@@@@@@@@@@@@@@@@......@@..............@@.@...@..................@....@
@@@@@@@@@@@@@@@@@@@@@@@@@@@@@@@@@@............@..........@..@@..@.............@....@.....
@@@@@@@@@@@@@@@@@@@@@@@@@@@@@@@@@@@...@.....@@@@...........@@@...........................
@@@@@@@@@@@@@@@@@@@@@@@@@@@@@@@@@@.......@...@@.....@......@@@@@........@..........@...@@
@@@@@@@@@@@@@@@@@@@@@@@@@@@@@@@@@@....@......@@....@@.@....@@@...............@@@@.....@@@
@@@@@@@@@@@@@@@@@@@@@@@@@@@@@@..............................@@@.............@@.@@@@...@@@
@@@@@@@@@@@@@@@@@@@@@@@@@@@@@@.....@@@@.......@.............@@@.............@@.@....@@@@@
@@@@@@@@@@@@@@@@@@@@@@@@@@@@@@@...@@@@@.................@@.@@@@.....................@....
@@@@@@@@@@@@@@@@@@@@@@@@@@@@@@@@@@@@@@@....@............@@@@@@.....@.....@@....@.........
@@@@@@@@@@@@@@@@@@@@@@@@@@@@@@@@@@@@@@@@.@..............@@@@@@@@..@@.......@......@......
@@@@@@@@@...@@@@@@@@@@@@@@@@@@@@@@@@@@@@.@@@............@@@@@@@...@@@......@@...........@
@@@@@@@@@..@@@@@@@@@@@@@@@@@@@@@@@@@@@@@@@@@.....@@.......@@@@@@@.@@@.....@@@@...@......@
@@.@@@@...@@@@@@@@@@@@@@@@@@@@@@@@@@@@@@@@@@................@@@@@@@@@..@@@@@@@.....@...@@
...@@.@....@@@@@@@@@@@@@@@@@@@@@@@@@@@@@@@@@........@@.......@@@@@@@...@@@@@...@...@.....
...@@......@@@@@@@@@@@@@@@@@@@@@@@@@@@@@@@@.........@@........@@...@...@@.....@@.........
...@@........@@@@@@@@@@@@@@@@@@@@@@@@@@@@@@.........@@.........@.....................@...
..@..........@@@@@@@@@@@@@@@@@@@@@@@@@@@@@..........@@@.........................@........
................@@@@@@@@@@@@@@@@@@@@@@@@@@..........@@@..................@@..............
...............@@@@@@@@@@@@@@@@@@@@@@@@@@@@@...@...@@@@.........@@....@@.......@.........
................@@@@@@@@@@@@@@@@@@@@@@@@@@@@@@....@@@@..@@......@@@..@@@.......@.........
........@.......@@@@@@@@@@@@@@@@@@@@@@@@@@@@@@...@@@@@......@@..@@@....@......@@.........
@@...@..@..@.....@@@@@@@@@@@@@@@@@@@@@@@@@@@@@@..@@@@@........@.@@@@....@@...@@@@@.......
@@@......@.......@@@@@@@@@@@@@@@@@@@@@@@@........@@@@@.....@@@.......@..@@..@@@@@@......@
.@@...@..............@@@@@@.@@@@@@@@@@@@@.........@......@....@.....@@@@@@.@@@@@@@.......
......@...............@@@.......@.....@@@.......@@@.................@@@@@@@@@@@@@@.......
..@..@...............@@.........@.....@@@@.......@@..................@@@@@@@@@@@@@.......
@@@.....@..........@.........@..........@@.......@@@@@.........@@....@@@@@@....@@@......@
@@...@..@...........@........@@@.................@@@@@@...............@...@.............@
@@......@@.....@@...@........@@......@...........@@@@@@.............................@....
@@......@@........@@@@........@..@......@@@@.....@@@@@@@....................@.@..@.....@@
@@@...............@@@@@@......................@..@@@@@@@...@@.................@.@......@@
@@...........@...@@@@@@@..........................@@@......................@@@@@.......@.
@................@@@@...............................@......................@@@@@...@.....
@@@@....@................@........@............................@..@@........@@@@.........
........@..@...................................@..............@@...@...........@.........
...@.................@.@..................@.........@.........@@@.@@@..........@.........
......................@@@@....................................@@@@@@@@...@@..............
@@@@.....@...............@.@........@@@@...................@...@@@@@@....@..@@....@.....@
@@@..........@@................@@@@@@@@@................@......@@@@@@...............@....
@@....@.@......................@@@@@@@@@..@@.........@..@.......@@@@@....@.@........@....
@.......@...@@..................@@@@@@@@.............@...@@.......@@@@@..@..............@
@.@@....@...@....@@@.........@@.@@@@@@@@........@....@..@@@.......@@@@@..................
..............@..@@@@.......@@...@@@@@@@@....@.......@..@@@..@@...@@@@@..@.@...........@@
.....@@...........@@@@......@.....@@...@.....@@.....@@............@@@......@@@..@@.....@@
..@..................@...@.........@.........@@....@@@@.................@@............@@@
.........................@...@.....@...@...@@@.....@@@...............@@..@......@@....@@@
.............................@.........@..@@@@..@..@@@@..................@......@.....@@@
.............................@@........@@@@@@@.....@@@...........@.................@@@@@@
.......@.....................@@@.......@@@..@@....@@@@.......@..@@@@@................@@.@
..........@@@@@@........................@@.......@@@.........@.@@@@@.....@....@.....@.@.@
...........@@@@@......@....@............@........@......@....@.@@@@...........@.........@
.....@....@@@@@@........................@@......@..............@@@@......................
@..........@@@@@.@@............@@..............................@@@..@....................
@...........@@@@@@@............@@.@@@@..........@..@..@.@@@.........@.....@.......@.....@
..........@.@@@@@@@..@@.......................@....@.....@@@@............................
.............@@.....@@@@@...@@.......@@.......@...@@@....@@............@.................
@................@@@@@@@@@..@@................@...@@@..........@........................@
................@@@@@@@@@@...@................................@@@...........@.@.........@
@.................@@@@@@...........................@...........@@...........@.@........@@
@................@@@@@@.....................@@.....@..................@....@...@.........
..@@.............@@.@..............................@..................@@@@...............
..@@@.............@.@..........@......@.........@.........@@@..........@@@...............
@...@.............................@@.........@@.@@.............@...............@@........
@@...........................................@@@@@@............................@@@...@...
@...............................@.@@......@@@@@@@@@@..@@.............@@...@.......@..@@..
@.....@...@@..................@.@@@@......@@@@@@@@@@..@@@@......@@@@@@@@@................
@.....@@@@@@@@@@@@..............@@@@@.....@@@@@@@@@...@@@@@@@..@@@@@@@@@....@..@.........
8
2 72 0
40 7 0
4 78 0
41 58 0
22 63 0
77 30 0
27 71 0
68 39 0

80 40 0
2 64 0
48 55 0
23 82 0
23 76 0
49 70 0
87 58 0
68 40 0
