width 89
height 89
@@@@@@@@@@@@@@@@@@@@@@@@@@@@@@@@@@........@@@...............@@.@....@@@@@@@@@@@@@@@@@@@@@
@@@@@@@@@@@@@@@@@@@@@@@@@@@@@@@@.............@@..........@.......@....@@@@@@@@@@@@@@@@@@@
@@@@@@@@@@@@@@@@@@@@@@@@@@@@@@@....................@@............@@....@@@@@@@@@@@@@@@@@@
@@@@@@@@@@@@@@@@@@@@@@@@@@@@@@@...................@@.......@............@@@@@@@@@@@@@@@@@
@@@@@@@@@@@@@@@@@@@@@@@@@@@@@@@...................@@......@.@...........@@@@@@@@@@@@@@@@@
@@@@@@@@@@@@@@@@@@@@@@@@@@@...............@.................@.........@@@....@@@@@@@@@@@@
@@@@@@@@@@@@@@@@@@@@@@@@@@@.....@...............................@.....@@..@@.@@@@@@@@@@@@
@@@@@@@@@@@@@@@@@@......@.@@.....................@....................@@........@@@@@@@@@
@@@@@@@@@@@@@@@.@@@@..................................................@@@...........@@@@@
@@@@@@@@@@@@@@@.@@@.....................@.@@............................@......@....@@@@@
@@@@@@@@@@@@@.......@...@.........@.....@@@@@@.......................................@@@@
@@@@@@@@@@@@@@......@...@.........@@....@@@@@..@@............................@.......@@@@
@@@@@@.@@@@@@@..........@.......@.@...@@@@@@@.............@....@@................@.....@@
@@@@@@..@@@@@@@..@..........@.........@@@@@@@@@@...................@..@..............@.@@
@@@@@@..@@@@.@@@.@@.....@.............@@@@@@@@@@.......................................@@
@@@@@@..@.@@..@@................@.....@@@@@@@@@...............................@........@@
@@@@@@........@@....@.................@@@@@@@@@..........@.........@..............@....@@
@@@@@.................................@@@@@@@@.........@@.........@.....@................
@@@@@@@...@@.....@@.............@.....@@@@@@@@.......@....@.......@...@......@...........
@@@@@@@.@.........@@.....@.@@...@.....@@@@@@@@@......@........@@.......@.....@@........@.
@@@@@@@@..............@@@@@@@......@...@@@@@@@@......@......@@@@@............@@...@....@@
@@@@@@@@@@@@..........@@@@@@@@.....@.@@@@@@@@@@...@...@.....@@@@@@..........@@@..........
@@@@@@@@@@@@...@......@@.@........@@@@@@@@@@@......@@@@..@@...@@@............@@..........
@@@@@@@@@@@@........@..@....@@...@@@@@@@@@@@@........@@........@@............@@@.........
@@@@@@@@@@@@......@..............@@@@@@@@@@@@@@@@@......@@...............................
@@@@@@@@@@@@@....@@..............@..@@@@@@@@@@@@@@@@@.........@..................@@......
@@@@@@@@@@@@@@@@.@@...........@.....@@@@@@@@@@@@@@@@@@@@......@.......@....@.............
@@@@@@@@@@@@@@@@@@@.................@@@@@@@@@@..@@@@@@@@@..........................@....@
@@@@@@@@@@@@@@@@@@....................@@@@@@@@..@@@@.@@@@.........@........@.......@..@.@
@@@@@@@@@@@@@@@@@.........@@@@..@@.....@@@@@.........@@@@@@.......@......@.............@@
@@@@@@@@@@@@@@@@@.....@.....@@.........@...@......@.@@@@@@@@...........................@@
@@@@@@.......@@@................@..@.......@........@...@@@@.............................
@@@@@................@........................@..@@@@@..@@@@...........@@........@......@
@@@@@...@...@......@@@............@......@.......@@@@.....@@.....................@.......
@@@@@.......@@......@@@...........@......@.......@@@.............@...............@@@@....
@@@@@.@@@........................@@................@.............@....@@....@@...@@@@@...
@@@@@.@@@.......................@@@........@@.........................@@@@@.@@.@@@@@@@.@.
@@@@@@@@@.@.@@@.......@@........@@@@.@........@....@.................@@@@@@....@@@@@@@...
@@@@@@@@@...@@.....@..@@@.....@....@................@...@..............@@@@..@@@@@@..@...
@@@@@@@@@..@...@...@...@.@............@........@.......@@.....@.............@@@@@@@..@...
@@@@@@@@...@..@@.......@....@.......@@@.......................@...@...............@..@..@
...@@@.....@@.@@.....@..............@@@..........@............@..@@.....................@
...@@@@..............@..........@@...@@.....@............@....@.....@@.@@...............@
...@@...........@....................@@........@.........@@@@......................@.@@..
@.............@@@....................@@........@@..............................@..@...@..
..............@@@.........@.........@@@.........@........................................
...............@@@..............@.....@......................@...@.......................
...............@@@@.............@.....@...................@@.....@@@@@....@..........@...
.....@@.........@@.................@..................@.@@@@@...@@@@....@................
.................@...@............@@.......@.......@....@@.@@@.....@..@@.................
@@@...@..............@............@....@.......@..@@........@@........@@.....@.@......@..
@@.........................@......................@@...........@@.@@.....@@@.@@@@..@.....
@@@@...@........@.........@@......................@@...@...@....@.@@..@..@@@@@@@@@.@.....
@@@@@........@............@@......................@........@.........@@@@@@@.............
@@@@.............@.....@@@@@@........................................@@@@@..............@
...@....................@.......@..@................................@@@@.@...@@...@@....@
........@@@@@@@....@................................................@........@@@@.......@
......@@@@@@@@............@...................................@.....@........@@@@........
......@@@@@@...........@..........@.....@..@.@......................@..@@@@.@@@@@......@.
.....@@@@@@@@.......................@......@.@@..@@......................@@@@@@@@.@......
..@@@@@@@@................@@@......................@@........@...........@@@@............
...@@@@@@@..............................@..........@@@@..@....@......................@..@
...@@@@@@@.............@@.....@.@.........@......@....@..........@@@....@...............@
....@@@@@@.@......................@..@@...@...@..@@............@@@@.....................@
....@@@@@@.............@............@@@..@......................@@@.....................@
@@..@@@@@@...........@@@............@@@..@@.....................@@@.........@.......@@...
@..@@@@....@....................@...@@@...............@@......@@@@@@................@@...
...................................@@@@................@@@...@@@@@@@@@...................
.....@...@..@@..............@......@@@@...............@@@@@@@@@@@@@@@@.....@.............
.@...@......@@....@@@@.............@@@@...............@@@@@@@@@@@@@@@@...@.@.............
@@........@@@@.@..@@@..............@@@@@.........@@@@@@@@@@@@@@@@@@@@@...@@@...........@@
@@........@@@@@@...................@@@@@..........@@@@@@@@@@@@@@@@@@@.....@@@...........@
@@@....@...@@@.@@....@..............@@@....@.......@@@@@@@@@@@@@@@@@.......@......@..@@..
@@@@@......@...........@@.....@..@...@.....@.......@@@@@@@@@@@@@@......@@@.@...@.....@@..
@@@@@.............................@@................@.@@@@@@@@@@....@@@@@@...............
@@@@@..............................@...........@......@@@@@@@@@@.@@@@@@.@@@..............
@@@@@.......@......@@.....@................@...@........@@@@@@@@@@@@@@...............@@@@
@@@@@..............@@.....@..................@....@@..@.@@@@@@@@@@@@@..................@@
@@@@@@........................@...@..........................@@@@@@@@.@@.................
@@@@@........................@@.@.............................@@@@@@..@@@................
@@@@@@........................................................@@@@@@@@@@.................
@@@@@@@@@............@.................@.......................@@@@@@@@@@@@.............@
@@@@@@@@@@@....................@@..@@.@@@...@@@@..@............@@@@@@@@@@@@..@@@........@
@@@@@@@@@@@@@@...@@@........@..@@..@@.@@@@@.@@@@@@@.......@..@@@@@@@@@@@@@@..@@@.......@@
@@@@@@@@@@@@@.................@@@.@@@@@@@@@@@@@@@@@@....@@@..@@@@@@@@@@@@@@..@@@@...@@.@@
@@@@@@@@@@@@@.........@.......@@@@@@@@@@@@@@@@@@@@@@@...@@@@@@@@@@@@@@@@@@@@@@@@@@@@@@@@@
@@@@@@@@@@@@@@@@@@....@.......@@@@@@@@@@@@@@@@@@@@@......@@@@@@@@@@@@@@@@@@@@@@@@@@@@@@@@
@@@@@@@@@@@@@@@@@@@@@@@...@......@@@@@@@@@@@@@@@@@@@.....@@@@@@@@@@@@@@@@@@@@@@@@@@@@@@@@
@@@@@@@@@@@@@@@@@@@@@@@.........@@@@@@@@@@@@@@@@@@@@@....@@@@@@@@@@@@@@@@@@@@@@@@@@@@@@@@
8
49 37 0
28 8 0
38 29 0
16 12 0
75 65 0
88 68 0
20 22 0
64 1 0

44 4 0
74 46 0
22 25 0
87 74 0
71 16 0
29 26 0
77 66 0
35 25 0
