width 89
height 89
@@@@@@@@....@@@@@..@..@@@@....@....@@@@@@@@@@@@@@@@@@..@@@@@@@@@@@@@@@.....@.@..@@@......
@@@@@@@......@@.......@@.....@@.....@@@@@@@@@@@@@@@@...@@@@@..@@@@@@@...@..@.@.......@...
@@@@@@@.......@......@@@............@...@@@@@@@@@@@@@..........@@@@@@.........@....@@...@
@@@@@.....@...........@@........@@..@...@@.@@@@@@@@@@...........@@@........@@.@.....@....
@@@@@.................................@..@.@..@@@@@@@...........@@@.........@............
@@@@..........@@@........................@.....@@@@@.@........................@@@.@......
@@@@@.........@@@........@...............@.....@@@@@..........................@.@@@@@....
@@@........................@.............@....@@@@.........@.....................@@@@@...
@@@......@.....................@@.............@@@@........................@......@@@@@...
@@...............................@@..........@@@@@@.......................@@.....@@.@....
@@....................@..@.............@@.....@@@@@@....................................@
@@......@@.................@............@......@@@@......@..............................@
@@......@@.@....................@..@.@..........@@@......@@.......@......................
@.......@..@....@......................................@.@@@.........@...................
@..........................@...........................@........@...@....................
...............@..............@.................................@........................
@..............@................@.................@...@.......@@..............@@.........
@...@@.......................@@.@.....................@.....@@@...........@....@.........
@..@@@@@........................@...........@................@@@....@....................
@.@@@@@@@@......................@...............@@..@.........@@........@@.........@.....
@@@@@@@@@@.....@............@...................@@.@@.........@@......@...............@@.
@@@@@@@@@...................@@..................@@@@@@........@.....@.............@...@@.
@@@@@@@...........@@.............@@@@............@@@@@..@@...@@@..@.................@@@@@
@@@@@@@.@.........@@@.........@...................@@@@.......@@@.........@.........@@@@@@
@@@@@@..@..................@@.@.............@........@@....@@@@@@........@@.........@@@@@
@@@@@@.@@@...@@....@......@...@@......@.............@@@....@@@@@@........@@.....@@......@
@@@@@@.@@@@.@@@....@......@....@......@...@....@.@@...@.......@@..........@.....@@......@
@@@@@..@@@@.@@@.............@.........@........@..@............@.........................
@@@.......@.................@......@@@...........@@.........@@@@.........@.@...........@.
@@@.................@@@.....@......@@........@.......@.......@@@.......................@@
@@@....@.....@......@@.............@@..............................@....................@
@...........@.......................@.................................@.....@............
@...........@......................................@@...@@.......@....@.........@..@.....
.@.....@@...@......@........@@..........................@@@......@.....@@................
....@..@@@.@@......@@..................@@........@@......................@...............
......@@@@@.......@@......@..@@........@@@@@@@.........@@................................
@......@@@@.......@..@@.@....@@........@@@@@@@...............@..@........@..@.@..........
@.......@@@@..........@@@@....@@....@..@@@@@@@..............@@.........@@@....@......@@@@
...........@.....@@.@....@.....@....@@@@@@@@@...............@@...@....@@@......@.@..@@@@@
...........@@..@.....................@.@@@@@@...........@@.@@@..@@@@..@@@@..........@@@@@
@@@..................@@.@..............@@@@@............@@@@@...@@@@...@.....@@...@@@@@@@
@@@@.....@............@.@...............@@@@..........@@@@@@@@.@@@@@@@@.......@..@@@@@@@@
@@@@..@.........@@@.....................@@@@@.......@.@@@..@@@@@@@@@@@@....@@.@@.@@@@@@@@
@@@@..@.@.......@.............@.@.......@@@@@..................@@@@@@@...@@@...@..@@.@@@@
....................@@........@@.......@@@@@..................@@@@@@.@....@.......@..@@@@
..@..@..@.@@.......@...........@@.......@....@.@.............@@@@@@@.................@@@@
@@@@.....@.................@...@@..@.......................@.@@@@@@@@@@@@@@@@@@..........
..@@..............@....@@@.@.@.............................@@@@@@@@@@@@@@@@@@............
..................@...............@...@....................@@@@@@@..@@@@@@@@@............
.............................@........@...@.......@.........@@@@@.....@.@..@..@..........
.......@@@...........@@@..............@.....................@@..............@@@..........
.......@@@@@...@....@..............................................@........@@@.@@.......
.......@@@@@@.@@@@..........................................@............................
....@...@@@@@.@@.......@@......@...@...@........@@@...........@@.........................
@@@@@...@@@@@@@@@@.@..@@@@@..@@.....@........@..@@@......................................
@@@@@@@@@@@@@@@@@@@@@@@@@@....@.........@@.@@@@.@@.....@.@...............................
@@@@@@@@@@@@@@@@@@@@@@@@@@@.............@@.@@@@.@......................@@@@..............
@@@@@@@@@@@@@@@@@@@@@@@@@@@@@...@............@@......@...@............@@@@@@...@.........
@@@@@@@@@@@@@@@@@@@@@@@@@@@@....@......@@...@@..@........@......@....@..@.........@...@@.
@@@@@@@@@@@@@@@@@@@@@@@@@@@.....@@..@@.......@..........@@...........@..........@........
@@@@@@@@@@@@@@@@@@@@@@@@@@@@@.@@@@..@..................@@....@......................@.@..
@@@@@@@@@@@@@@@@@@@@@@@@@@@@@.@@@@@@@...@@.@.....@@.............................@........
@@@@@@@@@@@@@@@@@@@@@@@@@@@@@@@@@@@@@@@@@...@....@.@...............@....................@
@@@@@@@@@@@@@@@@@@@@@@@@@@@@@@@@@@@@@@@@@@@........@@.....@......@@@.....@@....@.........
@@@@@@@@@@@@@@@@@@@@@@@@@@@@@@@@@@@@@@@@@@@......@.............@@@@@.....@@@@@@...@......
@@@@@@@@@@@@@@@@@@@@@@@@@@@@@@@@@@@@@@@@@@@@@....@@.........@@@@@@@@..@..@@@@@@..........
@@@@@@@@@@@@@@@@@@@@@@@@@@@@@@@@@@@@@@@@@@@@@..@@@@@@.......@@@@@@@......@@@@@@...@..@@..
@@@@@@@@@@@@@@@@@@@@@@@@@@@@@@@@@@@@@@@@@@@@@..@@@@@@.......@@@..........@@@@@....@.....@
@@@@@@@@@@@@@@@@@@@@@@@@@@@@@@@@@@@@@@@@@@@@@@@@@@@@@........@@.@.@@@@...@@@.............
@@@@@@@@@@@@@@@@@@@@@@@@@@@@@@@@@@@@@@@@@@@@@@@@@@@@@......@..@....@@@@..............@...
@@@@@@@@@@@@@@@@@@@@@@@@@@@@@@@@@@@@@@@@@@@@@@@@@@@@........@...................@..@.....
@@@@@@@@@@@@@@@@@@@@@@@@@@@@@@@@@@@@@@@@@@@@@@@@@@@.........@@@..........................
@@@@@@@@@@@@@@@@@@@@@@@@@@@@@@@@@@@@@@@@@@@@@@@@@@...@@.....@@@...........@...@.....@....
@@@@@@@@@@@@@@@@@@@@@@@@@@@@@@@@@@@@@@@@@@@@@@@@@@@@@@@@...@@@.............@.......@@@..@
@@@@@@@@@@@@@@@@@@@@@@@@@@@@@@@@@@@@@@@@@@@@@@@@@@@@@@@@........@.........@..@.........@.
@@@@@@@@@@@@@@@@@@@@@@@@@@@@@@@@@@@@@@@@@@@@@@@@@@@@@@.@.....................@..@........
@@@@@@@@@@@@@@@@@@@@@@@@@@@@@@@@@@@@@@@@@@@@@@@@@@@@@@.@...........................@....@
@@@@@@@@@@@@@@@@@@@@@@@@@@@@@@@@@@@@@@@@@@@@@@@@@@@@@..........@.........................
@@@@@@@@@@@@@@@@@@@@@@@@@@@@@@@@@@@@@@@@@@@@@@@@@@@@@......@@.....@@..@.........@@.......
@@@@@@@@@@@@@@@@@@@@@@@@@@@@@@@@@@@@@@@@@@@@@@@@@@@@@@@..@@@@@.......@@...@@@..@@@.......
@@@@@@@@@@@@@@@@@@@@@@@@@@@@@@@@@@@@@@@@@@@@@@@@@@@@@@@@@@@@@@@.......@@@@@@@@@@@@.......
@@@@@@@@@@@@@@@@@@@@@@@@@@@@@@@@@@@@@@@@@@@@@@@@@@@@@@@@@@@@@@@@@.....@@@@@@@@@@@@.......
@@@@@@@@@@@@@@@@@@@@@@@@@@@@@@@@@@@@@@@@@@@@@@@@@@@@@@@@@@@@@@@@@@.@..@@@@@@@@@@@@@......
@@@@@@@@@@@@@@@@@@@@@@@@@@@@@@@@@@@@@@@@@@@@@@@@@@@@@@@@@@@@@@@@@@@@@@@@@@@@@@@@@...@@...
@@@@@@@@@@@@@@@@@@@@@@@@@@@@@@@@@@@@@@@@@@@@@@@@@@@@@@@@@@@@@@@@@@@@@@@@@@@@@@@@@........
@@@@@@@@@@@@@@@@@@@@@@@@@@@@@@@@@@@@@@@@@@@@@@@@@@@@@@@@@@@@@@@@@@@@@@@@@@@@@@@..........
@@@@@@@@@@@@@@@@@@@@@@@@@@@@@@@@@@@@@@@@@@@@@@@@@@@@@@@@@@@@@@@@@@@@@@@@@@@@@@@........@.
@@@@@@@@@@@@@@@@@@@@@@@@@@@@@@@@@@@@@@@@@@@@@@@@@@@@@@@@@@@@@@@@@@@@@@@@@@@@@@@....@.....
@@@@@@@@@@@@@@@@@@@@@@@@@@@@@@@@@@@@@@@@@@@@@@@@@@@@@@@@@@@@@@@@@@@@@@@@@@@@@@@@@@@@@....
8
50 59 0
25 27 0
14 48 0
48 40 0
20 33 0
76 11 0
2 32 0
65 16 0

85 10 0
83 85 0
54 1 0
57 51 0
21 23 0
42 31 0
5 34 0
66 20 0
