width 89
height 89
@@@@@@@@@@@@@.....@@@@@@@@@@@@@@@@@@@@...@@@@@@@@@@@...@@@@@@@@@@@@@@@@@@@@@@@@@@@@@@@@@@
@@@@@@@@@@@@@@....@@@@@@@@@@@@@@@@@@@@....@@@@@@@@@@......@@..@@@@@@@@@@@@@@@@@@@@@@@@@@@
@@@@@@@@@@@@@@.....@@@@@@@@@@@@@@@@@@......@@@@@@@@..........@@@@@@@@@@@@@@@@@@@@@@@@@@@@
@@@@@@@@@@@@@@...@@@@@@@@@@@@@@@@@@@@.......@@@@@.@..@@......@@@@@@@@@@@@@@@@@@@@@@@@@@@@
@@@@@@@@@@@@@@.@.@@@@@@@@@@@@@@@@@@@....@..@@@@@@.............@@@@@@@@@@@@@@@@@@@@@@@@@@@
@@@@@@@@@@@@@@.....@..@@@@@@@@@@@@@@.........@@@@......@......@@@@@@@@@@@@@@@@@@@@@@@@@@@
@@@@@@@@@@@@@......@...@@@@@@@@@@@@@.........@@@.......@......@@@@@@@@@@@@@@@@@@@@@@@@@@@
@@@@@@@@@@@@@..........@@@@@@@@@@@@........................@@@@@@@@@@@@@@@@@@@@@@@@@@@@@@
@@@@@@@@@@@@@@......@@@@@@@@@@@@@@@.............@..........@@@@@@@@@@@@@@@@@@@@@@@@@@@@@@
@@@@@@@@@@@@@.......@@@@@@@@@@@@........@..@.............@@@@@@@@@@@@@@@@@@@@@@@@@@@@@@@@
@@@@@@@@@@@@........@.@@@@@@@@....@.....................@@@@@@@@@@@@@@@@@@@@@@@@@@@@@@@@@
@@@@@@@@@@@@..........@@@@..@..@.......................@@@@@@@@@@@@@@@@@@@@@@@@@@@@@@@@@@
@@@@@@@@@@@@..........@@@@.......@..@@.......@@...@.....@@@@@@@@@@@@@@@@@@@@@@@@@@@@@@@@@
@@@@@@@@@@@@@......@..@.@@........@..........@@..............@..@@@@@@@@@@@@@@@@@@@@@@@@@
@@@@@@@@@@@@..........@....................@@@@.....@...........@@@@@@@@@@@@@@@@@@@@@@@@@
@@@@@@@@@@@.................@..@....@....................@......@@@@@@@@@@@@@@@@@@@@@@@@@
@@@@@..@@@@.................@@.@.....................@.........@@@@@@@@@@@@@@@@@@@@@@@@@@
@@@@.....@@..............@..............@@......................@@@@@@@@@@@@@@@@@@@@@@@@@
@@@@....@@@@@@@@..@.....................@@.......@............@@@@@..@@@@@@@@@@@@@@@@@@@@
....@....@.@@@@@..@@@.......@...........@@.......@...............@...@@@@@@@@@@@@@@@@@@@@
............@@@@@@@@@.......@@@@@..............@@@........@..........@@@@@@@@@@@@@@@@@@@@
..@.@.........@@@@@@@@......@@@@@@@..@........@@@@@......@@...........@@@@@@@@@@@@@@@@@@@
..@.............@@@@.........@@@@@..@.@.......@@@@@.......@...........@..@@@@@@@@@@@@@@@@
..@............@@@@..........@@@@@........@@..@@@@...@.......@@...........@@@@@@@@@@@@@@@
..........@....@@@@.........@@@@..............@..............@@......@....@@@@@@@@@@@@@@@
@@@.@@....@@.................@@@....@......@..@.....................@@...@@@@@@@@@@@@@@@@
@@@@@@.....@.......................................@@..........@..@......@@@@@@@@@@@@@@@@
@@@@@@@.........................@@....@...........@@@@................@..@.@@@@@@@@@@@@@@
@@@@@@@.....@@@@.....@.@@@@.......@...............@@@@@....................@@@@@@@@@@@@@@
@@@@@@@.....@@@@...........@...@.................@@@@@@......@@...............@@@@@@@@@@@
@@@@@@@...@@@@@@@...@......@@....................@@@@@@......@@@........@@@.....@@@@@@@@@
..@@@@@...@@@@@@...........@@.........@@@@@......@@@........@@@@.....@...@@.....@@@@@@@@@
..@@@@@...@@@@@..........@@@@.........@.@@@......@@@@.......@@@@.................@@@@@@@@
...@@@@...@@@@@@@........@@@.............@.......@.@...........................@.@@@@@@@@
....@@...@@@@@@@@@@@.....@@@.......................@@.......................@...@@@@@@@@@
............@@@@@@@@..@..@@@......................@@@.................@.....@@@.@@@@@@@@@
@@..........@@@@@@@@..@........@........................................@.........@@@@@@@
@...........@@@@@@@....................................@@@....@..@................@@@@@@@
......@.....@@@@@@@....@@.@.............@.............@@@.....@@..................@@@@@@@
...@........@@@@@@@..@................................@...........@.....@@.....@@@@@@@@@@
..@........@@@@@@@@..........................@@@@.............................@@@@@@@@@@@
...........@@@@@@@@....@.@........@@....@....@@@@@@...........................@@@@@@@@@@@
...........@@@@@@@@.@...@@@@@................@@@@@@.@.........@.......@..........@@@@@@@@
....@.....@..@@@@@@@@@@.@@@@@.......@@@@.....@@@@@@.@@.............@@.@...........@@@@@@@
..........@@...@@@@@@@@@@@@@.........@@@@@...@..@...................@.......@@......@@@@@
..........@......@@@@@@@@@@@........@@@@@@@@.........................@..............@@@@@
.@...............@@@@@@@@@@@...@.@@@@...@@@.......................@......@............@@@
................@@@@@@@@@@@@...@@@@......@........@@.................................@@@@
.........@@@....@@@@@@@@@@@@....@@.............@...............................@.@@@@@@@@
....@@@@@@@@.....@@.@@@@@@@@......@.........@@.@.....@........@@.............@.@@@@@@@@@@
@@..@@@@@@@@@........@@@@@@@@.....@@@.......@............@.......@.........@.....@@@@@@@@
@@@@@@@@@@@@@......@..@@@@@@@........................@...@.........@@@..........@@@@@@@@@
@@@@@@@@@@@@@@.......@@@..@............@.............@...................@......@@@@@@@@@
@@@@@@@@@@@@@@..@....@@...@.....@......@@@...@...........@....@.....@......@....@@@@@@@@@
@@@@@@@@@@@@@@@.......@..............@..@@...@............@...@@................@@@@@@@@@
@@@@@@@@@@@@@@@............@........@@..................@............@..........@@@@@@@@@
@@@@@@@@@@@@@@...........@...................@...................................@@@@@@@@
@@@@@@@@@@@@@......@.....@.......................................@@@........@..@@@@@@@@@@
@@@@@@@@@@@@@..@.....................@..@....@...@.@...........@@@@@........@.....@@@@@@@
@@@@@@@@@..@...@..@....@....@.@......@@@@@...............@......@@@@..............@@@@@@@
@@@@@@@@@.........@@..........@@......@@@@@.......................................@@@@@@@
@@@@@@@@@.....@.......................@@@@@@@...........@....@.......@@............@@@@@@
@@@@@@@@......@......................@@@@@@@.........................@...........@@@@@@@@
@@@@@@..............................@.....@@...@.......@..@......@@@@@...........@@@@@@@@
@@@@@..............@@......@.....@@........@........@..@.@@......@@@@@@.........@@@@@@@@@
@@@.@............@@@@.@....@.....@@...@....@............@.@...@.@@@@@@@........@@@@@@@@@@
@@@.@..............@.@...........@.................@............@@@@@@@.......@@@@@@@@@@@
@@@.......@..................@@..@@@@............@..............@@@@@@@....@@.@@@@@@@@@@@
@@@..@............@@@............@@@@............@.....@@@..@@@@@@@@@@@@......@@@@@@@@@@@
@@@..@..........@@@@@............@@@@........@.@@@@....@@@@@@@@@@@@@@@@@.....@@@@@@@@@@@@
..........@.............@........@@@...@.......@@@@....@@@@@@@@@@@@@@@@@.....@@@@@@@@@@@@
@........@@...@@................@@@@.@@@........@..@.@@@@@@@@@@@@@@@@@@......@@@@@@@@@@@@
............@.@....@.....@@@....@.@@............@......@@@..@@@@@@@@@@@.......@@@@@@@@@@@
.........................@@@.......................@....@@..@@@@@@@@@@.......@@@@@@@@@@@@
...........@............@..@....@..................@@.......@@@@@@@@@...@..@@@@@@@@@@@@@@
.@....................@....@....@.................@.........@@@@@@@@.......@@@@@@@@@@@@@@
.@..@............@@...@....@@...@@@@.......................@@@@@@@@@@.@....@@@@@@@@@@@@@@
.@..@..........@...@..@.......@@@@.....@@@@.........@@....@@@@@@@@@@@@@....@@@@@@@@@@@@@@
@@.............................@@.....@.@@@.@.@@.....@.@..@@@@@@@@@@@@@@@..@@@@@@@@@@@@@@
@@.................@@@..........@.@@....@@@@@@@@@@@@@@....@@@@@@@@@@@@@@@@@@@@@@@@@@@@@@@
@@...............@@@@..................@.@...@@@@@@@@....@@@@@@@@@@@@@@@@@@@@@@@@@@@@@@@@
@@...@............@...........................@@@@@@@.@@@@@@@@@@@@@@@@@@@@@@@@@@@@@@@@@@@
@@@....@......................................@@@@@@@..@@@@@@@@@@@@@@@@@@@@@@@@@@@@@@@@@@
@@@@@......................@.........@.@...@..@@@@@@@..@@@@@@@@@@@@@@@@@@@@@@@@@@@@@@@@@@
@@@@@@...........@@..@...........@.........@@@@@@@@@@.@@@@@@@@@@@@@@@@@@@@@@@@@@@@@@@@@@@
@@@@@@@..@....@@@@@@.....@..@....@...........@@@@@@@..@@@@@@@@@@@@@@@@@@@@@@@@@@@@@@@@@@@
@@@@@@@@@@@...@@@@@@....@@.......@@..........@@@@@@@..@@@@@@@@@@@@@@@@@@@@@@@@@@@@@@@@@@@
@@@@@@@@@@@..@@@@@@@@@...@.......@@@@@@...........@@@@@@@@@@@@@@@@@@@@@@@@@@@@@@@@@@@@@@@
@@@@@@@@@@@..@@@@@@@@@...@...@@@@@@@@@@@@@@.@@@...@@@@@@@@@@@@@@@@@@@@@@@@@@@@@@@@@@@@@@@
8
19 27 0
46 64 0
7 22 0
2 35 0
41 68 0
64 25 0
10 73 0
13 81 0

30 81 0
17 5 0
37 39 0
12 21 0
39 68 0
55 77 0
60 3 0
67 20 0
