width 89
height 89
@@@@@@@@@@@@@@@@@@.@........@..@...@@@@@@@@@@@@@@...@@..@@@....@@@@@@@@@@@@@@@@@@@@@@@@@@
@@@@@@@@@@@@@@@@@@..@...........@...@@@@@@@@@@@@@.......@.......@@@@@@@@@@@..@@@@@@@@@@@@
@@@@@@@@@@@@@@@@..........@....@........@@@@@@..@.............@@@@@@@@@@@.....@@@@@@@@@@@
@@@@@@@@@@@@@@@..@@.....................@..@@.....@@.@.......@@@...@@.@@....@..@@@@@@@@@@
@@@@@@@@@@@@@@@...............@...................@@...@@...........@.....@....@@...@@@@@
@@@@@@@@@@@@@...........@...............@.........@@...@................@.@..........@@@@
@@@@@@@@@@@@@.@@@.........@@.........@..@@.....@........................@......@.........
@@@@@@@@@@@@..@@.....................@@........@........@...............@..@@.......@....
@@@@@@@@@@@@..@@.............@....@.@@............@...@..................@..........@@.@@
@@@@@@@@@@@@..@@@............@............@.@.....@@.........@...........@.........@@@@@@
@@@@@@@@@@@@..@@@...........@.......@.........@@@..@@........@...........@..@......@@@@@@
@@@@@@@@@@@@@@..@........@..........@.@..........@.@@...................@@@@@@......@@@@@
@@@@@@@@@@@@@@@.....@@...@......@.............@@......................@@@@@@@@@..@@@@@@@@
@@@@@@@@@@@@@@@......@@..@...............................@@...@@......@@@@@@@@@...@@@@@@@
@@@@@@@@@@@@@@@....@@@..............@@...@...........@@...@@..@@@.......@@@@@@@...@@@@@@@
@@@@@@@@@@@@@@@@.................@@@@....@...........@@@@@@@....@.......@@@@@@@.@@@@@@@@@
@@@@@@@@@@@@@@@@@@.......@..@@@@@@@@@.@.@@@.........@.@@@@@@..@.........@@@@@@@.@@@@@@@@@
@@@@@@@@@@@@@@@@@@@....@@@..@@@..@..........@@.....@..@@@@@@@.....@@....@@@@@@@@@@@@@@@@@
@@@@@@@@@@@@@@@@@@......@@..................@...........@@@............@@@..@@@@@@@@@@@@@
@@@@@@@@@@@@@@@@@@......@@............@.........@.......@@@@@..........@@...@@@@@@@@@@@@@
@@@@@@@@@@@@@@@@@@..............................@@........@@..........@.@..@@@@@@@@@@@@@@
@@@@@@@@@@@@@@@@@@.@.............................@...........................@@@@@@@@@@@@
@@@@@@@@@@@@@.@@@..@...@@@....@..@....@..........................@@..........@@@@@@@@@@@@
@@@@@@@@@@@@@......@..@@@....@@.@@......@............@..........@@@...@@@....@@@@@@@@@@@@
@@@@@@@@@@@@@....@......@....@@@@@..............................@@@....@....@@@@@..@@@..@
@@@@@@@@@@@...................@@@@@......@......................@@@.@@......@@@@........@
@@@@@@@..@@.............@.....@@@@..........@@.......@................@.....@@@.....@..@.
@@@@@@.................@@...@..@@......@...............@.........................@.......
@@@@@@...............@@@@.........@..@@@@................@@@.................@..@@.......
@@@@@@...............@.@.............@@@@.@@..@.@@..............................@@.......
@@@@@@..............@@.......................@@@@@.......@................@......@...@...
@@@@@@@.............@@.......................@@@@@@..........@........@.@@@....@.........
@@@@@@@@.........@...............@@@@@...@@@@@@@@@@..........@..........@@...............
@@@@@@@@..........................@@@@.@@@@@@@@@@@@...@......@...........@@..............
@@@@@@@@....@...............@....@@@@@@@@@@@@@@@@@@@@.@.................@@.........@.....
@@@@@@@................@...........@@@@@@@@@@@@@@@@@@..............................@...@.
@@@@@@@@@.......@..................@@@@@@@@@@@@@@@@@@@.................@@...@......@.....
@@@@@@@@@@........@......@.........@@@@@@@@@@@@@@@@@@@..@.......@@@....@@....@........@..
@@@@@@@@@@...@....@@@....@@@@......@@@@@@@@@@@@@@@@@@@........@@.........................
@@@@@@@@@....@..@.@@.....@@@.....@@@@@@@@@@@@@@@@@@@@@......@@@@.........................
@@@@@@@@@@@.......@@.....@@@@..@@@@@@@@@@@@@@@@@@@@@@@@.....@@@@..@.......@..............
@@@@@@@@@@........@..@@@@@@@@@@@@@@@@@@@@@@@@@@@@@@@@@...@.@@@@@@@@@.....................
@@@@@@@@@@.@@@.....@@@@@@@@@@@@@@@@@@@@@@@@@@@@@@@@@@@@@@@@@@@@@@@@@@.........@..........
@@@@@@@@@@.@@@@@...@@@@@@@@@@@@@@@@@@@@@@@@@@@@@@@@@@@@@@@@@@@@@@@@@..................@@@
@@@@@@@@@@@@@@@@..@@@@@@@@@@@@@@@@@@@@@@@@@@@@@@@...@@@@@@@@@@@@@@@.@.................@@@
@@@@@@@@@@@@@@@@@.@@@@@@@@@@@@@@@@@@@@@@@@@@@@@@@.......@@@@@.................@..@....@@@
@@@@@@@@@@@@@@@@@@@@@@@@@@@@@@@@@@@@@@@@@@@@@@@@.....@....@@@....................@@@@.@@@
@@@@@@@@@@@@@@@@@@@@@@@@@@@@@@@@@@@@@@@@@@@@@@@......@....@@@................@....@@@@@@@
@@@@@@@@@@@@@@@@@@@@@@@@@@@@@@@@@@@@@@@@@@@@@@@......@@.......@..........@.....@..@@@@@@@
@@@@@@@@@@@@@@@@@@@@@@@@@@@@@@@@@@@@@@@@@@@@@........@@........................@@@@@@@@@@
@@@@@@@@@@@@@@@@@@@@@@@@@@@@@@@@@@@@@@@@@@@@@.........@.......@...@.......@...@@@@@@@@@@@
@@@@@@@@@@@@@@@@@@@@@@@@@@@@@@@@@@@@@@@@@@@...................@...........@@..@@@@@@@@@@@
@@@@@@@@@@@@@@@@@@@@@@@@@@@@@@@@@@@@@@@@@@@...................@.....@....@...@@@@@@@@@@@@
@@@@@@@@@@@@@@@@@@@@@@@@@@@@@@@@@@@@@@@@@@@.....@@..........@......@@....@....@@@@@@@@@@@
@@@@@@@@@@@@@@@@@@@@@@@@@@@@@@@@@@@@@@@@@@@.....@@@.................@....@....@@@@@@@@@@@
@@@@@@@@@@@@@@@@@@@@@@@@@@@@@@@@@@@@@@@@@@@@.............................@.....@@@@@@@@@@
@@@@@@@@@@@@@@@@@@@@@@@@@@@@@@@@@@@@@@@@@@@@......................@...............@@@@@@@
@@@@@@@@@@@@@@@@@@@@@@@@@@@@@@@@@@@@@@@@@@@@..................................@..@@@@@@@@
@@@@@@@@@@@@@@@@@@@@@@@@@@@@@@@@@@@@@@@@@@@@.............@@.@@.......@.......@@...@@@@@@@
@@@@@@@@@@@@@@@@@@@@@@@@@@@@@@@@@@@@@@@@@@@@.................@@..............@@...@@@@@@@
@@@@@@@@....@@@@@@@@@@@@@@@@@@@@@@@@@@@@@@@@.................@@........@.....@@...@@@@@@@
@@@@@@@@......@@@@@@@@@@@@@@@@@@@@@@@@@@@@@@........@.......@@@.......@.@.@..@...@@@@@@@@
@@@@@@@@......@.@@@@@@@@@@@@@@@@@@@@@@@@@@@@@@@........@@@...................@...@@@@@@@@
@@@@@@@@@........@@@@@@@@@@@@@@@@@@@@@@@@@@@@@@...................................@@@@@@@
@@@@@@@@@@.......@@@@@@@@@@@@@@@@@@@@@@@@@@@@@@.........@.@@@......................@@@@@@
@@@@@@@@@@.......@@@@@@@@@@@@@@@@@@@@@@@@@@@@@@@............@@.@............@......@@@@@@
@@@@@@@@@@.........@@@@@@@@@@@.@@@@@@@@@@@@@@@@@....@........@.....@..@....@.......@@@@@@
@@@@@@@@............@@.@.@@@...@@@@@@@@@@@@@@@@@@..@@..............@..@...........@@@@@@@
@@@@@@@@...................@...@@@@@@@@@@.@@@@@@@..@@.............................@@@@@@@
@@@@@@@@.@......................@@@@@..@....@................@....................@@@@@@@
@@@@@@@@..............@.........@@@@@..................@.................................
@@@.@..............@@............@@..............@@@.....@......@@@.@....................
@@@.@.........@..@@@.....@.@......@.......@..@@@@@@@.....@@@.....@@.@...@..........@@@...
@@......@.....@..@@.....@@.......................@@....@@@@@..@.@@@@@@......@.......@@...
@@@.....@.@.............@.......@.......@@.......@@..@.@@.......@@@@...........@.........
@@@................@@................@...@...........@@@@.....@.@@.....................@@
@@@@...............@@...@@@@@......@.@@@.............@@@@@@...................@.........@
@@@@@@@......@@............@@@......@@@@..............@@@.........................@@@@..@
@@@@@@@..............@.....@@@..@......@@.............@@@@.......@@..@.....@.....@@@@....
@@@@@@@......................@.....@..................@@@@...........@@........@.@@@@....
@@@@@@.....@@...............@...@......................@@@..............@...@.@@@@@@@.@..
@@@@@@......@..............@............................................@.....@@@@@@@.@..
@@@@@@......@@...@.............................@@...................@.@@@.......@@@@@.@..
@@@@@@.......@..@............@@@...@.......@....@.....................@@........@@@@@@@..
@@@@@...@@@.........@@@....@@@@@...........@@.....@...............@...@@@@.....@@@@@@@@@.
@@@@@...@@@.........@@@....@@@@.........@...@..@@@@...................@.......@@@@@@@@@@.
@@@@@@..@@@@.......@@@@@...@@@@.....@@@...@@@@.@@@@@@@................@......@@@@@@@@@...
@@@@@@@@@@@@@....@@@@@@@.@@@@@@@@@@@@@....@@@...@@@....@......@@....@.@.......@@@@@@@@@@.
@@@@@@@@@@@@@...@@@@@@@@.@@@@@@@@@@@@@...@@@.....@@..........@@@@.....@.....@@@@@@@@@@@@@
8
57 66 0
65 14 0
5 71 0
35 18 0
46 60 0
58 59 0
66 81 0
63 53 0

19 2 0
46 76 0
78 82 0
72 74 0
67 70 0
39 85 0
56 11 0
71 7 0
