width 20
height 13
..................@@
...............@....
...@.......@..@.....
@.......@.@.........
....................
........@.......@...
...@..@....@.......@
................@...
....................
@.......@.@..@......
............@.......
.............@...@..
.................@@@
6
10 6 0
0 6 0
6 12 0
13 7 1
9 9 1
15 9 1

12 4 0
6 11 0
13 1 0
2 8 1
18 5 1
1 12 1
