width 20
height 13
.....@.........@@@@@
................@@@@
....................
........@..@........
...@..@..@..........
...@@........@.@....
...@......@.@.......
.....@..............
.............@......
......@.........@...
.........@.....@....
..........@.........
....@...............
6
4 7 0
12 12 0
13 1 0
10 4 1
11 1 1
19 7 1

17 10 0
9 9 0
7 9 0
0 12 1
1 10 1
2 5 1
