width 56
height 56
@@@@@@@@@@@@@@@@@@@@@..............@@@@@@@@@@@@@.@..@@@@
@@@@@@@@@@@@@@@@@@@@@@...............@@@@@@@..@......@@@
@@@@@@@@@@@@@@@@@@@@@@@.................................
@@@@@@@@@@@@@@@@@@@@@@@@@..........................@....
@@@@@@@@@@@@@@@@@@@@...@@@.......@.@@@..................
@@@@@@@@@@@@@@@@@@@@................@@....@............@
@@@@@@@@@@@@@@@@@@@..................................@@@
@@@@@@@@@@@@@@@@@@............@@@...........@........@@@
@@@@@@@@@@@@@@@@@@@....@.....@@@.@...........@........@.
@@@@@@@@@@@@@@@@@@@@.....@....@@......@......@..........
@@@@@@.@@@@@@@@@@@@...........@@......@@.....@..........
.....@..@@@@@@@@@@@..@@.......@......@@@.......@.....@@@
........@@@@@@@@@@@@........@.....@@@@@@@.......@...@@@@
....@...@@...@@@@@@@...@.@.........@@@@@@...........@@@@
.............@@@@@@@.@....@.....@...@@@@@...........@@@@
.............@@@@@@@..........@.@.@@@@@@@.......@...@@@@
..............@.@@@...........@@@.@@@@@@@...........@@@@
@....@@@....@.............@....@...@@.@.@.@..@.........@
@@........@...........@....................@...........@
......@..................@..........................@@@@
.........@@........@...................@........@...@@@@
...@......@...........@...@....@................@.....@@
@@....@..................@@.......@@......@...........@@
@..............@@.........@.....@.@...................@.
@.@@..................@@@@@...@..@@..@@@@@......@.......
@@@@...@@.............@@@@@@...@.....@@@@@....@.@.......
@@@.....@@.............@@@@..........@@@@@...@@@@@.....@
@@@..@.@@@.@...........@@@@@..........@@@@..@@@@@@.....@
.......@@@@@...........@@@@@.......@..........@@@..@....
.........@@@...........@@@@@.@.................@.......@
.........@.............@@@@@...............@.......@....
..........@............@@@@@................@@@.........
.....................@@@@@@.....@........@...@@.........
@@@@@............@....@@@@@.........@....@...@@@........
@@@..................@@@@@@@@................@.@........
@@@.........@.......@@@@@@@@@...........................
@@@......@@......@@@@@@@@@@@@.........@.................
@@@@@....@@...@..@@@@@@@@@@@@..........@......@...@.....
@@@@@@@..........@@@@@@@@@@@@...................@.......
@@@@@@......@....@@@@@@@@@@@@..................@@...@@@.
@@@@@@......@@...@@@@@@@..............................@.
@@@@@@@...@@@@...@@@@@@@.....@................@.....@...
@@@@@@....@@@@@..@@@@@@.................................
@@@@......@@@@@...@@@@@..@......................@.......
@@@@@.....@@@@@@...@@@@.@.........@.....................
@@@@@.@@...@@@@@....@@@@@...............@...............
@@@@@.@@..........@@@@@@@.......@.......................
...@@.............@@@@@@@..@@....................@......
..............@.@.@@@@@...........@.................@...
..@...........@@@@@@@@@@@...............................
........@@....@@@@@@@@..............@.....@..@@@........
.........@....@@@@@@@..........@@...........@@@@.....@@@
.............@@@@@@@....@......@@@@@...@@...@@@@.....@@@
...@....@......@@............@@@@@@@@@..@@@@@..........@
@..............@@.........@@@@@@@@@@@@..@@@@@...........
.....@@..@...@@@@......@@@@@@@@@@@@@@@..@@@@@..@........
8
28 7 0
24 20 0
52 43 0
1 30 0
15 30 0
1 24 0
40 46 0
13 16 0

5 32 0
37 29 0
41 3 0
54 54 0
25 5 0
1 23 0
8 18 0
35 51 0
