width 56
height 56
....@@@@@...@@@@@@@@....@@@@@........@.@@......@@@@@@@@@
.@.@@@@@@.....@@@@@......@@@...........@@......@@...@@@.
.....@@@@..@..@@@@@......@@..@................@@@@..@...
...............@@@.......@..........@@...@....@@@@......
...............@@@.......@..............................
....@@.....@.@@@@@.@@.@.........@............@@@........
@............@@@@@..@.....@..@...............@@@........
@@...........@@@@@@@@...@.......@....@@......@@@........
@............@@@@@@.............@@@..@@.......@@..@.....
@@.............@@@...................@@@.@@......@@....@
...............@@@@@......@@.........@.....@@@.........@
...............@@@@@.......@@@...@.........@@@@.........
@..............@@@@........@@..@@@...........@@...@@....
@..............@@@@........@.....@@..........@@....@@...
@........@@.......@@@@.....@......@..........@@.........
.........@@.......@@@....................@@...@........@
@........@@.......@@@..............@..........@.....@@@@
@..@................@.............................@..@@@
..........@.........@@..................................
........@.....@.....@......@.........................@..
.........................@......................@@......
...............@.........@..........@@@@@.......@.@.....
@.....@........................@...@@@@@@.........@....@
......@@..@......................@@.....................
.@@...@@...@........@...........@@..............@@@@@...
..@............@.........@@@.....@......@...@...@@@@....
@.....@........@@@@......@@@................@...@..@@...
....@@@.......@@@@@@...@@@@@............................
....@@.........@.......@@@@.............................
........................@...............@..............@
....@............@.....................@@@.......@.....@
@..........@@..............................@............
..@.@....................................@..............
...........@..........@....@............@@.......@......
...........@...............@.@@@@.......................
........@..@@@............@@@@@@@.........@@.@@......@..
.....@@@@..@@@.....@@...@.@@@@@@.............@..........
......@@...@@......@@.@@@.@@@@@@@...........@@@.........
@@@@.@@@@..@@@.....@@@@@@@@@@@@@@@....@@..@@@@@.........
@@@@@@@@@@.@.@@@...@@@@@@@@@@@@@@@@@@@@@..@@@@@...@@@@..
@@@@@@@@@.....@@...@@@@@@@@@@@@@@@@@@@@@@@@@@@@.@@@@@@..
@@@@@@@@@@@...@@...@@@@@@@@@@@@@@@@@@@@@@@@@@@@.@@@@@@@.
@@@@@@@@@@@@..@@@@@@@@@@@@@@@@@@@@@@@@@@@@@@@@@@@@@@@@@@
@@@@@@@@@@@@@@@@@@@@@@@@@@@@@@@@@@@@@@@@@@@@@@@@@@@@@@@@
@@@@@@@@@@@@@@@@@@@@@@@@@@@@@@@@@@@@@@@@@@@@@@@@@@@@@@@@
@@@@@@@@@@@@@@@@@@@@@@@@@@@@@@@@@@@@@@@@@@@@@@@@@@@@@@@@
@@@@@@@@@@@@@@@@@@@@@@@@@@@@@@@@@@@@@@@@@@@@@@@@@@@@@@@@
@@@@@@@@@@@@@@@@@@@@@@@@@@@@@@@@@@@@@@@@@@@@@@@@@@@@@@@@
@@@@@@@@@@@@@@@@@@@@@@@@@@@@@@@@@@@@@@@@@@@@@@@@@@@@@@@@
@@@@@@@@@@@@@@@@@@@@@@@@@@@@@@@@@@@@@@@@@@@@@@@@@@@@@@@@
@@@@@@@@@@@@@@@@@@@@@@@@@@@@@@@@@@@@@@@@@@@@@@@@@@@@@@@@
@@@@@@@@@@@@@@@@@@@@@@@@@@@@@@@@@@@@@@@@@@@@@@@@@@@@@@@@
@@@@@@@@@@@@@@@@@@@@@@@@@@@@@@@@@@@@@@@@@@@@@@@@@@@@@@@@
@@@@@@@@@@@@@@@@@@@@@@@@@@@@@@@@@@@@@@@@@@@@@@@@@@@@@@@@
@@@@@@@@@@@@@@@@@@@@@@@@@@@@@@@@@@@@@@@@@@@@@@@@@@@@@@@@
@@@@@@@@@@@@@@@@@@@@@@@@@@@@@@@@@@@@@@@@@@@@@@@@@@@@@@@@
8
18 6 0
43 36 0
21 0 0
18 5 0
3 21 0
41 10 0
35 38 0
48 23 0

52 32 0
32 17 0
21 21 0
6 18 0
18 36 0
42 12 0
12 34 0
28 18 0
