width 56
height 56
@@@@@@......@.......@@@@@@@.........@@@@@@@@@@@@@@......
@...@..@.@@@@...@....@@@@@.......@@.@@@@@@@@@@@@@@......
.......@...@......@...@@@@........@.@@@@@@@@@@@@@..@@...
.......@........@@..@...............@@@@@@@@@@@@@.......
.......@@........@.................@@@@@@@@@@@@@@@......
@...........@...........@@.........@@@@@@@@@@@@@@@......
@........@..@.....@.....@@......@@....@@@@@@@@@.........
.........@.............@@@..@@........@@@@@@@@@@@.......
.........@@............@@@@@@@.......@@@@@@@@@@@@.......
................@@......@@@@@@@......@@@@@@@@@..........
.......................@@@@.@@.......@@@.@@@@....@@.....
.....@.......@@........@@@@....................@....@...
.......................@@.........@@@..........@@.......
................@.......@....@........@@................
@.........@.................@@.@.......@................
.............................@................@....@@@@@
....@........................@.....................@@@@@
...........................@.........................@@@
.....................@........@.......@..........@@@.@@@
@....@................@...........@@@@@.............@@@@
@..................@@.....@@@.....@@@@@.............@@@@
...@....@...............@..@@.....@@@@@.......@@...@@@@@
...@@..@@............@.....@@....@@@@@@@@....@@@...@@@@@
@..@@@..@@..........@@@....@@@@..@@@@@@@@...@@@@@@@@@@@@
@@@@@@..@@.......@..@@@....@@@...@...........@@@@@@@@@@@
@@@@@@.....................@@@..@@...@.......@@@@@@@@@@@
@@@..............@...@.@........@@...@@@@....@@@@@@@@@@@
@@@......@@......@@@.................@@@@...@@@@@@@@@@@@
@@@.....@@.......@@@@...........@...@@......@@@@@@@@@@@@
@@@.....@@@@.......@@........@..@@.........@@@@@@@@@@@@@
@@@............@@............@............@@@@@@@@@@@@@@
...............@..@...@....@.............@@@@@@@@@@@@@@@
...............@....................@@...@@@@@@@@@@@@@@@
.....@@.............................@@@@.@@@@@@@@@@@@@@@
......@...@@@........................@@@@@@@@@@@@@@@@@@@
@..@@.@@.@@@@........@...............@@@@@@@@@@@@@@@@@@@
@@@@@@@@@@@@.......@@@@@@.....@@@@@@@@@@@@@@@@@@@@@@@@@@
@@@@@@@@@@@@@.....@@@@@@@......@@@@@@@@@@@@@@@@@@@@@@@@@
@@@@@@@@@@@...@...@@@@@@@@..........@@@@@@@@@@@@@@@@@@@@
@@@@@@@@@@@@.@@..@@@@@@@@@..........@@@@@@@@@@@@@@@@@@@@
@@@@@@@@@@@@@@@@@@@@@@@.............@@@@@@@@@@@@@@@@@@@@
@@@@@@@@@@@@@@@@@@@@@@@......@.....@@@@@@@@@@@@@@@@@@@@@
@@@@@@@@@@@@@@@@@@@@@@...............@@@@@@@@@@@@@@@@@@@
@@@@@@@@@@@@@@@@@@@@@@@......@.......@@..@@@@@@@@@@@@@@@
@@@@@@@@@@@@@@@@@@@@@@@........@.....@...@@@@@@@@@@@@@@@
@@@@@@@@@@@@@@@@@@@@@@@..................@@@@@@@@@@@@@@@
@@@@@@@@@@@@@@@@@@@@@@@.........@@@...@@.@@@@@@@@@@@@@@@
@@@@@@@@@@@@@@@@@@@@@@@@..@..........@@@@@@@@@@@@@@@@@@@
@@@@@@@@@@@@@@@@@@@@@@@@..........@@@@@@@@@@@@@@@@@@@@@@
@@@@@@@@@@@@@@@@@@@@@@@@...........@@@@@@@@@@@@@@@@@@@@@
@@@@@@@@@@@@@@@@@@@@@@@@...........@@@@@@@@@@@@@@@@@@@@@
@@@@@@@@@@@@@@@@@@@@@@@........@@@@@@@@@@@@@@@@@@@@@@@@@
@@@@@@@@@@@@@@@@@@@@@@@@@@....@@@@@@@@@@@@@@@@@@@@@@@@@@
@@@@@@@@@@@@@@@@@@@@@@@@@...@@@@@@@@@@@@@@@@@@@@@@@@@@@@
@@@@@@@@@@@@@@@@@@@@@@@@@.....@@@@@@@@@@@@@@@@@@@@@@@@@@
@@@@@@@@@@@@@@@@@@@@@@@@@....@@@@@@@@@@@@@@@@@@@@@@@@@@@
8
28 45 0
34 41 0
13 2 0
54 10 0
9 30 0
16 19 0
10 13 0
18 20 0

34 35 0
13 19 0
34 8 0
7 24 0
3 4 0
45 16 0
47 20 0
8 14 0
