width 56
height 56
...@..@@@@@@@@@@..@@@.........@@@..@@@@@@@@@@@@@@@@@@@@@
.....@@@@@@@@@@......@.........@@...@@@@@@@@@@@@@@@@@@@@
@....@@@@@...........@..............@@@@@@@@@@@@@@@@@@@@
@.....@@@@@..........................@@@@@@@@.@@@.@@@@@@
..........@...@.............@.......@@@........@...@@@..
........@@@@@.........................@.........@.......
........@@@@@..............@@@@.........................
.......@@@...................@..@.......................
...@...@@@.......................@..@@@.@............@..
..........@...@.........@...........@@..@..........@....
.....@................@.@@..@...........................
.......@.......@.......@@@.@..@@............@..@@.@.....
..........@............@@@...........@@...........@..@..
.........@......@......@@@..@@..@....@@@................
........................@@..@@@@@@@............@@.@.....
@@@@@@....................@@@@@@@@@@@@..@@.....@@@@.....
@@@@@@......................@@@@@@@@@.@@@@..............
@@@@@@.........@.@..........@@@@@@@@..@@@...........@..@
@@@@@@.........@............@@@@..........@......@@@@@@@
@@@@@..........@....................@........@@@@@@@@@@@
@@@@@...@.@.@.......@@@@.....................@@@@@@@@@@@
@@@@@...@.........@.......@..........@......@@@@@@@@@@@@
@@@@@@@@@....................@@..@.............@@@@@@@@@
@@@@@@@@@....................@.........@.......@@@@@@@@@
@@@@@@@@@................@...@.@........@@@@@@@@@@@@@@@@
@@@@@@@@@@...................@..........@@@@@@@@@@@@@@@@
@@@@@@@@@@..........@@.....@.@........@@@@..@@@@@@@@@@@@
@@@@@@@@...@@.....@@@@....@@@@.........@@...@@@@@@@@@@@@
@@@@@@@@..@@@.@@@@@@@@..@.@@@@@.............@@@@@@@@@@@@
@@@@@@...@@@@@....@@@.....@@@@@@@...........@@@@@@@@@@@@
@@@@@@@@@@@@@@.....@@.........@@@.....@..@@.@@@@@@@@@@@@
@@@@@@@@@@@@@@@@.........................@@@....@@@@@@@@
@@@@@@@@@@@@@@@@..@..............@@@.....@......@@@@@@@@
@@@@@@@@@@@@@@@@..@.......@@..@....@@..@.........@@@@@@@
@@@@@@@@@@@@@@@@..............@@...@@...@........@@@@@@@
@@@@@@@@@@@@@@................@@@@@...............@@@@@@
@@@@@@@@@@@@@@......@..@......@@@@.................@@@@@
@@@@@@@@@@@@@@......@..@@...............@.....@....@@@@@
@@@@@@@@@@@@@@@.........................@.@@.........@@@
@@@@@@@@@@@@@@@@@.........@...@........@.............@@@
@@@@@@@@@@@@@@@@@..........@..@@....@@@.................
@@@@@@@@@@@@@@@@@..........@@@@@.....@@.@..........@....
@@@@@@@@@@@@@@@@@..........@@@@@............@...........
@@@@@@@@@@@@@@@@@@@@......@@@@@@...........@............
@@@@@@@@@@@@@@@@@@@@@...@@@@@@@@.@.@@...@@........@.....
@@@@@@@@@@@@@.@@@@@@@...@@@@@@@@@@@@...@@@@@@..@@@@@@@..
@@@@@@@@@@@@@.@.@@......@@@@@@@@@@@@@@@@@@@@@..@@@@@@...
@@@@@@@@@@..............@@@@@@@@@@@@@@@@@@@.@..@@@@@@...
@@@@@@@@@@................@@@@@@@@@@@@@@@@@.....@@@@@@..
@@@@@@@@@.......@@......@@@@@@@@@@@@@@@@@@.......@@@@@@.
@@@@@@@@@@@@@...@@....@..@@@@@@@@@@@@@@@@@.....@.@@@@@@.
@@@@@@@@@@@@@@............@@@@@@@@@@@@@@@@.@.....@@@@@@@
@@@@@@@@@@@@@@.............@@@@@@@@@@@@@@@@@.....@@@@@@@
@@@@@@@@@@@@@@.............@@@@@@@@@@@@@@@@@@@@@@@@@@@@@
@@@@@@@@@@@@@@@............@@@@@@@@@@@@@@@@@@@@@@@@@@@@@
@@@@@@@@@@@@@@@@@.@@......@@@@@@@@@@@@@@@@@@@@@@@@@@@@@@
8
0 1 0
43 12 0
40 4 0
34 10 0
42 41 0
23 25 0
13 22 0
43 28 0

13 46 0
34 27 0
53 40 0
24 26 0
33 25 0
46 44 0
29 5 0
39 28 0
