width 56
height 56
@@@@@@@@@@@@@@@@@@@@@@..........@..............@@@@@@@@@
@@@@@@@@@@@@@@@@@@@@@@@@........@.@............@@@@@@@@@
@@@@@@@@@@@@@@@@@@@@@@@@@@@....................@@@@@@@@@
@@@@@@@@@@@@@@@@@@@@@@@@@@......................@@@.@@@@
@@@@@@@@@@@@@@@@@@@@@@.@@@@.....................@.@..@@@
@@@@@@@@@@@@@@@..@@@@..@@............................@@@
@@@@@@@@@@@@@@...@@@@.......@.........@..............@@@
@@@@@@@@@@@@@@.....@@...@.............@....@.........@@@
@@@@@@@@@@@@@@@...@@@...@....@.......@@....@...........@
@@@@@@@@@@@@@@....@@@........@.......@@...@...........@@
@@@@@@@@@@@@@@.....@@.....................@..@.......@@@
@@@@@@@@@@@@@.........@.......@........@.....@@...@@.@@@
@@@@@@@@@@@@@.............@..............@.........@@@@@
@@@@@@@@@@@@@.............@@.........................@@@
@@@@@@@@@@@@@...........@.@..@..........@............@@@
@@@@@@@@@@@@....@.....@........@@......@@...@.@@@..@...@
@@@@@@@.@...............................@..............@
@@@@@@@................@.....................@..@@.....@
@@@@@@@...............@@....@.@@................@.....@@
.....@...................@............@...............@@
.........................@..................@..........@
.........................@@@...............@@.....@@..@@
......@.........@.............@@@..........@@...@@@....@
@...............@.............@@............@@........@@
@@@...........................@@....................@.@@
@@@..................................@............@@@...
@@@...........@......@..@..@.........@.........@...@@@@.
@@@..@........@....@...@@..@.........@..@..........@@@@@
@@@.@....@@..@@.........@..@.@@@....................@@@@
@@@@@....@@@.@....@.................................@@@@
@@......@..@......@...................@.............@@@@
@.....................................@..@..........@@@@
.........................................@..........@@@@
...................@......................@@........@@@@
@.....@@@...@......@........@..........@@...........@@@@
@@......@@@................@....@...........@....@@@@@@@
@@@@...@@@...............@....@..@@.@@......@....@@@@@@@
@@@@@@@@@@.@..@@@@....@@......@.....@@@..........@@@@@@@
@@@@@@@@@@@@@@@@@@@@@@@@............@@@............@@@@@
@@@@@@@@@@@@@@@@@@@@@@@@@@.........@@@@...........@@@@@@
@@@@@@@@@@@@@@@@@@@@@@@@@........@.@@................@@@
@@@@@@@@@@@@@@@@@@@@@@@@@...@........................@@@
@@@@@@@@@@@@@@@@@@@@@@@@@......@..@@....................
@@@@@@@@@@@@@@@@@@@@@@@@@.........@@....................
@@@@@@@@@@@@@@@@@@@@@@@@@.....@@@@@@................@@@.
@@@@@@@@@@@@@@@@@@@@@@@@@.....@@@@@@..........@..@@@@@@@
@@@@@@@@@@@@@@@@@@@@@@@@@........@@@.............@@@@@@@
@@@@@@@@@@@@@@@@@@@@@@@@......@@@@@@@.@..........@@@@@@@
@@@@@@@@@@@@@@@@@@@@@@@......@@@@@@@.......@.@@..@@@@@@@
@@@@@@@@@@@@@@@@@@@@@@@......@@@@@@........@@@@.@@@@@@@@
@@@@@@@@@@@@@@@@@@@@@@.....@...@@@..........@@...@@@@@@@
@@@@@@@@@@@@@@@@@@@@@@...........@..........@@...@@@@@@@
@@@@@@@@@@@@@@@@@@@@@@...@@@.@........@...........@@@@@@
@@@@@@@@@@@@@@@@@@@@@@@..@.............@.........@@@@@@@
@@@@@@@@@@@@@@@@@@@@@@@@@@..........@@@@......@.@@@@@@@@
@@@@@@@@@@@@@@@@@@@@@@@@@@...........@@@@@...@...@@@@@@@
8
35 11 0
35 28 0
29 25 0
45 3 0
8 17 0
41 7 0
31 41 0
13 11 0

47 8 0
14 9 0
29 31 0
22 35 0
34 53 0
43 14 0
17 15 0
44 41 0
