width 56
height 56
@@@...@.......@@@@@.....@@@@@........@@@....@@@@@@@.....
@@@...........@@........@@@@.........@.......@@@@@......
@@@.@.........@.........@@@@......@..........@.@.@@.....
@@.....................@@@@@.@@....@..@......@....@....@
......................@@@@@@..@@...........@........@@@@
.....@..........@..@.@...@@@........................@@@@
...................@@@...@@@@........@@@...@........@@@@
@.....@@.......@.@.........@@....@....@....@.........@@@
......@@.......@.................................@@@..@@
.....................@.....@@.@.....@@......@@.........@
@....................@@.....................@....@......
@....................@@...............@..@..............
@@...........@.@..@.................@@@..@@.............
@@......................@@.@......@@@........@........@@
@.........@.........@...@@.......@@@@@.......@@.......@@
..................@.@@..@@@.@...@@@@@......@@@@@@.....@@
..................@@@@...@@.....@@@@....@@@@@@@@@@@@..@@
@@..@@............@.............@@@...@@@@@@@@@@@@@@@@@@
@@@@@..........@.....................@@@@@@@@@@@@@@@@@@@
@@@@@@@@....@......@.......@@.......@@@@@@@@@@@@@@@@@@@@
@@@@@@@@....@..@@@........@@@..@@....@@@@@@@@@@@@@@@@@@@
@@@@@@@@@......@@@..................@@@@@@@@@@@@@@@@@@@@
@@@@@@@@@......@@@.................@@@@@@@@@@@@@@@@@@@@@
@@@@@@@@......@@@@.....@...........@@@@@@@@@@@@@@@@@@@@@
@@@@@........@@@@...................@@@@@@@@@@@@@@@@@@@@
@@@@........@@@@@@.....@...........@@@@@@@@@@@@@@@@@@@@@
@@@......@@...@@@...@.....................@@@@@@@@@@@@@@
...................@@.....................@@@@@@@@@@@@@@
.......................@...................@@@@@@@@@@@@@
..............@.....@.....@@@.............@@@@@@@@@@@@@@
....@......................@@@............@@@@@@@@@@@@@@
..@@@..@.........@......@..@..@..........@@@@@@@@@@@@@@@
@@@@.................@@....@.@............@@@@@@@@@@@@@@
@@@..................@.........@@.........@@@@@@@@@@@@@@
@@@.....@@@....................@@.@..@....@@@@@@@@@@@@@@
@@......@@@.....................@@........@@@@@@@@@@@@@@
@@.......@@...@@..............@@@@@.........@@@@@@@@@@@@
...@....................@.........@............@@@@@@@@@
@@@@...@@@........................................@@@@@@
@@@@@..@@@.@.....@..@.........@...@............@...@@@@@
@@@@@..@.....@...@@@@....................@@@@@......@@@@
@@@............@@@@@@....................@@@......@.@@@@
@@@.............@@@@@.....................@@.....@@@@@@@
@@@@.............................................@.@@@@@
@@@...................@.............................@@@@
@@@@@@.........@@@....@.......@@....................@@@.
@@@@@@@......@@@@@@@...........@.....@@...............@.
@@@@.@........@@@@@@.................@.....@............
@.............@@@@@.....................................
@.............@@@@@@......@@@................@.@@.......
@....@........@@@@@...@.@.@@@@.................@@.@.....
@..@@@@........@@@@.....@.@@...................@@@@.....
@..@@@.......@.........@@@@@@....................@@@@@.@
@.......................@@@@@.....................@@@@@@
@@@@.......@@...@.@.....@@@.......................@@@@@@
@@@@@......@@..@@@@@@@..@@@....@....@@@@.........@@@@@@@
8
48 7 0
46 46 0
43 14 0
13 7 0
6 54 0
42 46 0
47 53 0
42 49 0

23 2 0
20 31 0
25 9 0
39 15 0
19 54 0
42 48 0
54 47 0
24 41 0
