width 20
height 17
@@...@@.............
@...................
......@..@.@..@.....
....................
...@................
.....@.......@......
....@......@.....@..
................@...
.@..................
....................
.....@.....@.......@
.................@@@
.@...@..@.......@@@@
............@...@@@@
..@.....@.....@....@
.@.@.@..............
..........@@........
6
12 2 0
2 8 0
3 16 0
15 15 1
8 10 1
18 9 1

3 3 0
15 2 0
15 7 0
15 13 1
7 12 1
17 9 1
