width 20
height 17
.....@@@@...@.......
.......@.........@..
....@........@.....@
......@.............
@...................
@@..@.....@.........
@............@......
@..@..@.....@......@
.@..................
.......@..@....@....
.......@............
.....@...........@..
......@.......@.....
..@..........@@.....
...........@.@@.....
.............@......
...@................
6
9 1 0
7 3 0
15 7 0
8 4 1
9 10 1
9 0 1

19 15 0
5 5 0
0 0 0
12 12 1
19 0 1
12 6 1
