width 20
height 17
.......@.......@@...
..@.....@.........@.
.............@......
......@...@.........
....................
..@...@.@...........
.........@.....@....
............@.......
@...................
@.@....@............
..............@..@..
...@...........@....
@.....@.@.@.@.......
@@......@....@......
@.@............@.@..
@..@................
@...................
6
8 9 0
14 13 0
11 5 0
2 7 1
17 2 1
16 16 1

1 10 0
1 3 0
10 2 0
14 16 1
0 6 1
3 3 1
