width 20
height 17
...........@........
....................
@...................
@@@................@
@@.........@........
@@.....@.......@....
......@.............
..@....@...@....@...
....@.@...@......@..
.........@..........
.@..@...@..@........
...@........@..@..@.
@........@...@......
...........@........
.....@..............
....................
....................
6
14 8 0
6 5 0
11 3 0
19 5 1
15 13 1
12 14 1

5 0 0
5 5 0
17 12 0
5 16 1
7 9 1
14 13 1
