width 20
height 17
@@@................@
@@..@..............@
@@......@...........
.....@.@..@.........
....................
..@..............@..
..........@.........
....................
...@.........@......
.....@.@.@.........@
...............@...@
..@......@....@.....
...@.@.@............
................@...
....................
...@.......@.......@
............@.......
6
11 13 0
7 8 0
17 1 0
14 16 1
19 11 1
5 4 1

6 4 0
11 11 0
0 15 0
10 8 1
17 11 1
11 16 1
