width 20
height 17
..............@.....
.@............@.....
....@...@...........
.............@....@.
............@.......
..@..@..............
.......@..@...@.....
...............@.@..
....................
...@...@.@..........
......@...........@.
.......@.@......@..@
...................@
.....@...@...@......
....................
.....@.....@........
....................
6
15 1 0
1 0 0
9 0 0
10 16 1
9 12 1
7 4 1

11 3 0
12 1 0
0 10 0
2 2 1
6 6 1
8 5 1
