width 20
height 17
..........@.........
.......@..@.@.......
...@................
.............@......
...@...@............
..@..............@..
......@.............
.@................@.
........@...........
............@.......
....@...............
.@...............@..
......@.....@.......
....@..@............
................@...
...........@........
....................
6
1 4 0
14 2 0
14 10 0
18 3 1
1 6 1
5 11 1

8 12 0
9 15 0
5 15 0
4 15 1
3 3 1
6 4 1
