width 20
height 17
.......@............
..@.................
......@..@...@......
........@..@....@...
....................
..@....@............
.@.............@....
...........@........
.....@.......@.@....
.....@..............
..............@.....
......@..@...@..@...
....................
........@..........@
........@....@@....@
...@.........@@....@
............@@@....@
6
18 11 0
8 8 0
10 16 0
2 12 1
0 7 1
0 14 1

5 14 0
1 10 0
9 3 0
1 0 1
10 5 1
15 16 1
