width 79
height 79
@......@@@@@@@..@.......@@@@@@@@@@@@@@@@...@................@@@@@@@@@@@@@@@@@@@
@@@@......@@.@..........@@@@@@@@@@@@@@.@.....................@@@@@@@@@@@@@@@@@@
@.......@................@@@@@@@@@@@@@...........@.@@@......@@@@@@@@@@@@@@@@@@@
@........................@@@@@@@@@@@@@....@@@@@..@.....@......@@@@@@@@@@@@@@@@@
@@..........@..@.........@@@@@@@@@@.......@@@@@@......@@@@.....@@@@@@@@@@@@@@@@
...............@.@@@@@@@@.@.@@@@@@..........@@.@@.....@@@........@@@@@@@@@@@@@@
..@..............@@@@@@...@..................@..@@@...@@.........@@@@@@@@@@@@@@
.@@..@.........@.@@@@.......@@....................@......@......@@@@@@@@@@@@@@@
..@@.@@@@@@..@....@@@.................@...........@..............@@...@@@@@@@@@
.....@@@@@@..@.........@..@.......@..@@@...................@.....@@...@@@@@@@@@
.....@@@@@.....@@............@.......@@@........@..........@@....@@@....@@@@@@@
......@@@@...@@@@...............@@................@.......@@@@...........@@@@@@
.......@@.......@..@.......@@..@@@......@.....@...@.......@@@@.........@..@@@@@
........@.................@@@@@@@@@@....@.....@........................@..@@@@@
............@....@........@@@@@@@@@@....@@............@...................@@.@@
..@........@@@.........@..@@@@@@@@@.....@..................................@...
@.........@@@@........@@@...@@@@@@@@..................@@..............@@@......
@........@@...........@.....@@@@@@@@...........................@@@@...@@@......
@@@..@@....@@........@@.......@@@@@@@...................@...@@@@@@@@@.@@@@.....
@@@@@@@@......@................@@@@.@.............@@........@@@@@@@@@@.........
@@@@@@@@...@.@@..........@...@@@@@................@....@@@@@@@@@@@@@@....@@....
@@@@@........@..@............@@@@@....................@@@@@@@@@@@@@@@@@@@@@@..@
@@@@@@@.........@@@@@........@@@..@........@..........@@@@@@@@@@@@@@@@@@@@@@..@
@@@@@@@...........@@@............................@@....@@@@@@@@@@.@@@@@@@@@...@
@@@@@@@...........@@@...........................@@@@@@.@@@@...@@@.@@@@@@@@@@@@@
@@@@@@@.....@.@...@....@........................@....@@@......@@@.@@@@@@@@@@@@@
@@@@@@........@..@....@@.@..........................@@@@.....@@@@.@@@@@@@@@@@@@
@@@@@@...@....@.......@.............@....@...........@@@.......@@.@@@@@@@@@@@@@
@@@@..................@...........@@@..@@@.@.......@.@@@....@..@@..@@@@@@@@@@@@
@@@@....@@........@..@@...........@@...@@@@@.........@@@....@......@@@@@.@@@@@@
@@@@...@@@@...@...............@@......@@@@@@@.............@...........@..@@@@@@
@@@@.@....@@................@.........@@@@@.................@........@@..@@@@@@
@@@@......@@@......@@................@@@@@@........@.................@@..@@@..@
@@@.....@@@@......@@@@.@@............@@@@@@@.......@.................@....@....
@@@.....@@@@.........@...........@......@@@@.......@@..@@....@@..@........@....
@@@@....@@@@.........@@@....@...@@@....@@@@..@.....@@@.@@.......@@........@@@@.
@@@@......@.@................@@.@@.....@@@.......@@@@@......@.........@..@.@@@.
@@@@...........@.........................@@.................@@.....@...........
@@@@.@.......@..........@@.................................@@@.................
@@@@..@.............@................@....................@@@@.................
@@@@@@........@............................@@..............@@@@..@.@........@..
@@@@@@..@..................................@..............@@@............@@.@@.
@@@@@@@@@...........@.........@...@...............@........@@.............@....
@@@@@@@@..........................@....@@@.....@...@..@@.......................
@@@@@@@...............................@@@@@@..........@@@......................
@@@@@@...........@..@@.....@@.........@@@@@@....@@@....@@...@.................@
@@@@@@.........@@....@......@..@@.....@@@@@@@@@@@@..........@@.........@.......
@@@@@..........@.....@..............@@@@@@@@.@@@@@.........@@@.@...............
@@@@@..........@...................@@@@@@@@@.@............@.@@@@........@......
@@@@@@..............@..............@@@@@@@@..@.................@@@.............
@@@@@@.............................@@@@@@@@.....................@@@............
@@@@@@@....................@.......@@@@@....@......@............@@@....@.......
@@@@@@@@@@@........@......@........@@@@@@....@..................@.@............
@@@@@@@@@@@......@......@@@.......@@@@@@@.@...................@................
@@@@@@@@@@.......@........@........@@@@@............@......@.........@.........
@@@@@@@@.@......@@...................@@.....@.....@.@@@..@@........@...........
@@@@@@@@.@.@................@@@@........@...@........@@@@@....@@...............
@@@@@@@@.............@..@...@@@@........@@.@@..................@...........@@@@
@@@@@@@@@@@...........................@.................................@@@@@@@
@@@@@@@@@@@@............@@@@@@..........@............@...............@...@@@@@@
@@@@@@@@@@@.............@@...............................................@@@@@@
@@@@@@@@@@@.........@.............................................@@@@@@@@@@@@@
@@..@@@@@..................@............@.........@..@.............@@@@@@@@@@@@
........@...................@......@.........@.....................@@@@@@@@@@@@
...@..........................@..........@@...............@...........@@@@@@@@@
..........@.....................@.....@@@.@..@@@.............@...@...@@@@@@@@@@
...............................@.......@@.......................@..@.....@@@@@@
.............@@..@............@@@....@@.........................@@..@....@@@@@@
.........@@.......@@...........@......@.........................@@..@....@@@@@@
@@.......@@.........@...............@..................@............@...@@@@@@@
@@@...@..@@...................@...........@@@@.............@@@..........@@@@@@@
...@.@@...@@........@@.....................@@@.......@.................@@@@@@@@
@..................@@...@...........@...................................@@@@@@@
......................@@@@@.........@...............@...................@@@@@@@
...............@......@.........@.............................@.......@@@@@@@@@
..@.......@........@@@@.@.......@@@..@@.............@..........@@@...@@@@@@@@@@
@@@.........@@....@@@@@@@@...........@@@.@.........@@....@...@@@@@@@@@@@@@@@@@@
@@@.......@@@@......@@@@@@...........@@@@@.........@@......@@@@@@@@@@@@@@@@@@@@
@@@......@@@@@@@@....@@@@@@@@......@..@@@@....@........@@@@@@@@@@@@@@@@@@@@@@@@
8
28 61 0
40 2 0
53 17 0
64 74 0
41 19 0
25 36 0
10 18 0
43 21 0

64 63 0
27 26 0
7 69 0
9 13 0
14 71 0
70 73 0
8 16 0
13 71 0
