width 79
height 79
........@@@@@.@@@@@@@@@@@@@@@@@@@@@@@@@@@@@@@@@@@@@@@@@@@@@@@@@@@@@@@@@@@@@@@@@
........@@@@..@@@@@@@@@@@@@@@@@@@@@@@@@@@@@@@@@@@@@@@@@@@@@@@@@@@@@@@@@@@@@@@@@
..@@.....@@@...@@@@@@@@@@@@@@@@@@@@@@@@@@@@@@@@@@@@@@@@@@@@@@@@@@@@@@@@@@@@@@@@
@...........@..@@.@@@@@@@@@@@@@@@@@.@@@@@@@@@@@@@@@@@@@@@@@@@@@@@@@@@@@@@@@@@@@
...@@..............@@@@@@@@@@@@@@@@.@@@@@@@@@@@@@@@@@@@@@@@@@@@@@@@@@@@@@@@@@@@
...................@@@@@@@@@@@@@@@@.@@@@@@@@@@@@@@@@@@@@@@@@@@@@@@@@@@@@@@@@@@@
......@.@.......@@@@@@@@@@@@@@@@@@@.....@@@@@@@@@@@@@@@@@@@@@@@@@@@@@@@@@@@@@@@
..........@.....@@@@@@@@@@@@@@@@@@@@....@@@@@@@@@...@.@@@@@@@@@@@@@@@@@@@@@@@@@
@...........@@..@@@@@@@@@@@@@@@@..@@....@@@@@@@@@.....@@@@@@@@@@@@@@@@@@@@@@@@@
.......@........@@@@@@@@@@@@@@@@......@..@@@@@@@@.....@@@@@@@@@@@@@@@@@@@@@@@@@
....@........@..@@@@@@@@@@@@@@@.......@..@@@@@@@.....@@@@@@@@@@@@@@@@@@@@@@@@@@
@.........@.@...@@@@@@@@@@@@@@@@@..........@@@.........@@@@@@@@@@@@@@@@@@@@@@@@
@...........@....@@@@@@@@@@@@@@@@@.........@@@.......@@@@@@@@@@@@@@@@@@@@@@@@@@
@@......@@.......@@@@@@@@@@@@@@@@@@@...@@.......@....@@@@@@@@@@@@@@@@@@@@@@@@@@
@@.......@........@@@@@@@@@@@@@@@@@...@@@..@..........@@@@@@@@@@@@@@@@@@@@@@@@@
@@.@...............@@@@@@@@@@@@@@@@....................@@@@@@@@@@@@@@@@@@@@@@@@
@@................@@@@@@@@@@@@@@@@@.........@@..@@.....@@@@@@@@@@@@@@@@@@@@@@@@
@@@@..........@...@@@@@@@@@@@@@@@@@.............@@@....@@@@@@@@@@@@@@@@@@@@@@@@
@@@@..@....@@@@...@@@@@@@@@@@@@@@@@......@@.............@@@@@@@@@@@@@@@@@@@@@@@
@@@........@@@.....@@@@@@@@@@@@........@@.@..........@..@@@@@@@@@@@@@@@@@@@@@@@
@@@.............@@@@@@@@@@@@@@..........@.@..........@@.@@@@@@@@@@@@@@@@@@@@@..
.....@.........@@@@@@@@@@@@@@....................@...@..@@@@@@@@@@@@@@@@@@@@@..
............@..@@@@@@@@@@@@@@...@.@.........@............@@@@@@@@@@@@@@..@@@@..
...........@@..@@@@@@@@@@@@@@@@@@.............@@@@@..@...@@@@@@@@@@@@@@@..@...@
...........@@@@@@@@@@@@...@@@@@@@..@...........@.....@...@@@@@@@@...@.........@
..@......@.@@@@@@@@@@@@....@@........................@...@@@@@@....@@.........@
...........@@@@@@@.@@@@@.......@...............@..@.......@@@@@@.......@.......
.............@@@@@..@@@.....@.@@........@..............................@.......
@@@....@.....@.@@@..@@@.....@................@..@@.@@..................@@......
@@@..@@@........@@.@@@@....................................@..........@........
@.........@.....@@.@@@@........@.....................@.....@...............@...
............................@.....................@............................
..........@........@.........................@@...@............................
@.........@..@@@@.....................@......@@@@..............................
....@.......@@@@@..................@..@......@@@@@....@@.......................
@...@.......@@@@@@...........................@@........................@@@.....
@..@@........@@@@............@.........@@@...@@...@@................@..@@......
@..@@@@@@..@..................@@.......@@@@.......@@.............@.@....@......
...@@@.@@.....@...@.....................@@..............................@......
...@@..@@............@@@.......................................................
.......@@@.........@.@@@@.....@@......@@@@...............@.....................
@......@@@@..........@@@@....@@.....@..@@@...................@........@@@@@@@..
.......@@@@...........@@@@..@@@........................................@@@@@@..
@@@....@@@@...............@@@....@........@............................@@@@@...
@@@@@@@@@@@..............@@@@....@......@...@@@.......@@..@......@.....@.@.....
@@@@@@@@@@@........@.......................@@@@..................@.........@@@@
@@@@@@@@.@@......@@@..@....................@@@@....@.............@@@.......@@@@
@@@@@....@.......@@@.......................@@@........@.....................@@@
@@@@.................................@@.........@@..@@.....@@.@..............@@
@@@@.@............@@..@@........@...@@@@.......@@@........@@@@@.@..........@@@@
@@@@@@..@.........@@@@@@.........@...@@@.@....@......@@.......@.@.......@..@@@@
@@@@@@.......@....@@@@@@@@@..........@@..@...........@@.................@@@@@@@
@@...............@@@@@@@@@.......@...................@.........@.........@.@...
@@..........@....@@@@@@@@@.......@.........@.........@.........@..@.@..........
.@............@@@@@@@@@@@@@@@.....................................@............
..............@@@@@.@@@@@@@@@@@....@...@.......@@.@@.............@@..@.........
....................@@@@@@@@@@@@@@@@...@........@@@@.........................@.
..............@.....@@@@@@@@@@@@@@@@@.............@@@@.......................@@
@@..................@@@@@@@@@@@@@@.....@....@......@@.......................@@@
@@...............@..@.@@@@.@@@@@................@.....@@...................@@@@
@@..............@@@@..@@@@...@@@...............@@...............@........@.@@@@
@@..............@......@@@..............@...@......@.......@..@@.........@.....
@@@@...................@........@...........@@..........@.@@..@@...............
@@@@......@...................@@.....................@.........................
@@@@...@..........@....@@............@...................@...@..........@...@@@
@@@@.....@....@.........@...................................................@@@
@@@..................@..................@@.........................@@@.....@@@@
@@@@@.....@....@.....@......@...........@@..........@.@..............@.....@@@@
@@@@@@..@@@@..@.....@@@@..................................@.............@@@@@@@
@@@@@@@@@@@@@@@.....@@@@@@@...............................@@@..........@@@@@@@@
@@@@@@@@@@@@@@@.....@@@@@@.....@.........@..@..@@@....@..@@@@..........@@@@@@@@
@@@@@@@@@@@@@@@..@...@@@@@.....................@@......@@@@@@....@@@@@@@@@@@@@@
@@@@@@@@@@@@@@@@@@......@@@@@@............@@@...........@@@@@.......@@@@@@@@@@@
@@@@@@@@@@@@@@@@@@......@@@@@@@..........@@@@.............@@.......@@@@@@@@@@@@
@@@@@@@@@@@@@@@@...@....@@@@@@@@..........@@@@............@@@@..@@@@@@@@@@@@@@@
@@@@@@@@@@@@@@@@.....@.@@@@@@@@@......@@.@@@@@@...........@@@@@@@@@@@@@@@@@@@@@
@@@@@@@@@@@@@@@@@.......@@@@@@@@@.....@@@@@@@@@@@@.....@@@@@@@@@@@@@@@@@@@@@@@@
@@@@@@@@@@@@@@@@@......@@@@@@@@@@@.....@@@@@@@@@@@.@..@@@@@@@@@@@@@@@@@@@@@@@@@
@@@@@@@@@@@@@@@@@@@@....@@@@@@@@@@@....@@@@@@@@@@@@@..@@@@@@@@@@@@@@@@@@@@@@@@@
8
11 6 0
75 33 0
59 66 0
19 31 0
42 52 0
55 37 0
45 38 0
50 43 0

14 14 0
5 20 0
53 64 0
59 64 0
49 14 0
37 76 0
16 47 0
0 4 0
