width 79
height 79
@..@@@............................@....@@@@@....@@@@@@@@@@@.@@......@@.....@@@@
...@@...........@..........@........@...@@@.....@@@@@@@@@@....@....@@@@...@@@@@
......@.........@........................@......@@@@@@@@@.@.......@@@@.....@.@@
......@@........@..@.......@@........@.@........@@@@@@@@@........@@@@@.......@@
@.........@@....@...................@@@.........@@@@@@@@@.......@@@@@@....@..@@
...@................................@...........@@@@@@@@@@.......@...@@.......@
@@@@..........@@..........@.....@................@@@@@@@@@.....@@@...........@@
@@@@...@......@...........................@@.....@@@@@@@@@.....@@@@..........@@
@...................................@............@.@@@@@@.@...@@@@@....@.....@@
@..................................................@@..@......@@@@@.@..@..@@@@@
@@.......@.............@@..........@.....@....................@@@......@...@@@@
@@..........@...............@............@..............@.....@@@.....@@@.@@@..
@@....@.@....@..............@.@@........@@.............@@.@...@@.....@@@..@....
@@@...................@...@@@@@@@..........@......@@@.........@@.....@.........
@@@@@@............@...@...@@@...@.................@...........@................
@@@@@@..@...............@@@@@..................................................
@@@@@@@...............@@@@@@@.........@...@@@@...................@..........@@@
@@@@@@@..............@@@@@@..............@@@@@@@....@@...@.......@@@@..........
@@@@@@..............@@@@@@@..............@@@@@@@.............@....@@@..........
@@@@@@@.............@@@@@...@@.......@...@@@@@@..............@....@@@..........
@@@@@@@.......@....@@..@...@@@@....@.@..@@@@@@..........@@@@......@............
....................@......@@@@....@.@@...@@..............@@......@............
....................@.........@......@@@@..@.................@.................
............@.................@......@@@@@@@@@@@........@......................
................@........................@@@@@@@.................@.......@@....
@@@......................................@@@@@@@..@..............@............@
@@@.......@@.......@...@..............@..@@@@@@@..@@..@.@..@......@...........@
@.@........@@@........@@...................@@@@@..@@...............@....@.....@
............................................@@@@.........@.......@......@....@@
.........@...................................@@@.............@@..............@@
.........@...........................@.......@@@..@.......@................@...
................@@.@........................@@@@.@..............@@.............
.....@..@.......@@......................@................................@....@
..@..@..@.......@..............................@@.........@@............@.....@
.....@...................@...........@@@...@.............@@@.@.@........@@....@
.........................@...........@@@..@@.................@..............@.@
..........@@............@@@@.........@@@..@@.....@.@@........@................@
@.....................@...........@@.@@@.........@@........@.@.....@@@........@
.......@............@@@...........@@.@@@@@........@............@@@@@@@.........
.......@@.@@@.......@@@........@.....@@@...@......@@@@.........@@@@@@..........
....@...........@@.............@....@@@.......@@....@@.....@...@@@@@...........
....@..@.....................@...........@@@...............@@..@@@@@........@@.
......................................@@@@@@@@@..........@.@@...@@@@........@@@
.....@...........@.....@..............@@@@@@@@@......@@....@@...............@@@
.....@.........@@@@...@@@@.....@....@@@@@@@@@@@@.....@@@..........@..........@@
.....@.........@@@@@....@@@..@@@@...@@@@@@@@@@......@@@..................@.....
................@@@@..@.@@@@@@@@@...@@@@@@@@@@@.......@....@...@.......@.@@@@..
@..@@@..........@@@@..@@@@@@@@@@....@.@..@@@@@......@....@.................@@..
@@.@@...........@@@...@@@@@@@@@..@.......@@@@@...............@.............@@@.
@@@@@.........@@@@@@@@@@@@@@@@@@...........@@@@@.....@@.........@@.........@@@.
..@@..........@@@@@@@@@@@@@@@@...@.......@@@@..@................@....@.....@@..
...@.........@@@@@@@@@@@@@@@...@.........@@@@..@@.....................@........
...@.........@@@@@@@@@@@@@@........................................@.@@@@@@....
...@@@.......@@@@@@@@@@@@@@......@..............................@.....@@@@.....
..@@@@...@...@@@@@@@@@@@@@@......@.@@..............@.@@@@.@...........@@@@...@.
.........@.@..@@@@@@@@@@@@@.@....@......@@....@@@@@@@@@@@@@...........@@@@....@
.........@@@..@@@@@@@@@@@@..........@@..@.....@@.@@@@@@@@@@.......@@@@@@@@....@
...........@@@@@@@@@@@@@@@....................@@.@@@@@@@@@@@@@@@@...@@@@.@.....
@........@.@@@@@@@@@@@@@...........@...............@@@@@@@@@@@@@@..@@@@........
.........@@@@@@@@@@@@@........@@.....................@@@@@@@@@@@@.@@@@@........
........@@@@@@@@@@@@@@...............@................@@@@@@@@@@@@@@...........
........@@@@@@@@@@@@@@...@..@.......@.................@@@@@@@@@@@@.............
.....@@.@@@@@@@@@@@@@@..........@.....................@..@@@@@@@@.............@
......@@@@@@@@......@@.......@........@................@....@@@@@..@.....@@@...
......@@@.....................................................@...@.......@@...
@@.....@...@@.....................@...@@@.@.......@@.................@....@@...
......................@@..............@@@.@@....................@.@.....@.@@@..
...@...........@....@.@@.......@@..........@.................@..............@@@
.........@.....@@@..@.@@..@.....@.....................................@.....@@@
...........@@@@@@@@.@.............@..@....@..@.....................@.........@@
..........@@@@@@.@@.@@.......@@@..@..@@..........@..........................@@@
..........@@@.......@......@.@@@@@@@@@@.@.......@@.....@...@..@.....@......@@@@
...@@...@...@.............@@@@@@@@@@@@@.........@@@...........@.........@..@@@@
@@@@@@.@@........@..........@@@@@@@@@@@........@@@@@.......................@@@@
@@@@@@@@@.....@...@..................@@.......@@@@@@@@@@..@.......@..@.....@@@@
@@@@@@@@@..........@.......@@................@@@@.@.@@@@....@@........@.@.@@@@@
@@@@@@@@@@@......@@@......@@@@..............@@@@@....@@.....@@.@...........@@@@
@@@@@@@@@@@@.....@@@@@@@@..@@@@@@@@@........@@@@@....@...@..@@@...........@@@@@
@@@@@@@@@@@@@@@@.@@@@@@@..@@@@@@@@@@........@@@@@.......@@@@@@@..........@@@@@@
8
59 1 0
54 47 0
46 52 0
72 40 0
2 46 0
68 53 0
40 78 0
26 66 0

65 47 0
77 15 0
66 58 0
1 0 0
14 8 0
24 0 0
73 38 0
29 68 0
