width 79
height 79
@@@@@@@@@@@@@@@@@@@@@...@........@@@........@@@@@@@@@@@@@@@@@@@@@@@.......@@@@@
@@@@@@@@@@@@@@@@@@@@@......@@...@.@...........@@@@@@@@@@@@@@@@@@@@@.......@@...
@@@@@@@@@@@@@@@@@@@@@.......@...@............@@@@@@@@@@@@@@@@@@@@@@............
@@@@@@@@@@@@@@@@@@@@@.......@................@@@@@@@@@@@@@@....................
@@@@@@@@@@@@@@@@@@@@@.....................@@@@@@@@.@@@@@@@@....................
@@@@@@@@@@@@@@@@@@@@@.................@@..@@........@@@@@@@@@...@..........@@..
@@@@@@@@@@@@@@@@@@@@.......@@.........@@....@...@...@@@@@....@.@@..............
@@@@@@@@@@@@@@@@@@@@@......@@@@......................@@@@.................@@...
@@@@@@@@@@@@@@@@@@@@@@.....@@@@@@@.....@...@...........@@.................@@..@
@@@@@@@@@@@@@@@@@@@@@@.@@@@@@@@@@@.....@..@@@..........@@@..@..................
@@@@@@@@@@@@@@@@@@@@@@@@@@@@@@@@.......@@@@@@..@.......@.....@...@.............
@@@@@@@@@@@@@@@@@@@@@@@@@@@@@@@@.........@.@@..@...............................
@@@@@@@@@@@@@@@@@@@@@@@@@@@@@@@@.......................@.......................
@@@@@@@@@@@@@@@@@@@@@@@@@@@@@@@@.......................@......@................
@@@@@@@@@@@@@@@@@@@@@@@@@@@@@@@@@@..................@@@@...............@......@
@@@@@@@@@@@@@@@@@@@@@@@@@@@@@@@@@@@...............@@@....@..................@@@
@@@@@@@@@@@@@@@@@@@@@@@@@@@@@@@@@@...........@....@.......................@@@@@
@@@@@@@@@@@@@@@@@@@@@@@@@@@@@@@@@@...........@....@....@@.................@@@@@
@@@@@@@@@@@@@@@@@@@@@@@@@@@@@@@@@@....................@.........@@.......@@@@@@
@@@@@@@@@@@@@@@@@@@@@@@@@@@@@@@@@@@@@..........................@@@...@....@@@@@
@@@@@@@@@@@@@@@@@@@@@@@@@@@@@@@@@@@.............@...................@@@@@@@@@@@
@@@@@@@@@@@@@@@@@@@@@@@@@@@@@@@@@@@...@............................@@@@@@@@@@@@
@@@@@@@@@@@@@@@@@@@@@@@@@@@@@@@@@@@...............@................@@@@@@@@@@@@
@@@@@@@@@@@@@@@@@@@@@@@@@@@@@@@@@@....@...........@......@@........@@@@@@@@@@@@
@@@@@@@@@@@@@@@@@@@@@@@@@@@@@@@@@@..........@............@@.......@@@@@@@@@@@@@
@@@@@@@@@@@@@@@@@@@@@@@.@@@@@@@..@@.....................@@@.......@@.@@@@@@@@@@
@@@@@@@@@@@@@@@@@@@@@@...@@@@@@@.@................@..@@.@@@......@@..@@@@@@@@@@
@@@@@@@@@@@@@@@@@@@@@@@@.@@@@@@@......@@.....@....................@.@@@@@@@@@@@
@@@@@@@@@@@@@@@@.@@@.@.@.@@.@@@@......................@.............@@@@@@@@@@@
@@@@@@@@@@@@@@@@..........@..@...........@.........@@........@......@@@@@@@@@@@
@@@@@@@@@@@@@@@@..........@@.......................@@.....@.........@@@@@@@@@@@
@@@@@@@@@@@@@@@.....@...@@.....@.............@........@...........@.@@@@@@@@@@@
@@@@@@@@@@@@@.......@....................@@.......................@@@@@@@@@@@@@
@@@@@@@@@@@@@.......................@....@@......@@...............@@@@@@@@@@@@@
@@@@@@@@@@@@@............@@..........@...@@......@@@....@.......@@@@@@@@@@@@@@@
@@@@@@@@@@@@@...@@........@..............@@.................@@@@@@@@@@@@@@@@@@@
@@@@@@@@@@@......@..........@@@@@.......................@@@@@@@@@@@@@@@@@@@@@@@
@@@@@@@@@@@@..........@.....@@@@@..........@........@..@@@@@@@@@@@@@@@@@@@@@@@@
@@@@@@@@@.@.......@@......@@@@@@@.@@@@........@.......@@@@@@@@@@@@@@@@@@@@@@@@@
@@@@@@@..........@@...........@@@@@..@......@.@@@.....@@@@@@@@@@@@@@@@@@@@@@@@@
@@@@@@@......@@..........@......@.............@@......@@.....@@@@@@@@@@@@@@@@@@
@@@@@@@......@@@........@.....@...................@.@@.@......@@@@@@@@@@@@@@@@@
@@@@@@@@@@...@@@........................@.....@......@.........@@@@@@@@@@@@@@@@
@@@@@@@@@@@@@@@......................@......................@...@@@@@@@@@@.@.@@
@@@@@@@@@@@@@@...................@@....@...........@........@.....@@@@@@.....@@
@@@@@@@@@@@@@@.........@@@.......@..@@.........@@...@@@@@.........@@@@@........
@@@@@@@@@@@@@@@@.....@@@@@.....@@@@@@@@.............@@@@@@.........@@@.........
@@@@@@@@@@@@@@@@@..............@@@@@@@@..............@@@@..@.........@.........
@@@@@@@@@@@@@@@@@@............@@@@@@@@.@.......@.....@@@@............@.........
@@@@@@@@@@@@@@@@@@......@.....@@@.@@@@..............@@@@@............@.........
@@@@@@@@@@@@@@@@@@@...@@@@@@...@@..@@...@...@@...........................@@....
@@@@@@@@@@@@@@@@@@@@@.....@...@@@...........@@...........................@@....
@@@@@@@@@@@@@@@@@@@@@@@@.....@.@@.............................................@
@@@@@@@@@@@@@@@@@@@@@@@@@..........@...............@.........@.................
@@@@@@@@@@@@@@@@@@@@@@@@@..............@.......@.....@....@.@@@@@..@@.....@...@
@@@@@@@@@@@@@@@@@@@@@@@@@.......@............@@@..........@....@@.@@....@.@..@@
@@@@@@@@@@@@@@@@@@@@@@@@@..@..................@@.............@...@@@.....@@..@@
@@@@@@@@@@@@@@@@@@@@@@@@@@...@@...............@@..............@.@@@@.....@....@
@@@@@@@@@@@@@@@@@@@@@@@@@..............@.@...@@......@...@.....@@@.@....@@....@
@@@@@@@@@@@@@@@@@@@@@@@@@@....@....@@@.......@@....................@..@....@...
@@@@@@@@@@@@@@@@@@@@@@@@@@.........@@.....@...@.......@............@@@@........
@@@@@@@@@@@@@@@@@@@@@@@@@@..........@.@.......@......@@.................@......
@@@@@@@@@@@@@@@@@@@@@@@@@@........@.@.....@@.....@..........................@..
@@@@@@@@@@@@@@@@@@@@@@@@@@@......@@.@............@..@@....@@..@................
@@@@@@@@@@@@@@@@@@@@@@@@@@...........@...........@@.@@.........................
@@@@@@@@@@@@@@@@@@@@@@@@@@...............@.........@@@........@..........@.....
@@@@@@@@@@@@@@@@@@@@@@@@@@@@@.....@@..@@.@........@@@.........................@
@@@@@@@@@@@@@@@@@@@@@@@@@@@..............@@@@.......@...............@.@@@@.....
@@@@@@@@@@@@@@@@@@@@@@@@@@.....@@.........@@......@@........@.....@.....@......
@@@@@@@@@@@@@@@@@@@@@@@@@@....@@@......................................@@@@@@..
@@@@@@@@@@@@@@@@@@@@@@@@@............................@..@..@...........@@@@@@..
@@@@@@@@@@@@@@@@@@@@@@@@@@@.........@@...@@.....@..@.@.......@....@....@@@@@@..
@@@@@@@@@@@@@@@@@@@@@@@@@@@@@@@@.....@.........@@@@@.@@@...............@@@@@@..
@@@@@@@@@@@@@@@@@@@@@@@@@@@@@@@@@.....@@@@.....@@@@@..@.@...........@@@@@@@@@@@
@@@@@@@@@@@@@@@@@@@@@@@@@@@@@@@@...@..@@@@@@...@@@@@@...............@@@@@@@@@@@
@@@@@@@@@@@@@@@@@@@@@@@@@@@@@@@@@.....@@...@....@@.......@..........@@@@@@@@@@@
@@@@@@@@@@@@@@@@@@@@@@@@@@@@@@@@@@@@...@...@@...................@..@@@@@@@@@@@@
@@@@@@@@@@@@@@@@@@@@@@@@@@@@@@@.@......@................@@..........@@@@@@@@@@@
@@@@@@@@@@@@@@@@@@@@@@@@@@@@@@........................@@@.....@.....@@@@@@@@@@@
8
32 70 0
75 44 0
60 78 0
67 26 0
38 50 0
59 72 0
70 11 0
23 6 0

42 45 0
27 57 0
63 57 0
63 18 0
36 51 0
69 11 0
26 60 0
41 6 0
