width 79
height 79
@@@@@@@@@@@@@@@@@@....@@@.......@@@@@@@@@@@@@@@.......@......@@@@@@@@@@..@@@@@@
@@@@@@@@@@@@@@@@@@@@......@...@@@@@@@@@@@@@@@@@.................@@@@......@@@@@
@@@@@@@@@@@@@@@@@@@@.@@...@@.....@.@@@@@@@@@@@@.............@...@@.@........@@@
@@@@@@@@@@@@@@@@@@@@@@@...@@.......@@@.....@@@@@................@@..........@@@
@@@@@@@@@@@@@@@@@@@@@@@@.........@@@....@..@@@@@@@.....................@...@@@@
@@@@@@@@@@@@@@@@@@@@@@@@@.......@@@@........@..@@@..............@......@.......
@@@@@@@@@@@@@@@@@@@@@@@@@@.@..@@@@@@...........@@.................@.........@..
@@@@@@@@@@@@@@@@@@@@@@@@@.....@@@@@.........................................@.@
@@@@@@@@@@@@@@@@@@@@@@@@........@@@.......@.......@..........@..............@..
@@@@@@@@@@@@@@@@@@@@@@@........@@@@.@........................@............@....
@@@@@@@@@@@@@@@@@@@@@@@..@.......@.............@.............@............@@@@@
@@@@@@@@@@@@@@@@@@@@@@..@@..@@@.........@..............................@..@@@@@
@@@@@@@@@@@@@@@@@@@@@@..@@....@@......@.@.......................@......@.@@@@@@
@@@@@@@@@@@@@@@@@@@@@@@..@.....@.....@@..................@..@...@...@.....@@@@@
@@@@@@@@@@@@@@@@@@@@@@...@@.......@.......................................@@@@@
@@@@@@@@@@@@@@@@@@@@@@...@@..............@..@....................@........@@@@@
@@@@@@@@@@@@@@@@@@@@.@......@@@@@@...@.....@@@@..@@@.......@............@.@@@@@
@@@@@@@@@@@@@@@@@@@@.......................@@@@.@@........@@............@@@@@@@
@@@@@@@@@@@@@@@@@@..............................@@@..@.....@@........@@@@@@@@@@
@@@@@@@@@@@@@@@@@@@@..................@.@@@.......@..@@..............@@@@@@@@@@
@@@@@@@@@@@@@@@@@@@@@.....................@......@@...................@@@@@@@@@
@@@@@@@@@@@@@@@@@@@@@@@...............................................@@@@@@@@@
@@@@@@@@@@@@@@@@@@@@@@..............................................@@@@@@@@@@@
@@@@@@@@@@@@@@@@@@@@@.................................................@@@@@@@@@
@@@@@@@@@@@@@@@@@@@@...........@@@...............@..@..................@@@@@@@@
@@@@@@@@@@@@@@@@@@@@.........@..@@........@@..........................@@@@@@@@@
@@@@@@@@@@@@@@@@@@.@......................@@............@.......@.@..@@@@@@@@@@
@@@@@@@@@@@@@@@@@.........................@@......@@@...........@@@@@@@@@@@@@@@
@@@@@@@@@@@@@@@@................@........@@@......@@@@.........@@@@@@@@@@@@@@@@
@@@@@@@@@@@@@@@@....@@@........@@.......@@@@@@....@@@@.........@@@@@@@@@@@@@@@@
@@@@@@@@@@@@@@@@....@........@@@@@@@..@@@@@@..@@@@@@@@.........@@@@@@@@@@@@@@@@
@@@@@@@@@@@@@@@@.............@@@@@@@@.@@@@@@.@@@@@@@@@.@.....@@@@@@@@@@@@@@@@@@
@@@@@@@@@@@@@@@@.@...@......@@@@@@@...@@@@@.....@@@@@@.@...@@@@@@@@@@@@@@@@@@@@
@@@@@@@@@@@@@@@@.@@@......@@@@@@@@@...@@.@@............@@..@@@@@@@@@@@@@@@@@@@@
@@@@@@@@@@@@@@@@@@@@@.....@@@@@@@@@@.......@@..............@@@@@@@@@@@@@@@@@@@@
@@@@@@@@@@@@@@@@@@@@@@....@@.@@@@@@@.............@.........@@@@@@@@@@@@@@@@@@@@
@@@@@@@@@@@@@@@@@@@@@@....@................................@@@@@@@@@@@@@@@@@@@@
@@@@@@@@@@@@@@@@@@@@@@............................@@@....@@@@@@@@@@@@@@@@@@@@@@
@@@@@@@@@@@@@@@@@@@@@@............................@@@....@@@.@@@@@@@@@@@@@@@@@@
@@@@@@@@@@@@@@@@@@@@@@.@.........@...........@...@@.@@.......@@@@@@@@@@@@@@@@@@
@@@@@@@@@@@@@@@@@@@@@@@............@.........@@.@@@.@@.....@@@@@@@@@@@@@@@@@@@@
@@@@@@@@@@@@@@@@@@@@@..............@.......................@@@@@@@@@@@@@@@@@@@@
@@@@@@@@@@@@@@@@@.............@...@@.@.......................@@@@@@@@@@@@@@@@@@
@@@@@@@@@@@@@@@@.............@@....@.@......................@@@@@@@@@@@@@@@@@@@
@@@@@@@@@@@@@@@@...@....@.....@.@...@@......@...................@@@@@@@@@@@@@@@
@@@@@@@@@@@@@@@....@@...@@....@..@.@@@.....@@...............@@..@@@@@@@@@@@@@@@
@@@@@@.@@@@@@@.....@@@@..@....@..@@@@@......@.@@................@@@@@@@@@@@@@@@
@@@@....@@@........@@@@.......@@.@@@@@........@........@........@@@@@@@@@@@@@@@
@@@@.@...@......@...@@@........@@@@@@@........@....@@@@.........@@@@@@@@@@@@@@@
@@@@...................@@.@....@..@@@@@@............@@@.@.@..@..@@@@@@@@@@@@@@@
@@@@@..................@@..........@@@@@............@@@.@@@@....@@@@@@.@@.@@@@@
@@@@@..@..........@....@...@...@...@@@@.................@@@...@@@@@....@@.@@@@@
@@@@@@@.........@..................@@..@.@...............@@..@@@@@@@......@@@@@
@@@@..@.@@@@...@@.....@@................@@...............@....@@@@@.......@@..@
@@......@@@@....@...@@@@...........................@...........@@@.......@@...@
@@@@............@....@@@.....@...........@.....@@..@@....................@....@
@@@@...................................@..@............@.....@...............@.
@@@@.............@......@........................@...........@@...........@....
@@@...@@@........@.....@@...@....................@..........@@@.....@@........@
@@@@@.@@...............@@......@@....@....................@@@@........@..@.....
@@@@@@@@@@@...@@@.......@...@@..@........@@................@...................
@@@@@.@@........@@......@.........@@......@@..................................@
@@@@............@@...............@...@.....@...................................
@@@@...................@...........@@@@.............@...................@......
@@@@@@........@...........@@.......@@@@...........@.@@..........@...........@..
@@@@@@...@...........@@............@@@@.........@.......@.........@@...........
@@@@@@...............@...............@@@....@@..........@.........@@...........
@@@@@@@@@.........................@@.@@@.@........@@@............@@@@..........
@@@@@@@@@@.....@@@.....@....@......@.@@..@@.@.....@@@............@@..@@......@@
@@@@@@@@@@@@.....@.........................................@.....@@...@@......@
@@@@@@@@@.........@...@@..@@........@.........@...........@@@@........@.......@
@@@@@@@@@@......@......@.@@@@.........@.................................@.....@
@@@@@@@@@@@....@@@.....@..@@......@...@@...............................@@......
@@@@@@@@@@@@@@@@@@........@....@@@@................................@@@@@@@@...@
@@@@@@@@@@@@@@@@@@.............@..................@..................@@@@@@@@@@
@@@@@@@@@@@@@@@@@@...@......@.....@....................................@@@@@@@@
@@@@@@@@@@@@@@@@@@.....................................................@@@@@@@@
@@@@@@@@@@@@@@@@@@.......................@@.........@.................@@@@@@@@@
@@@@@@@@@@@@@@@@@@.@........@..........................@........@@@@@@@@@@@@@@@
8
67 69 0
33 67 0
13 70 0
69 69 0
58 4 0
37 17 0
67 13 0
59 72 0

22 19 0
70 14 0
27 10 0
38 28 0
35 19 0
50 53 0
9 61 0
41 46 0
