width 20
height 44
...................@
....@.........@...@@
.....@.............@
........@..@@....@..
....@..@...@........
...@......@........@
.................@.@
....@.@.......@....@
............@......@
....@...............
....................
......@........@....
.......@....@.......
..@.................
@.....@.....@..@....
..........@.........
...................@
........@...........
..@.................
......@.........@...
........@...........
......@.............
..@............@....
.......@..@......@..
.@...@..............
....................
..@..@.....@..@..@..
........@....@....@.
...@...............@
.......@........@..@
.........@..........
.................@..
....@..........@....
..@....@...@........
...............@....
......@...........@.
@.......@...........
.......@............
.....@....@.........
...................@
........@...@@.@...@
....@..............@
........@.........@@
...@...............@
6
2 9 0
2 28 0
4 8 0
1 23 1
9 37 1
7 28 1

11 40 0
6 10 0
1 22 0
15 8 1
16 10 1
1 14 1
