width 20
height 44
....................
..................@.
@@..................
@@......@.@..@.....@
@@@.@..@...........@
......@.............
..........@.........
....................
.@..................
............@..@....
......@....@........
.@.....@............
...@.............@..
..........@.........
.....@..@....@...@..
.@..@........@.@..@.
..@.................
..........@...@.....
......@@@....@......
......@.@...@.....@.
...................@
...@...............@
..@..@......@..@...@
.@..................
........@........@..
...@..@........@..@.
.........@..........
....................
........@...@.......
....@...............
................@...
...........@.@..@...
....@...@....@.@....
.@..................
.....@......@.......
................@...
..........@.........
.........@.@......@@
.............@......
.................@..
.......@.@.@........
@@..................
@@.@...@.....@..@...
@@@@................
6
7 13 0
3 31 0
10 4 0
5 35 1
8 29 1
2 35 1

9 13 0
17 11 0
16 2 0
3 35 1
6 14 1
10 0 1
