width 20
height 44
...@@.........@@@@@@
...............@@@@@
........@.@....@@@@@
...@........@...@@@@
.....@..@...........
.......@...@........
....................
.........@.....@....
....@..@..........@.
....................
@...@...........@...
@.......@...........
...........@...@....
....................
@...@...........@...
@@.......@..........
.@........@@......@@
.@.@...@...@........
...........@....@...
..@......@......@...
....................
.@.@......@...@..@..
.....@..@.......@...
.............@......
.@.@.......@.....@..
.......@.@..........
...@................
...@.....@...@.@....
..@.........@.......
....@............@..
....................
..@.........@....@@.
................@...
..@.@......@.@......
..............@.....
.@..................
...........@...@....
.........@......@.@.
....@.....@..@......
......@.............
@@@@............@...
@@@@....@..@........
@@@@................
@@@@................
6
10 36 0
9 38 0
10 19 0
0 32 1
6 43 1
6 6 1

15 8 0
16 29 0
15 14 0
16 24 1
12 20 1
1 34 1
