width 20
height 44
@....@..............
....................
...@......@.........
..............@.....
..@...@.............
.....@.........@..@.
.......@.....@......
.........@..........
...........@........
.................@..
.....@@@............
.@.@................
..................@.
...........@@...@...
......@.............
..@.@...............
...........@....@...
.....@.......@......
....@...............
.@......@.@...@....@
....................
.....@.........@....
.......@............
........@...........
....................
...@...........@....
.....@....@...@.....
........@......@.@..
..@.............@...
.....@..............
.@....@........@.@..
...@..........@.....
..@.................
........@...@.@.....
..........@.........
..@@................
........@...........
...@.......@.@...@..
....@....@.....@....
....................
.............@.@@...
........@...@...@...
....................
....................
6
1 8 0
10 21 0
11 28 0
15 39 1
10 13 1
8 1 1

19 31 0
10 20 0
2 2 0
13 0 1
9 31 1
3 10 1
