width 76
height 76
@@@@@@@@@@@@.......@.@@@.@...@@@@@...........@@@@@@@.@@@@@@@@@@@@@..@@@@@@.@
@@@@@@@@@@@@..........@@.....@@@@@@..........@.@@@@@....@@@@@@@@....@@@.....
@@@@@@@@@@@...@..@...@@@...@@@@..@...........@....@@.......@@..@.....@@.....
@@@@@@@@@@.......@@..@@....@@@@..............@....@..@..@...@........@@...@@
@@@@@@@@@@................@@@@..@......................@@............@.....@
@@@@@@@@@............@...@@@@@......................@.@@@@@..@.......@......
@@@@@@@@@............@@.................@...........@@@@@@@..@..............
@@@@@@@@@...........@@.............@@@...........@@...@@@@...@.............@
@@@@..@@.........................@@.............@@@..@@@@@................@@
@@@...@@.........................@@.............@@@...@@@............@..@@@@
@@@@.........@...................@.....................@@...............@@@@
@@@@.........@.............@..@..................@.....@....@...........@@@@
@@..............@....@........@@@................@@@...@....@@......@@@@@@@@
........@..................@..@@@@@.......@....@...............@....@@@@@@@@
...........................@..@@@@@............@@.@.@...............@@@@@@@@
....@.................@..@@...@@@@@............@@@.......@..........@@@@@@@@
....@...................@@@....@@@.............@@.......@@..........@@@@@@@@
...@....................@@@.....@..............@@.......@@............@@@@@@
...@@...................@@@..............@@@..@@@@@@........@.........@@.@@@
........................................@@@@@@@@@@@@@@..........@.@......@@@
.........@@.......@@@................@...@@@@@@@@@@.......................@@
.........@@.......@@..........@.........@@@@@@@@@@@....@....@...............
.........@@@...@@........@......@@....@@@@@@@@@@................@.....@...@.
.........@@............@.@......@....@@@@@@@@@@@........@.......@@......@..@
.......................@.......@@@....@@@@@@@@@@.@...@........@........@@..@
...............................@@@@.....@@@@@@@@.................@@@.......@
@@@@@@@.......................@@@..........@@@@@@.................@@........
@@@@@@@....@@@@...............@@........@@.@@@@@@..........@......@@@.......
@@@@@@@@.....@@........@.......................@@.......@...........@.......
@@@@@.........@...@....@@@.......@@@@.@............@@@@@@@..................
@@@@@.............@.....@@@......@@@....@..@.@......@@@@@@@.................
@@@@.............@......@@@@.....@@@.@...............@@@@..........@@.......
@@@@@..................@@@@@@@.@.....................@@.....................
@@@@@....................@@@@@@...........@....@......@........@............
@@@@@@...................@@@@@@............@@@@@..........@...........@.....
@@@@@@...................@@@@@@@@@........@@@@@@@..@...................@@@@@
@@@@@@@........@@.....@@..@@@@@@@@..........@@@@........@@...............@@@
@@@@@@@........@@.....@...@@@@@@@@..........@@@@@.@......................@@@
@@@@@@@@....@@@@@...@@@...@@@@@@@@.......@....@@@............@....@.....@@@@
@@@@@@@.....@@@@@.....@...@@@@@@@@......@@...@@@@............@..@.@@....@@@@
@@@@@.......@@@@@.........@@@@@@@@.......@...@@@@...........@@...@@@....@@@@
@@@@@@........@@@.........@@@@@@.@.......@...@@@@..........@@@...@@@@..@@@@@
@.............@@@@........@@@@...........@@....@@..........@@@@@.@@@@...@@@@
.........@.....@@@@.......@@@@....@......@@@..@@@..........@@@@@@@@@@...@@@@
@...@@...........@@..@....@@@...........@@@@@@@@...@..........@@@@@@@..@@@@@
@..@@............@@@........@...........@@@@@@@@@@............@@@@@@...@@@@@
@..@@............@@@@@@.................@@@@@@@@@@......@........@@.....@@@@
@...@.............@@@@..@...............@@@@@@@@@@...@..@........@@......@@@
@.@@@....@....@@...@@@@@@....@@@........@@@@@@@@@@...............@@@..@..@@@
..@...@............@@@@@@@....@@@...@@@@@@@@@@@@................@@@@@....@@@
..@...@.......@...@@@@@@@@..@@@@@@@@@@@@@@@@@@@@................@@@@@....@@@
..@.........@@@..@@@@@@@@@@@@@@@@@@@@@@@@@@@@@..................@@@@@@......
...........@@@@..@@@@@@@@@@@@@@@@@@@@@@@@@@@@....@..........@..@@@@@@@.....@
..........@@@@@....@@@@@.@@@@@@@@@@@@@@@@@@@@...@@........@.@..@@@@@@@@@@...
..@.....@...@@@....@@.@..@@@@@@@@@@@@@@@@@@@@@@................@@@@@@@@@@...
.....@.........@...@@....@@@@@@@@@@@@@@@@@@@@@@..@.............@@@@@.@@@@@..
@....@..................@@@@@@@@@@@@@@@@@@@@@@@@@@...........@@@@@@@...@@...
..............@@@........@@@@@@@@@@@@@@@@@@@@@@@@@...@.......@@@@@@@@..@@...
...............@@@@@@@@@.@@@@@@@@@@@@@@@@@@@@@@@@@@..@@.....@@@@@@..@..@....
........@........@@@@@@@.@@@@@@@@@@@@@@@@@@@@@@@@@@@@....@@@@@@@@@........@@
......@.@@@@@....@@@@@@@@@@@@@@@@@@@@@@@@@@@@@@@@@@@@......@@@@@@@@.......@@
..@.....@@@@@@...@@@@@@@@@@@@@@@@@@@@@@@@@@@@@@@@@@@@@@@@@@@@@@@@@@.........
@.@.....@@@@@@.....@@@@@@@@@@@@@@@@@@@@@@@@@@@@@@@@@@@@@@@@@@@@@@@@........@
@.......@@@@@@@@.@@@@@@@@@@@@@@@@@@@@@@@@@@@@@@@@@@@@@@@@@@@@@@@@@@...@@@@@@
@..@....@@@@@@@@@@@@@@@@@@@@@@@@@@@@@@@@@@@@@@@@@@@@@@@@@@@@@@@@@@@..@@@@@@@
...@@...@@@@@@@@@@@@@@@@@@@@@@@@@@@@@@@@@@@@@@@@@@@@@@@@@@@@@@@@@@@@@@@@@@@@
@......@@@@@@@@@@@@@@@@@@@@@@@@@@@@@@@@@@@@@@@@@@@@@@@@@@@@@@@@@@@@@@@@@@@@@
@.......@@@@@@@@@@@@@@@@@@@@@@@@@@@@@@@@@@@@@@@@@@@@@@@@@@@@@@@@@@@@@@@@@@@@
@........@@@@@@@@@@@@@@@@@@@@@@@@@@@@@@@@@@@@@@@@@@@@@@@@@@@@@@@@@@@@@@@@@@@
@........@@@@@@@@@@@@@@@@@@@@@@@@@@@@@@@@@@@@@@@@@@@@@@@@@@@@@@@@@@@@@@@@@@@
....@....@@@@@@@@@@@@@@@@@@@@@@@@@@@@@@@@@@@@@@@@@@@@@@@@@@@@@@@@@@@@@@@@@@@
.......@@@@@@@@@@@@@@@@@@@@@@@@@@@@@@@@@@@@@@@@@@@@@@@@@@@@@@@@@@@@@@@@@@@@@
......@@@@@@@@@@@@@@@@@@@@@@@@@@@@@@@@@@@@@@@@@@@@@@@@@@@@@@@@@@@@@@@@@@@@@@
......@@@@@@@@@@@@@@@@@@@@@@@@@@@@@@@@@@@@@@@@@@@@@@@@@@@@@@@@@@@@@@@@@@@@@@
.....@@@@@@@@@@@@@@@@@@@@@@@@@@@@@@@@@@@@@@@@@@@@@@@@@@@@@@@@@@@@@@@@@@@@@@@
....@@@@@@@@@@@@@@@@@@@@@@@@@@@@@@@@@@@@@@@@@@@@@@@@@@@@@@@@@@@@@@@@@@@@@@@@
8
62 31 0
61 24 0
33 12 0
18 0 0
13 45 0
38 33 0
9 15 0
15 62 0

5 70 0
5 45 0
36 10 0
7 70 0
29 47 0
3 70 0
11 26 0
15 61 0
