width 76
height 76
@@@@@@@@@@@@@@@@@..@@@@@@@@@@@@@@..............@..@@@@@@@@@@@@@@@@@@....@@@@
@@@@@@@@@@@@@@@@...@@@@@@@@@@@@@@.................@@@@@@@@@@@@@@@.@......@@@
@@@@@@@@@@@@@@@....@@@@@@@@@@@@@..@@@......@@...@.@@@@@@@@@@...@@........@.@
@@@@@@@@@@@@@@@.....@@@@@@@@@@...@@@@.......@@..@@@@@@@@@@.....@@..........@
@@@@@@@@@@@@@@@.....@@.@@@@@@@...@@@@..@.........@@@@@@@@@......@@.@.......@
@@@@@@@@@@@@@@..@@.....@@@@@@...@@@@@@.....@......@@@@@@@@..@.....@@@......@
@@@@@@@@@@@@....@@.......@@@....@@@@@@@.@.........@@@@@@@.........@....@@..@
@@@@@@@@@@@@..@@@@...............@@@@.............@@@@@@@...............@..@
@@@@@@@@@@@@@@@@@@................................@@@@@@@.........@..@@....@
@@@@@@@@@@@@@@@@@@.....................@...........@@@@@..........@..@@..@.@
@@@@@@@@@@@@@@@@@@@..@.@....@...............@.....@@@@@@..........@........@
@@@@..@@....@@@@@...............................@@...@@....................@
@@@...@@....@..@@.......................@....@..@..@....................@@@@
@.@@..@...........@@........@..@..@.....@..@@@@@@@@....................@@@@@
@................@@@.........@.........@@@.@@@@@@@@@@@.......@....@....@@@@@
@.....@....@........................@..@@@@@@@.@@@@@@@.................@@@@@
@.....@.......@..........@.......@@@@@@@@..@@@.@@@@@.@.................@....
@.......@.@...@@....................@..@@..@.@.@@@@.........................
@.........@.@.@@@@.@................@.@@@@.@...@@.....@@@...................
@...@@........@@@@.@..@...........@.........@..............@@@....@@........
@...@@...........@@...@...@.......@............@........@@...@@@.@@@.@@@....
@@@@@@.........@....@...@.@.........@.@........@@@..........@@@@@@@@@@@.....
@@@@@@@..........@@@@.........@@@.............@@@.........@@@@@@@@@@@@......
@@@@@.......@@...@@@@....@....@@@@.......@.......@........@@@@@@@@@@@@@@...@
@@@@@@....@.@@....@@@@@@@@....@@@@........................@@@@@@@@@@@@@@@@@@
@@@@@@.....@@@@.@@@@@@@@@@@..@@@@@@@...........@..........@@@@@@@@@@@@@@@@@@
@@@@@@@@@@@@@@@@@@@@@@@@@@@@@@@@@@@@..................@@@.@@@@@@@@@@@@@@@@@@
@@@@@@@@@@@@@@@@@@@@@@@@@@@@@@@@@@@@@.....................@@@@@@@@@@@@@@@@@@
@@@@@@@@@@@@@@@@@@@@@@@@@@@@@@@@@@@@.....................@@@@@@@@@@@@@@@@@@@
@@@@@@@@@@@@@@@@@@@@@@@@@@@@@@@@@@@@......................@.@@@@@@@@@@@@@@@@
@@@@@@@@@@@@@@@@@@@@@@@@@@@@@@@@@@@....................@.....@@@@@@@@@@@@@@@
@@@@@@@@@@@@@@@@@@@@@@@@@@@@@@@@@@@..............@...@.@@.......@@@@@@@@@@@@
@@@@@@@@@@@@@@@@@@@@@@@@....@@@@@@@...........@....@...........@@@@@@@@@@@@@
@@@@@@@@@@@@@@@@@@@@@@@@.....@@@@............@...........@.....@@@@@@@@@@@@@
@@@@@@@@@@@@@@@@....@@@@.......@............@@..@...@.......@@@@@@@@@@@@@@@@
@@@@@@@@@@@@@.@@.....@@@.......@@...........@@......@@......@@@@@@@@@@@@@@@@
@@@@@@@@@@@@..@@.@@..@......................@@.....@@@.......@@@@@@@@@@@@@@@
@@@@@@@@@@@@.............@.....@@@...........@....@@@@@@.....@@@@@@@@@@@@@@@
@@@@@@@@@@......................@@.....@..@@@.....@@@@@@.....@@@@@@@@@@@@@@@
@@@@@@@@@@..@@.....@...@..............@@@@@...@...@@@@@@......@@@@@@@@@@@@@@
@@@@@@@@@@@@.............@............@@.....@@...@@@..@...@@@@@@@@@@@@@@@@@
@@@@@@@@@@@@..........................@@.....@@........@....@@@@@@@@@@@@@@@@
@@@@@@@@@@@@.....@@........@..............@.@@@.............@@@@@@@@@@@@@@@@
@@@@@@@@@@@@@@@...........@@.......@........@@@.............@@@@@@@@@@@@@@@@
@@@@@@@@@@@@@@.........@.....................@@.........@@@@@@@@@@@@@@@@@@@@
@@@@@@@@@@@@@@....@....@.....................@@.........@@@@@@@@@@@@@@@@@@@@
@@@@@@@@@@@@@@........@...................................@@@@@@@@@@@@@@@@@@
@@@@@@@@@@@@@...........................................@.....@@@@@@@@@@@@@@
@@@@@@@@@@@@@..............@@...............@.................@@@@@@@@@@@@@@
@@@@@@@@@@@@@.......@@@@@...@......................@@.........@@@@@@@@@@@@@@
@@@@@@@@@@@@@@.......@@@......................................@@@@@@@@@@@@@@
@@@@@@@@@@@...........@@.....@...............................@@@@@@@@@@@@@@@
@@@@@@@@@@@....@..@@@.@@................@................@...@@@@@@@@@@@@@@@
@@@@@@@@@@@..@....@@@.@.........@@..@....................@.....@@@@@@@@@@@@@
@@@@@@@@@@............@........@@........................@....@@@@@@@@@@@@@@
@@@@@@@@@@.................@...@@..@..................@@@@@@@.@@@@@@@@@@@@@@
@@@@@@@@@@@.@.............@@@......@.................@@@@@@@@@@@@@@@@@@@@@@@
@@@@@@@@@@@...............@@.......@...........@.......@@@@@@@@@@@@@@@@@@@@@
@@@@@@@@@@@........................@.@..............@.@@@@@@@@@@@@@@@@@@@@@@
@@@@@@@@@@@@@..............@.......@@..............@@@@@@@@@@@@@@@@@@@@@@@@@
@@@@.@@@@@@@@...............@.@....@@...............@@@@@@@@@@@@@@@@@@@@@@@@
@@@@........@...@@...@...@@.........@....@.@.......@@@@@@@@@@@@@@@@@@@@@@@@@
@@@@@@.......@.....@...............@@....@@...@@@..@@@@@@@@@@@@@@@@@@@@@@@@@
@@@@@@.......@......................@..............@@@@@@@@@@@@@@@@@@@@@@@@@
@@@@@........@@............@........@......@@......@@@@@@@@@@@@@@@@@@@@@@@@@
@@@@@.......@@@........@.....@@.....@.....@@@......@@@@@@@@@@@@@@@@@@@@@@@@@
@@@@.......@@@@......@@..@..@...........@@@@.....@..@@@@@@@@@@@@@@@@@@@@@@@@
...@@.......@@@@......@...........@.....@@@@@@@.....@@@@@@@@@@@@@@@@@@@@@@@@
..........................@.@...........@@@@@@@@.@@@@@@@@@@@@@@@@@@@@@@@@@@@
.........@.....................@@@@........@@@@@@@@@@@@@@@@@@@@@@@@@@@@@@@@@
...............................@@@@.......@@@@@@@@@@@@@@@@@@@@@@@@@@@@@@@@@@
.........................@@@@.@@@@@@@@@...@@@@@@@@@@@@@@@@@@@@@@@@@@@@@@@@@@
......@@....@...........@@@@@@@@@@@@@@@@@@@@@@@@@@@@@@@@@@@@@@@@@@@@@@@@@@@@
.....@@@.....@.@@@@.....@@@@@@@@@@@@@@@@@@@@@@@@@@@@@@@@@@@@@@@@@@@@@@@@@@@@
..@@@@@@.......@@@@.@...@@@@@@@@@@@@@@@@@@@@@@@@@@@@@@@@@@@@@@@@@@@@@@@@@@@@
.@@@@@@...@@@.@@@...@..@@@@@@@@@@@@@@@@@@@@@@@@@@@@@@@@@@@@@@@@@@@@@@@@@@@@@
8
50 55 0
61 15 0
36 47 0
30 55 0
33 65 0
28 8 0
61 48 0
22 14 0

33 59 0
52 24 0
20 38 0
41 11 0
51 60 0
17 72 0
18 55 0
12 19 0
