width 76
height 76
@@@@@@@@@@@......@@@@.............@........@@@@@@@@@@@@@@@@@@@@@@@@@@@@@@@@@
@@@@@@@@@@@......@................@..........@@@@@@@@@@@@@@@@@@@@@@@@@@@@@@@
@@@@@@@@@@@.....................@...........@@@@@@@@@@@@@@@@@@@@@@@@@@@@@@@@
@@@@@@@@@@@...........@...........................@@@@@@@@@@@@@@@@@@@@@@@@@@
@@@@@@@@@@@@@........@@...........................@@@@@@@@@@@@@@@@@@@@@@@@@@
@@@@@@@@@@@@@.......@.........@..@..............@@@@@@@@@@@@@@@@@@@@@@@@@@@@
@@@@@@@@@@@@@....@..@.....@.@....@@...............@@@@@@@@@@@@@@@@@@@@@@@@@@
@@@@@@@@@@@@@@...@.......@@@@@.........@@.........@@@@@@@@@@@@@@@@@@@@@@@@@@
@@@@@@@@@@@@@@@............@@.........@@@..@......@@@@@@@@@@@@@@@@@@@@@@@@@@
@@@@@@@@@@@@@@@.......@.....@..........@@.@@.....@@@@@@@@@@@@@@@@@@@@@@@@@@@
..@@@@@@@@@@@@@.....@.@................@@@@@....@@@@@@@@@@@@@@@@@@@@@@@@@@@@
..@@@@@@@@@@@@.............@............@@@@.......@@@@@@@@@@@@@@@@@@@@@@@@@
.@@@...@@@.@@....................@.............@....@@@@@@@@@@@@@@@@@@@@@@@@
..@@...@...@...@.................@@@................@@@@@@@@@@@@@@@@@@@@@@@@
...............@....................................@@@@@@@@@@@@@@@@@@@@@@@@
......@@.............@@..@.....@@@........@@@@.......@@@@@@@@@@@@@@@@@@@@@@@
@@....@@....@............................@@@@@........@@@@@@@@@@@@@@@@@@@@@@
@@@.@..............@@.................@@..@@@@@...........@@@@@@@@@@@@@@@@@@
@@@@@...................@@@...............@@@@@........@..@@@@@@@@@@@@@@@@@@
@@@.....................@@@@..............@@@@@@..........@@.@@@@@@@@@@@@@@@
@@........@@..........@@@...............@.@@@@@@.............@@..@@@@@@@@@@@
@@...................@@@@...............@.@@@@@...............@..@@@@@@.....
@@...............@...@@@@.......@......@@@@@@@.....@@.......@....@@@@@......
@@...................@@@@@@...............@@@@@@@................@@@@@....@.
@@@@@@..@@..@.................@@..........@@@@@@@@..............@@@@@@@@....
@@@@@@.@@@........@...@..@....@@.........@@@@@@@@@...@.@.@.....@@@@@@..@@..@
@@@@@@@@@@........@...........@@.........@@@@@@@@@..............@@@@.......@
@@@@@@@@@@..............@..@.@@@.........@@@@@@@@@.......@..@....@@@......@@
@@@@@@@@@...@@@@@@.......@@@.@@..........@@@@@@@@@@......@.......@@@.......@
@@@@@@@@@...@@@@@@.....@.@@@@@@.........@@.@@@@@@@@....@.........@@..@......
@@@@@@@......@@@@...@....@@@@@@........@@..@@@@@@@@.@......@@.@.@@@.@.......
@@..@@@.....@@...........@@@@................@@@@@..@......@@.....@.........
@...@@.........@........@@@@@.........@...@@@@@@@@.............@@@@@......@.
@@...............@.......@@@@.........@...@@@@..@.......@@....@@@@...@......
@@..@......@...........@@@@@@...@...@.@.....@@................@@@...........
......................@@@@@@@@......@.@@@...@@................@@@@..........
...@.............@@....@@@@@@...............@...................@..@........
..................@@.@...@@@@...................@@@@..@@....................
@....@....@.......@@....@@@.....................@@@@@@@...@@@@@@@...........
@....@@...@.......@@@...@@@................@...@@@@@@@@@..@@@@@@@@.........@
@.....@..@@.......@@@@..@@.........@@@.....@...@@@@@@@@@.@@@@@@@@@.@.@@....@
.........@@....@@@@@@@@.............@@.........@@@@@@@@@.@@@@@@@@....@@...@@
.........@@.@@@@@@@@...............@@@..........@@@@@@@..@@@@@@@..........@@
.....@...@@@@@@@@@@@..@............................@@@@@@@@@@@@@@.........@@
.........@@@@@@@@@@..................................@.@@@@@@@@@@@......@@@@
...@....@@@@@@@@@@@@.......................@.@.........@@@@@@@@@@@@@@....@@@
........@@@@@@@@@@@@.@......@............................@@@@@@@@@@@@.......
......@@@@@@@@@@@@@@................@@..@@....@.@...@....@@@@@@@@@@@@.......
@..@.....@@@@@@@@@@@@..@@............@..@@.@@.@....@.....@@@@@@@@@@........@
@.@.......@@@@@@@@@@....@...............@.@.@........@@@@@@@@@@@@@@@........
@.........@@@@@@@@@@......................@.........@...@@@@@@@@@@@@@.......
@.........@@@@@@@@@@@@@...........@@....................@@@@@@@@@@@@@.....@.
@........@@@@@@@@@.........@@.....@@.......@@...............@.@@@@@@@@......
.........@@@@@@@@.......@.@@@..@@..@.......@..........@........@@@@@@@......
.........@@@@@@@@.........@..@@@........@.....@@.....@@........@@@@........@
@...@@...........@@..........@@@@.......@.............@........@@@.........@
..@@@............@@@..@........@@................................@....@@...@
.................@@@..@.@.......@...............@.........@.@@...@..........
..................@............................@@@..@........@...@.....@....
...........@@..............@@.......................@...@................@..
........@@@@@..............@@.....@@@..............@@...@@@.......@@........
.........@@@@@...................................@.@.....@@........@@@......
@.....@..@@..@..@.@@...............................@.....@.....@@@@@.....@..
@@@...............@@@........................................@@@@@@@.....@@.
@@@@............................@@@.............@.@........@@@@@@@@@........
@@@.............@...............@@@@...............@.......@@@@@@@@@@.......
@@@@.........@.................@@@@.........@..............@@@@@@@@@........
@@@.....@@...@@..@.........@....@.....................@.....@@@@@@@@@@......
@@@@....@@...@@@....................@.......................@@@@@@@@@@......
@@@@....@@.........@@@..................@@@@@@@......@.......@@@@@@@@.......
@@@@...............@@@@@..........@.......@.@..............@@@@@@@@@@@......
@@@@@.....@........@@@@@....@@....@.@..................@@@.@@@@@@@@@@@......
@@@@@@.............@@@@@.@@@@@..@....@@................@@@@@@@@@@@@@@@...@@@
@@@@@...........@@@@@@@......@......@@...........@@....@@@@@@@@@@@@@@@@.@@@@
@@@@@@@@......@.@@@@@@..............@@@@.....@@@@@@.....@@@@@@@@@@@@@@@@@@@@
@@@@@@@@.....@..@@@@@...............@@@@.@...@@@@@...@@@@@@@@@@@@@@@@@@@@@@@
8
40 65 0
36 1 0
43 7 0
70 47 0
55 30 0
68 39 0
31 0 0
22 38 0

48 63 0
31 63 0
12 73 0
36 63 0
0 53 0
68 39 0
11 42 0
28 42 0
