width 34
height 34
@@@@@@@@@@@@@@@@@@@@@@@@@@@@@@@@@@
@@@@@@@@@@@@@@@@@@@@@@@@@@@@@@@@@@
@@@@@@@@@@@@@@@@@@@@@@@@@@@@@@@@@@
@@@@@@@@@@@@@@@@@@@@@@@@@@@@@@@@@@
@@@@@@@@@@@@@@@@@@@@@@@@@@@@@@@@@@
@@@@@@@@@@@@@@@@@@@@@@@@@@@@@@@@@@
@@@@@@@@@@@@@@@@@@@@@@@@@@@@@@@@@@
@@@@@@@@@@@@@@@@@@@@@@@@@@@@@@@@@@
@@@@@@@@@@@@@@@@@@@@@@@@@@@@@@@@@@
@@@@@@@@@@@@@@@@@@@@@@@@@@@@@@@@@@
@@..@@@@@@@@@@@@@@@@@@@@@@@@@@@@@@
@@...@@@@@@@@@@@@@@@@@@.......@@@@
.....@@@...@@@@@@@@@@@........@@@@
..............@@@@@@@@.......@@@@@
..............@@@@@@.@@......@@@@@
......@.......@@@@@..@@........@@@
............@.@@........@.........
.......@.......@.......@@@........
...............@@..@...@..........
@@............@@@.................
@@....@..........................@
@@@.............@@@...............
@@@..............................@
@@................@........@@...@@
@.....@@@....@@...................
@.....@@@@..@@@.........@.........
......@.....@@@....@....@@....@...
...................@.........@@...
.....@............@@.........@@...
....@@.....@.......@...@.@.@......
.......................@@@@@@@....
...................@..@@@@@@@@@...
.................@....@@@@@@@@@@..
......@@@..@.....@....@@@@@@@@@@@@
8
5 24 0
3 33 0
13 18 0
29 23 0
5 33 0
27 19 0
32 29 0
27 28 0

32 28 0
5 27 0
6 21 0
16 31 0
3 22 0
24 15 0
31 30 0
20 26 0
