width 34
height 34
@@@@@@@@@@@@@@@@@@@.....@@@@@@@@@@
@@@@@@@@@@@@@......@...@@@@@@@@@@@
@@@@@@@@@@@@.......@@....@@@@@@@@@
@@@@@@@@@@@@......@@@..@.@@@@@@@@@
@@@@@@@@@@@@..........@@..@@@@@@@@
@@@@@@@@@@@@..........@@@@@@@@@@@@
@@@@@@@@@@@@...........@@@@@@@@@@@
@@@@@@@@@@@@......@....@@@@@@@@@@@
@@@@@@@@@@@.....@@@........@@@@@@@
@@@@@@@@@@@......@@@......@@@@@@@@
@@@@@@@@@.........@@.....@@@@@@@@@
@@@@@@@@@......@.........@@@@@@@@@
@.................@@.....@@@@@@@@@
@...............@.@@.@@@@@@@@@@@@@
@......................@@@@@@@@@@@
@...@..................@@@@@@@@@@@
.......................@@@@@@@@@@@
..................@....@@@@@@@@@@@
..................@.....@@@@@@@@@@
.....@..@.........@.....@@@@@@@@@@
...@....@@......@@@@.@...@@@@@@@@@
.@.@....@@......@@@@@@.....@@@@@@@
...@....@.........@@@@....@@@@..@@
...@..@@@.........@@@.....@..@..@@
......@@@...........@....@......@@
......@@..@@.................@@@@@
...@......@@.................@@@@@
.............................@@@@@
....@@........@...@@......@@@@@@@@
@...@..............@..@@@@@@@@@@@@
@@......................@@@@@@@@@@
@@......................@@@@@@@@@@
@@...@..@@..............@@@@@@@@@@
@@...@@@@@.@.........@@@@@@@@@@@@@
8
17 33 0
9 14 0
13 22 0
12 23 0
21 30 0
15 31 0
22 32 0
1 15 0

15 31 0
22 28 0
13 22 0
24 4 0
17 33 0
22 2 0
31 23 0
15 4 0
