width 34
height 34
@@@@@@@@@@.@@@...@.......@@@@@@...
@@@@@@@@@..@@@...@.........@@.@@..
@@@@@@@...............@@.......@..
@@@@@@@@...@..........@@..........
@@@@@@@...@@........@............@
@@@@@......@.....................@
@@@........@@....................@
...........@@.....@@@@...........@
...............@@@@@@...........@@
....................@.............
.......@...@.....@................
..................................
..................................
......................@@.......@..
......................@......@....
.......@.......@..................
.@@.........@@@....@........@.....
.............@@@...@@.............
...@.@.@@@.....@..................
........@@...@................@...
..@...@..@...@................@@..
..@...@@.....@@.............@@@@..
@..@.........@@...@.........@@@@@@
@................@@.........@@@@@@
..........................@..@@@@@
.....@.....@..........@...@.@@@@@@
@.............@..@@..........@@@@@
..............................@@@@
...................@..........@@@@
...................@..........@@@@
@@@..@..............@.........@@@@
@@@...@@@...........@..@..........
@@@.@@@@............@@@@@.........
@@@.@@@@............@@@@......@...
8
11 11 0
14 8 0
26 12 0
18 14 0
17 15 0
32 7 0
27 23 0
19 4 0

29 28 0
29 10 0
3 32 0
30 11 0
33 33 0
8 27 0
10 31 0
22 7 0
