width 34
height 34
@@@@@@@@@.............@@@@@@@@@@@@
@@@@@@@@@............@@@@@@@@@@@@@
.@@@@.@@@............@@@@..@@@@@@@
.@@@@.................@@..@@@@@@@@
............................@@@@@@
.....@..............@....@.....@@@
.@.............................@@@
.......@...................@...@@@
..........@.@@...@.............@@@
@..................@.......@..@@.@
@@............................@...
@........@........................
@........@........................
@@.......@@@......................
@.........@@..............@.....@@
..........@@.............@@@@....@
.........................@@@@...@@
..@.......@...................@.@@
..@@.....................@....@@@@
@.@@...@.........@........@....@@@
..@@...........@@@..............@@
.@@@@@......................@@...@
@@@@@@....@.................@@@...
@@@@@@....@...@...@.............@.
@@@@@@@@@........................@
@@@@@@@@@.......@........@.....@@@
@@@@@@@@@.........@@@@...@.......@
@@@@@@@@@....@....@@@@...@@.......
@@@@@@@@@@...@.@.@@@@@@...........
@@@@@@@@@@..@....@@@@@@...........
@@@@@@@@@@....@..@@@@@@@.....@@..@
@@@@@@@@@@@@....@@@@@@@......@@..@
@@@@@@@@@@@@@....@@@@@@@@@.......@
@@@@@@@@@@@@@@@@@@@@@@@@@@.@....@@
8
4 7 0
14 10 0
19 1 0
9 22 0
24 26 0
29 24 0
27 17 0
8 22 0

14 9 0
24 29 0
13 29 0
3 15 0
6 18 0
7 14 0
29 9 0
7 6 0
