width 80
height 80
@@@@@@@@@@@@@@@@@@@@@@@@@@@...@..................@@@@@@@@@@@@@...@@@...@@@@@.@@@
@@@@@@@@@@@@@@@@@@@@@@@@@@@.................@@...@@@@@@@@@@@...........@@@@@.@@@
@@@@@@@@@@@@@@@@@@@@@@@@@@@@.....................@@@@@@@@@@@......@.....@@@..@@@
@@@@@@@@@@@@@@@@@@@@@@@@@@@...........@@@@@@@@@@..@@@@..@@@@............@....@@@
@@@@@@@@@@@@@@@@.@@@@@@@@@@..........@@@@@@@@@...@@......@@.........@..........@
@@@@@@@@@@@@@@@@.@@@@@@@@@@..........@@@@@@@@@.@.@@.......@.....................
@@@@@@@@@@@@@@@...@.@................@@@@@@@@@.....@............................
@@@@@@@@@@@@@@@..@@..................@@@@@@@@@.................@...........@....
@@@@@@@@@@.@@@........................@@.@@@@@............@...@@.......@..@@@...
@@................@@....@@...@@@.@@..........@............@..........@@@@@@@@...
@@...............@@@.........@@@@@@@............@@@...................@@@@@@@@..
@@..........................@@@@...@@........................@...@...@@@@@@@...@
@@@@........@...@.................@@@.................@.........@.....@@@@@@....
@@@@@@.................@@@........@@@...................@@...........@@...@@....
@@@@@......@...@.......@@@.........@@..@.....@..........@.....@...@..@..........
@@@@@......@@....@...........@@.................@.......@@....@@@@@..@..........
@@@@@.......@.......@........@@.........................@@@@@@@@@@@.............
@@@@@.........@...........@.....@..........@..@.......@@@@@@@@@@@@@.............
@@@@@...........................@.....................@@@@@@@@@@@@....@@...@....
.@........@.@.............................@@.@.......@@@@@@@.@@@@@..............
......@...@@@................@@.....@.....@@@@.........@@@....@........@@@......
........@@@@@......@..........@.........@..@@...@.....@@@@@.@@@...@....@@@......
....@...@@@@@......@..@.......@.@@..@@.....@@..........@@@@.@....@....@@@@@...@.
......@.@@@@.....@@@..@....@..@............@@.........@@@@.........@............
@..............@@@@@@.@@.@.................@@.....@...@@@@.........@...........@
................@@@@@@@@.@............@@...@..........@@@@.@..@......@.........@
................@@@@@@@@@@........@...@...............@@@@@@..@...........@.....
..@@@@..........@@@@@@@@@@..@......@@.@.............@@@@@@@@.........@...@@.....
.....@......@..@@@@@@@@@@......@@...@.@....@@..........@@@@@....@@@@@@@@..@.....
.................@.@@@@@@...................@@@@@@.@....@@@@@..@@@@..........@..
.................@..@@@@@@@...@@.@..........@@@@@@@@@@..@@.....@@@@.............
...................@@@@@@@@@.....@............@@@@@@.@..@.......@@..............
.........@...........@@@@@@....@.....@.......@@@@@@@....@.....@..@...@..........
.........@..........@@@@@@@.................@@@@@@@....@..@.........@@...@..@.@.
....@..@@..@........@@@@@@@................@@@@..@@................@.....@....@@
...........@.......@.@@@@@@...................@@..............@@@.......@@@...@@
.......................@@@.........................@.......@...@@@@@....@@@@@@@@
..@@@@@.................................@..................@....@@..@...@@@@@@@@
@@@@@@@.........................@@@@.............@........@@....@@@.@..@@@@@@...
@@@@@@.......@@@.....@@@@....@..@...@...@.............@@........@.......@@@@@...
@@@@@@...@@@@@@@...@.........@@@....@@..........@@@@@@@@@........@...@..@@@.....
@@@@@...@@@@@.............@..@@...@@@@...........@@@@@@@@..........@@...........
@@@@@.@.@@@@@.................@...................@@@@@@@..........@.........@..
@@@@@@@@@@@@@@....@..@@@...........@.......@.......@@@@@@@...@...............@.@
@@@@@@@@@@@@@@@@@.@..@@..@...............@.@.......@@@@........@.......@........
@@@@@@@@@@@@@@@@@....@...@...............@@@........@@@@.......@.........@@.....
@@@@@@@@@@@@@@@@@.......................@@@@@@...@@@@@@@@@@....@...@@.@.........
@@@@@@@@@@@@@@.................@.......@@@@@@@.....@@@@@@@............@.........
@@@@@@@@@@@@@....@.....................@.@@@.@..@.....................@.........
@@@@@@@@@@@@@........................@@..@......@@.............@.....@......@...
@@@@@@@@@....@......@@..............@@@..........@.......@..@@..............@.@@
@@@@@@@@@......@@@@@@@.............@@@@.....................@...........@.......
@@@@@@@@@......@@@@@..@.......@...@@@@..@.....................@@.@..............
@@@@@@@@@@.....@@@@...@.......@@..@@@@..........@@@@...@@...@..................@
@@@@@@@@@@....@@.........@..@@@@.@@@@.....@..@@@@@@@@...@...................@..@
@.@@@@@@@@.......@@.....@@...@@@.@@@.......@.@@@@@@@@@@@@@.................@@@@@
@..@@@@@@@......@.......@@...@@@@@@.......@@@@@@@@@@@@@@@@@@@..........@....@@.@
....@@@@@@...............@...@@@.@@....@..@@@@@@@@@@@@@@@@@@@@.@..@..........@..
@@..@.@..@..@@...@.......@.................@@@@@@@@@@@@@@@@@@@@@....@..@@@......
@@...............@.......@................@@@@@@@@@@@@@@@@@@@@@@.....@..@@@.....
@@@.............@@@.........@@.@@....@@.@@@@@@@@@@@@@@@@@@@@@@@@@....@@.@@......
@@@..........@..............@.@@@..@.@@@@@@@@@@@@@@@@@@@@@@@@@@@@@@....@@@......
@..............@@@.........@..@@@..@@@@@@@@@@@@@@@@@@@@@@@@@@@@@@@@....@.......@
@........@....@@@@@................@@@@@@@@@@@@@@@@@@@@@@@@@@@@@@@@...........@@
........@@@...@@................@@@@@@@@@@@@@@@@@@@@@@@@@@@@@@@@@@@@..........@@
.........@....@@.@...@@.....@@@@@@@@@@@@@@@@@@@@@@@@@@@@@@@@@@@@@@@@@..@......@@
..............@...@@.@@.....@@@@@@@@@@@@@@@@@@@@@@@@@@@@@@@@@@@@@@@@@@@@.@....@.
.....................@@@..@@@@@@@@@@@@@@@@@@@@@@@@@@@@@@@@@@@@@@@@@@@@@@@.@@@...
....@.................@...@@@@@@@@@@@@@@@@@@@@@@@@@@@@@@@@@@@@@@@@@@@@@@@.......
@@@@@.....................@@@@@@@@@@@@@@@@@@@@@@@@@@@@@@@@@@@@@@@@@@@@@@@.......
@@@@@.@.................@@@@@@@@@@@@@@@@@@@@@@@@@@@@@@@@@@@@@@@@@@@@@@@@@@@..@@.
@@@@@@@...........@.....@@@@@@@@@@@@@@@@@@@@@@@@@@@@@@@@@@@@@@@@@@@@@@@@....@@@@
...@@@@@.......@@..@....@.@@@@@@@@@@@@@@@@@@@@@@@@@@@@@@@@@@@@@@@@@@@@@@...@@@@@
...@@@@@..@....@..........@@@@@@@@@@@@@@@@@@@@@@@@@@@@@@@@@@@@@@@@@@@@......@@@@
.@...@.........@.......@@@@@@@@@@@@@@@@@@@@@@@@@@@@@@@@@@@@@@@@@@@@@@@@.....@@@@
.@.............@.......@@@@@@@@@@@@@@@@@@@@@@@@@@@@@@@@@@@@@@@@@@@@@@.......@@@@
......................@@@@@@@@@@@@@@@@@@@@@@@@@@@@@@@@@@@@@@@@@@@@@@@........@@@
.@.@...@.....@.......@@@@@@@@@@@@@@@@@@@@@@@@@@@@@@@@@@@@@@@@@@@@@@@@....@..@@@@
@@.@@@@.....@@@......@@@@@@@@@@@@@@@@@@@@@@@@@@@@@@@@@@@@@@@@@@@@@@@@...@@@@@@@@
@@@@@@......@@@......@@@@@@@@@@@@@@@@@@@@@@@@@@@@@@@@@@@@@@@@@@@@@@@@...@@@@@@@@
8
28 26 0
65 43 0
60 30 0
1 73 0
14 32 0
16 66 0
59 35 0
38 38 0

64 3 0
68 21 0
75 21 0
30 59 0
29 47 0
64 0 0
1 37 0
37 1 0
