width 80
height 80
@@@@@@@@@@@@@@@@@@@@@@@@@@@...@@@@....@..@...@@@@@@@....@..@@@..@@@@@@@@@@@@@@@@
@@@@@@@@@@@@@@@@@@@@@...................@@....@@@@@.....@.......@@@@@@@@@@@@@@@@
@@@@@@@@@@@@@@@@@@@@..................@.........@@...........@....@@@@@@@@@@@@@@
@@@@@@@@@@@@@@@@@@@...@@.@......................@@..@....@.........@@@@@@@@@@@@@
@@@@@@@@@@@@@@@@@@@...@@.@@.....@@.....@........@@.................@@@@@@@@@@@@@
@@@@@@@@@@..@@@@@.....@@@@@@@@@.@@@................................@@@@@@@@@@@@@
@@@@@@@@@@.@@@@.@......@@@..@@@.@@@...@@@....@........@............@@@@@@@@@@@@@
@@@@@@@@......@..............@@.......@@.....@.................@....@@@@@@@@@@@@
@@@@@@@..........@........@@@............@@..@..@................@....@@@@@@@@@@
@@@@@@@@.................@@........@........@@..@.........@@.....@..@.@@@@@@@@@@
@@@@@@@@.............................@.......@.....@......@@.@...@@....@@@@@@@@@
@@@@@@@@..........@@........@@@@.............@............@@.....@@....@@@@@@@@@
@@@@@@@@........@@@@@.......@@.......@.......@............@@......@..@@@@@@@@@@@
@@@@@@@@@...@@@@@@@@@@@..............@..........@....@........@@.....@@@@@@@@@@@
@@@@@@@@@@.@@@@@@@@@..@..@.......@@@.@...............@@......@@...@@@@@@@@@@@@@@
@@@@@@@@@@@@@@@@@@@..............@@@@@@.............................@@@@@@@@@@@@
@@@@@@@@@@@@@@@@.....@.........@@@@@@@...@.......@@@................@@@@@@@@@@@@
@@@@@@@@@@@@@@@........@.......@@@@@@@@@..........@@.....@.......@..@@@@@@@@@@@@
@@@@@@@@@@@@@....@............@@@@@@@@@@..........@@@@....@@...@...@@@@@@@@@@@@@
@@@@@@@@@@@@@....@......@.....@@@@@..@@@.....@@....@.@@@@@@@.@@@@@.@@@@@@@@@@@@@
@@@@@@@@@@@@@...@@.@........@...@............@..@@...@@@@@@@@@@@@@..@@@@@@@@@@@@
@@@@@@@@@@@@@@@.............@...@@......................@@@@@@@@@@....@@@@@@@@@@
@@@@@@@@@@@@@@@@@...............@@..@.............@@@...@@...@@.......@@@@@@@@@@
@@@@@@@@@@@@@@@@...@............@.......@..............@@@....@.......@@@@@@@@@@
@@@@@@@@@@@@@@@@@@.@.....................@...................@@.........@@@@@..@
@@@@@@@@@@@@@@@@@@.......@.................................................@....
@@@@@@@@@@@@@@@@@.............................@..........@..@...@@@@@@.@......@@
@@@@@@@@@@@@@@@.....................@...@...........@@@..@......@@@............@
@@@@@@@@@@@@@@......@........@@@..............@@@..@.@@.........@..............@
@@@@@@@@@@@@@............@...@@...............@@.....@@..@............@......@@@
@@@@@@@@@@@@@@..........@@....................@@.....@...@@................@@@@@
@@@@@@@@@@@@@........@@....@......@.....@...@.....@@.....@@@@@.............@@@@@
@@@@@@@@@@@@@@@.......@@@......@@@@....@@...@.....@@.....@@@@@.@@@...........@@@
@@@@@@@@@@@@@@.@.@@@@...@......@@@@.@...@@..............@@@@@...@......@......@@
@@@@@@@@@@@@@@....@@@...................@@..@@...........@@@..........@....@...@
@@@@@@@@@@@@..@...@@@..................@@@..@@..........@@@@..@....@....@.......
@@@@@@@@@@@.......@@@.......@..@.....@.@@........@.....@@@@@..@.@.@............@
@@@@@@@@@@@@.......@@@........@....@.@.................@@@@@.....@@...........@@
@@@@@@@@@@@@@....@.@........@@@@...@....@.......@@@.....@@@@.......@...........@
@@@@@@@@@@@@@....@.@........@@@@@................@@@@....@@@...................@
@@@@@@@@@@@........@.......@@@@@@@.................@@....@@...@.@@...@....@@..@.
@@@@@@@@@@@...............@@@@@@@........@..........@....@......@@........@.....
@@@@@@@@@@@@@@@.........@@@@@@.@@@@..............@.......@.........@......@@....
@@@@@@@@@@@@@@@@@..........@...@@@...........@...@.......@..................@...
@@@@@@@@@@@@@@@@@@@............@@@@......................@@...........@.........
@@@@@@@@@@@@@@@@@@@............@@@...........................@@@@@@@@...........
@@@@@@@@@@@@@@@@@@@............@@@...........................@@@@@@@............
@@@@@@@@@@@@@@.@@@@..@.........@@.........@..................@@@@.@...........@.
@@@@@@@@@@@@@@....@...@@@@......@@@......@.........@.......@@@@@@...............
@@@@@@@@@@@@@@....@@............@@@@...@.........@.@.@@@.......@@....@..........
@@@@@@@@@@@@@@........@.........@@@@..@@@@@......@@@.@@@........@@@..@..........
@@@@@@@@@@@@@@@.@.....@....@@..@@@@@@@@@@@....@..................@..............
@@@@@@@@@@@@@.......@.@.....@..@@@@@@@@@@@@.@.@....@@............@..............
@@@@@@@@@@@@@..@......@.....@@.@@@@@@@@@@@@...@..@@@@@....@....@@@.............@
@@@@@@@@@@@@@@........@@@....@...@@@@@@@@...@@@...@@@.......@....@.@............
@@@@@@@@@@@@@@@@..@@.............@@@@@@...........@@....@@.......@..............
@@@@@@@@@@@@@@@@@................@@@@@............@........@....................
@@@@@@@@@@@@@@@@@@...............@@@@.............@...................@.........
@@@@@@@@@@@@@@@@@...@............@@@@....@......................@.@.........@..@
@@@@@@@@@@@@@@@@@@...........@....@@.............@.....@@.....@@@.............@@
@@@@@@@@@@@@@@@@@@...............................@....@......................@@@
@@@@@@@@@@@@@.........@...@.....@@...............@....@....@@...@......@........
@@@@@@@@@@@@@@..................@...........................@................@@.
@@@@@@@@@@@@@@@.....@...@.............@@....................@........@@@....@@@@
@@@@@@@@@@@@@@@.......................@@@.........@@@......@........@@@@.....@@@
@@@@@@@@@@@@@..............@..........@...........@@@......@..@@@....@@@.....@@@
@@@@@@@@@@@@@..............@...@...................@@........@@@@...@@@@.....@@@
@@@@@@@@@@@@@..................@@.............@@...@@@....@@@@@....@@@@@.....@@@
@@@@@@@@@@@@@.......@............................@@@@@@..@@@@@@....@@@@@....@@@@
@@@@@@@@@@@@@.@.........@.......@...@............@@@@@@@@@@@@@@@@@@@@@@@....@@@@
@@@@@@@@@@@@@@@@@..................@@............@@@@@@@@@@@@@@@@@@@@@@@@@.@@@@@
@@@@@@@@@@@@@@@...@................@@..@.........@@@@@@@@@@@@@@@@@@@@@@@@@@@@@@@
@@@@@@@@@@@@@@@....@@...@..........@@............@@@@@@@@@@@@@@@@@@@@@@@@@@@@@@@
@@@@@@@@@@@@@@@@...@@...@@...................@....@@@@@@@@@@@@@@@@@@@@@@@@@@@@@@
@@@@@@@@@@@@@@@@@......@@@....@@@.................@@@@@@@@@@@@@@@@@@@@@@@@@@@@@@
@@@@@@@@@@@@@@@.......@@@@@............@..........@@@@@@@@@@@@@@@@@@@@@@@@@@@@@@
@@@@@@@@@@@@@@........@@@@@...........@...........@@@@@@@@@@@@@@@@@@@@@@@@@@@@@@
@@@@@@@@@@@@@@........@@@@@@.@@@@.....@...@.@@..@@@@@@@@@@@@@@@@@@@@@@@@@@@@@@@@
@@@@@@@@@@@@@@...@@@.@@@@@@@.............@@@@@...@@@@@@@@@@@@@@@@@@@@@@@@@@@@@@@
@@@@@@@@@@@@@@..@@@@@@@@@@@@@..........@@@@@@...@@@@@@@@@@@@@@@@@@@@@@@@@@@@@@@@
8
47 25 0
28 13 0
75 47 0
50 67 0
16 64 0
9 11 0
35 45 0
61 40 0

76 67 0
75 68 0
20 77 0
32 10 0
38 57 0
30 9 0
62 2 0
68 41 0
