width 71
height 71
.......@@@@@@@@@@@@@@@@@@@@@@@@@@@@@@@@@@@...........@....@...@@@@@@@@@
......@@@@@@@@@...@@....@@@@@@@@@@@@@@@@@@@...................@@@@@@@@@
.@.....@@...@@@..@@@.....@@@@@@@@@@@@@@@@@@@...........@.......@@@@@@@@
......@@@.................@@@@@@@..@@...@@@@@........@...........@@@@@@
...@.......................@@@@@...@@...@@@@.........@.@.@.....@....@@@
.............@..@..@.....@...@@@....@....@@.....@....@.@@@..........@@@
..................................@@@...........@....@.@@@...@......@@@
.............................@...@@@@...@.......@..@...@@@.....@.......
@@@@@@...@.................@.....@@@..@@@@.........@@@@@@......@.......
@@@@@...@@@@....@..........@.....@@@...............@@@@@@@.@...........
@@@@@@...@...........@...........@@@...@............@@@@@@@.........@..
@@@@@......................@.......@.@@@............@@@@@@@............
@@@@.........@..@@....................@@...@@@....@@@@@@@@@@........@..
@@@@@.@.......@@@@..@.....................@.@@......@@@@@@@@...@...@@..
@@@@@.........@@@@..@.....@..........@.......@........@@@@@@.......@...
@@@..........@@@@@@@@@@@@............@................@@@@@@@@@@@..@...
@......@........@@@@@@@@..............................@@@@@@@@@@...@...
................@@@@@@@@@...............................@@@@@@@@...@...
...@@........@@....@...@@..........@...@.........@...@.....@@@@........
@@...........@..................@...@.........@.@@...@@.....@@.........
@@@@....................................@.....@..........@..@@.........
@..@......@@....@...................@@.@@.................@.@@.........
.......@..@@.........................@.@@@............................@
..........@.............@................@...@@....@........@@@........
..@...........@@........@@.................@.@@..@.........@@@@......@@
..............@........@@@......@@@...........@@...@@.......@@....@....
@.....................@@@...@@................@...........@@@@.....@...
@......................@.......@.....@....................@@@@@@...@...
@.........@..................@@@.....@....................@@@.........@
@@................@..........@@......@@@@@@..@@@@......@..........@....
@@..................@....@@.......@..@@..........................@.....
.@.......................@@@@.................@@........@@.............
........@@.@...@.@@@......@@@@....@...........@@@.......@..............
.........@@@@.....@@.....@@@@@@........@......@@@.......@..............
.........@@@@............@@@@@.......@@....@..........@@...............
@....@...@@@@@.........@@@@................@@@............@@....@......
@..@.....@.@@........@@@@@.....@.@@.........@....@@@@@@.........@@@....
.............@@.....@@....@..@.@@@@.........@...@@@@@@..........@@@....
........@..@@@@@.@@@@@..@....@@@@@@............@@@@@@@.......@..@@.....
..........@@@@@@...@@........@@@@@@@.............@@@@@.@.....@.@@@@...@
..........@@@@@.......@......@.@@@@@@............@@@@@.@@@@@@@@@@@@...@
..@@..@..@@@@@@@@@@@..@..........@@@@@@..@..@....@@@@@.@@@@@@@@@@@@@...
@.@........@@@@@@@@@.@@.......@@.@...............@@@@@@@@@@@@@@@@@@@@.@
@.@@......@@@@@@@@@@@............@...............@@@@@@@@@@@@@@@@@@@@@@
........@.@@@@@@@@@@@.............................@@@@@@@@@@@@@@@@@@@@@
......@@@..@@@@@@@@@@..@.@...@@................@@@@@@@@@@@@@@@@@@@@@@@@
.....@@@@@@@@@@@@@@....@@..........@@.........@@@@@@@@@@@@@@@@@@@@@@@@@
..@@@@@@@@@@@@@@@@@....@...........@@..@...@@@@@@@@@@@@@@@@@@@@@@@@@@@@
..@@@@@@@@@@@@@@@@@.................@@@@...@@@@@@@@@@@@@@@@@@@@@@@@@@@@
....@@@@@@@@@@@@@@.................@@.@@@...@@@@@@@@@@@@@@@@@@@@@@@@@@@
@@....@@@@@@@@..............@@@@@@......@.....@@@@@@@@@@@@@@@@@@@@@@@@@
......@@@@@@@@...............@@@......@@@......@@@@@@@@@@@@@@@@@@@@@@@@
......@@@@@@@@......@@....@@..@@@.@............@@@@@@@@@@@@@@@@@@@@@@@@
.......@@@@@@..@..@...@......@@...@..@.......@@@@@@@@@@@@@@@@@@@@@@@@@@
@.........................@..........@.........@@@@@@@@@@@@@@@@@@@@@@@@
@@@...........................................@@@@@@@@@@@@@@@@@@@@@@@@@
@@@@........................@..............@@.@@@@@@@@@@@@@@@@@@@@@@@@@
@@@@@@@.........@@..........@........@...@.@@..@@@@@@@@@@@@@@@@@@@@@@@@
@@@@.............@@@@....@.@@@............@....@@@@@@@@@@@@@@@@@@@@@@@@
@@................@@.....@@@.......@....@@@....@@@@@@@@@@@@@@@@@@@@@@@@
..................@........@.@..@@.......@.......@@@@@@@@@@@@@@@@@@@@@@
.....@.....................@.@...@@@..@..@....@@@@@@@@@@@@@@@@@@@@@@@@@
.....@................@@@.@@............@@@...@@@@@@@@@@@@@@@@@@@@@@@@@
.....@............@...@@@@......@......@@@@...@@@@@@@@@@@@@@@@@@@@@@@@@
...............@..@....@@@.....@@...@@@@@@@@@@@@@@@@@@@@@@@@@@@@@@@@@@@
..........@..@.........@@......@@...@@@@@@@@@@@@@@@@@@@@@@@@@@@@@@@@@@@
....................@@@@............@@@@@@@@@@@@@@@@@@@@@@@@@@@@@@@@@@@
....@...@.............@.......@......@@@@@@@@@@@@@@@@@@@@@@@@@@@@@@@@@@
...........@............@@....@......@@@@@@@@@@@@@@@@@@@@@@@@@@@@@@@@@@
..............@.....@................@@@@@@@@@@@@@@@@@@@@@@@@@@@@@@@@@@
.@@..................@............@...@@@@@@@@@@@@@@@@@@@@@@@@@@@@@@@@@
8
57 39 0
21 12 0
62 6 0
36 36 0
13 29 0
62 28 0
6 61 0
62 31 0

32 7 0
2 5 0
43 61 0
7 70 0
61 5 0
66 32 0
19 51 0
0 63 0
