width 71
height 71
@@@@@@.@...@@..@@......@@@@@@@@@@@@@..@@@@@..@@@@@@@@@@@@@@@@@.......@@
@@@@@@...@..............@@@@@@@@@@.@...@.@@.....@@@@@@@@@@@@@.......@@@
@@@@@@...@@@............@@@@@@@@@@...@........@@@@@@@@@@@@@@........@@@
@@@@.......@.............@@...........@@......@@@@@@@@@@@@@@........@@@
@@@@.......@@@...@.@.....@@...................@@@@@@@@@@@@@@........@@@
@@@@....@...@@..@@..@@@@.@@@..................@@@@@@.@@@@@@@......@.@@@
@@.@................@@@@.@@@@........@.@...@....@@@@......@.........@@@
@@.....@............@@@....................@.......@.................@@
..@@............................@.......@@@@............@...........@@@
.......................................@@@@@@@......@...@..............
..................@...@...............@@..@@@........@@@@@.............
........@@.@..@.......................@@....@..@@..@.@@@@@@@@@@........
@@@..@@@@@@@.....@....@..............@@@......@@@......@@@@@@@@......@@
@@@.@@@@@@@@.............@...........@@@...@..@@@......@@@@@@@.........
@@@@@@@@@@@@@@@..............@.............@..@@@..@...@@@@....@.......
@@@@@@@@@@@@@@......................@@................@@@@@..@.@@......
@@@@@@@@@@@@@...........@@.........@@@@@@..............@@@@...@........
.....@.@@@@@@......@@@..................@..............................
........@@@@..@.............................@....@...................@.
.@@....@@@@@.....@......@...............@@@@@....@.....................
.......@@@@@................@..........@@@@@@.....@....................
.......@@@@@...............@@..........@@@@@@.@....................@..@
....@..@@@@@...........@@..@.......@..@@@@@@@.....@....................
.@@....@..@@......@....................@@@@@@@....@.......@............
.@@......@@@..@....@...............@...@@@@@@...........@.@@@........@@
.@@......@.......................@....@@@@@@@@@.......@@@@@@@........@@
@@@......@.............................@@@@@@@@@......@@@.@@@........@@
@..........@@.....@......@@.....@...@@@@@@@@@@@@..@...@@....@........@@
@.........@..............@@.......@@.@.@@@@@@@@@@@@@..................@
@@................................@.....@.@@@@@@@@@@@@..@..........@...
@@.........@@@@@......@@..........@.....@.@@@@@@@@@@@@.......@.........
.......@...@@@@@@@.....@.....@............@@@@@@@@@@@@@@.............@@
...........@@@@@@@....@@@..@........@.....@@@@@@@@@@@@@.....@........@@
..@@.....@@@@@@@@@.........@@@.....@@@.....@....@@@@@@@...........@..@@
.........@@@@@@@@@.........@@.....@@@@.@........@@@@@@@..............@@
.........@@@@@.............@...........@........@@@.........@@@........
...........@@@...........@@@....@...............@@@@@.......@@@@.......
..@.......@@@...@........@......................@@@@@...@@.@@@@@@@@....
.@.......@@@......@......@...@@..................@@@@...@@@@@@@........
@@..@@...@@@...............@............................@@@@@@@........
.........@@........@......@@..................@...@@....@@@@@@@........
.......@.@@................@@..............@@.....@@....@@@@@....@.....
...@@@...@@...@.............@@...@................@@....@@@@@..........
..@@@@..............................................@@...@@@@.....@@...
...@...................@...................@.@@..........@.........@@.@
....@............@.........................@@@@.....@..............@@..
....@..........@....................@@@....@@@@............@@..@.@@@@..
@.............@@..@...................@......@...................@@@@..
...@@..........@....@@...........@@...@..........@@....@.........@@@...
...@@...............@@...........@@@@@@.........@@...............@@....
.............................@..@@@@@@@@@.......@@@@@.............@....
................................@@@@@@@@.@.....@@@@@@..................
......................@.....@@@@@@@@@@@@.......@@@@@@................@@
..@@@.................@@....@@@@@@@@@@.........@@@@@@........@.........
@.@@@@.......@........@@......@@@@@@@@@........@@@@@@@@................
@@@@@@.....@..................@@....@@@....@@...@@@@@@@.......@........
@@@@@@...................@....@..........@.....@..@@@@@@......@.......@
@@@@@@@@.....@.......@...................@............@@@@@@....@.....@
@@@@@@@@.....@.......@.@...........@@@................@@..@@...@@......
@@@@@@@@@@.........................@.........@......@@@....@@@@@@......
@@@@@@@@@@.......@......@@...@.........@@................@.@@@@........
@@@@@@@@@@@.............@@@..@....@@@..@@............@...@...@@........
@@@@@@@@@@@..@@@.........@@..@..@.@@@@@@@@...........@...@@............
@@@@@@@@@@.@......@...@@@@@..@..@@@@@@@@@@..........@@..@@............@
@@@@@@@@@@...........@@@@...@@..@@@@@@@@@@.............................
@@@@@@@@@@...@.......@@@@.......@@@@@@@@..............................@
@@@@@@@@@............@@@@....@@@@@@@@@@@@@.........................@@@@
@@@@@@@@@.....@......@@@@....@@@@@@@@@@@@@.......@............@......@@
@@@@@@@@......@...@...@@@.....@@@@@@@@@@@@@@....@.......@@...........@@
@@@@@@@@@.....@......@@@@.....@@@@@@@@@@@@@@@...@.......@@...@.......@@
@@@@@@@@@@@..@@@.@@@.@@@@.....@@@@@@@@@@@@@@@.................@......@@
8
7 48 0
32 31 0
9 56 0
70 39 0
29 59 0
3 28 0
41 12 0
70 15 0

52 67 0
10 64 0
0 46 0
61 55 0
32 4 0
64 69 0
41 15 0
45 19 0
