width 71
height 71
@@@@@@@@.....@@@@@@@....@...@...@@@@@@@@@@@@@@@@@@@@@@@@@@@@@@@@@@@@@@@
@@@..@@........@@@@@..............@@@@@@@@@@@@@@@@@@@@@@@@@@@@@@@@@@@@@
@@@.............@@@@..@...........@@@@@@@@@@@@@@@@@@@@@@@@@@@@@@@@@@@@@
@@.............@@@@@.@..........@@@@@@@@@@@@@@@@@@@@@@@@@@@@@@@@@@@@@@@
@@@....@@....@@@@@@@............@@@@@@@@@@@@@@@@@@@@@@@@@@@@@@@@@@@@@@@
@@@...@.......@@@@@@@.............@@@@@@@@@@@@@@@@@@@@@@@@@@@@@@@@@@@@@
@@@@.....@@.....@@.......@@......@@@@@@@@@@@@@@@@@@@@@@@@@@@@@@@@@@@@@@
@@.......@.......@@.@@.......@....@@@@@@@@@@@@@@@@@@@@@@@@@@@@@@@@@@@@@
@@...............@@..@.......@@....@@@@@@@@@@@@@@@@@@@@@@@@@@@@@@@@@@@@
@@...............@@................@@@@@@@@@@@@@@@@@@@@@@@@@@@@@@@@@@@@
................@@@@................@@@@@@@@@@@@@@@@@@@@@@@@@@@@@@@@@@@
@@........@@..............@.@.@.....@@@@@@@@@@@@@@@@@@@@@@@@@@@@@@@@@@@
@@@...............@.....@............@@@@@@@@@@@@@@@@@@@@@@@@@@@@@@@@@@
.................................@@@@@@@@@@@@@@@@@@@@@@@@@@@@@@@@@@..@@
............@@..................@@@@@@@@@@@@@@@@@@@@@@@@@@@@@@@@@@@@.@@
....................@..........@@@......@@@@@@@@@@@@@@@@@@@@@@@@@......
.....................@@....@@..@@@.......@@@@@@@@@@@@@@@@@@@@@@@@....@.
@........@.........@............@@@......@@@@@@@@@@@@@@@@@@@@@@@@@@..@@
@@@@....................................@@@@@@@@@@@@@@@@@@@@@@@@@@...@.
@@@@@.............@......@....@..............@@@@@@@@@@@@@@@@@@@@@@@...
@@@...............@.@....@@.....@@...........@@@@@@@@@@@@@@@@.@@@@@....
@@@.@.@.........@.@.....@....@.......@.......@@@@@@@@@@@@@....@@@@@....
@@..............@@@..........@............@...@@@@@@@@@@......@..@@@@..
@@@.........@.................@@.....@.........@@.@@@@@@..........@@@..
@@@@.........................@@........@....@..@@..@@@@.........@.@.@..
@@@@......@........................@........@..@@........@............@
@@@@..............@@......................@...........................@
@@@@..............@@............@.......................@........@.....
@@@@@..@........@.@@..........@@@..................@...................
@@@@@..@@.....................@@@@@...@@....@@.....................@...
@@@...@@@................@...............@.@@@....@.......@........@...
@@....@...@.............................@@@@.....@@@..@............@...
@@.........................@@@..........@@@@......@..@@@@..........@...
@@@@@..@.........@......@..@@@..........@@@...........@@@@@.......@....
@@@@@@@@@.....@.@@.........@@@..........@@.............@@@@............
@@@@@@@@@......@@@...........@....@.....................@@.............
@@@@@@@@@.........................@@.....@@.............@........@.....
@@@@@@@@.....@@@..................@......@.....@..................@...@
@@@@@@@@..@...@@........@@@.......@............@@......@@...@..........
@@@@@@@@..@@@@@@...............................@@@..........@..........
@@@@@@@@@@@@@@.................................@@......................
@@@@@@@@@@@@@@........................@@@@.....@......@................
@@@@@@@@@@@@@@............@.............@@@@........@@@@..........@@...
@@@@@@@@@@@@@@....@......@@..@@.........@@@.........@.............@@...
@@@@@@@@@@@......@@...........@.@@.......@...............@@........@...
@@@@@@@@@@@.........@....................@..............@@@............
@@@@@@@@@@@.@................@.........@@@..@........................@@
@@@@@@@@@@@.@@@.......@.@@@......@......@@@@@@@..@.....................
@@@@@@@@@@..@@@@@@@@..@..........@.....@@@@@@@@........@@........@.....
@@@@@@@@@@@..@@@@@@@@@@...@.@@@@@......@@@@@@..@...........@@.@......@@
@@@@@@@@@@...@@@@@@@@@@@@...@@@................@............@@.......@@
@@@@@@@@@@@@@@@@@@@@@@@@....@@@.........................@@@@@.........@
@@@@@@@@@@@@@@@@@@@@@@@..................@............@@@@@@@@@@@@@@@@@
@@@@@@@@@@@@@@@@@@@@@@................................@@@@@@@@@@@@@@@@@
@@@@@@@@@@@@@@@@@@@@@@..@.............................@@@@@@@@@@@@@@@@@
@@@@@@@@@@@@@@@@@@@@@@.@@@@@......@...................@@@@@@@@@@@@@@@@@
@@@@@@@@@@@@@@@@@@@@@@@@@@@@@............@@@...........@@@@@@@@@@@@@@@@
@@@@@@@@@@@@@@@@@@@@@@@@@@@@@@...........@.......@.....@@@@@@@@@@@@@@@@
@@@@@@@@@@@@@@@@@@@@@@@..@@......@.....................@@@@@@@@@@@@@@@@
@@@@@@@@@@@@@@@@@@@@@@@...@@@@..@.....@@...............@@@@@@@@@@@@@@@@
@@@@@@@@@@@@@@@@@@@@@@....................@@...........@@@@@@@@@@@@@@@@
@@@@@@@@@@@@@@@@@@@@@.......................@..........@@@@@@@@@@@@@@@@
@@@@@@@@@@@@@@@@@@@@@@@@.............................@.@@@@@@@@@@@@@@@@
@@@@@@@@@@@@@@@@@@@@@@@@.............@........@@@....@@.@@@@@@@@@@@@@@@
@@@@@@@@@@@@@@@@@@@@@@@@@.......@@......@.@...@@.........@@@@@@@@@@@@@@
@@@@@@@@@@@@@@@@@@@@@@@@@.......@@......@.@...@@.........@@@@@@@@@@@@@@
@@@@@@@@@@@@@@@@@@@@@@@@@.......@@@............@........@@@@@@@@@@@@@@@
@@@@@@@@@@@@@@@@@@@@@@@@@@@.....@@@..................@@@@@@@@@@@@@@@@@@
@@@@@@@@@@@@@@@@@@@@@@@@@@@@.....@...@@........@@..@@@@@@@@@@@@@@@@@@@@
@@@@@@@@@@@@@@@@@@@@@@@@@@@@@..@@.....@.....@@.@@@@@@@@@@@@@@@@@@@@@@@@
@@@@@@@@@@@@@@@@@@@@@@@@@@@@@@.@@........@@.@@@@@@@@@@@@@@@@@@@@@@@@@@@
8
8 7 0
10 36 0
36 28 0
10 18 0
20 35 0
22 53 0
26 19 0
41 67 0

9 14 0
19 45 0
51 32 0
36 54 0
25 31 0
25 17 0
49 64 0
28 17 0
