width 55
height 55
@@@@@@@........@@@@@@@@@@@@...@@@@@.....@.@@@...@@@@@..
@@@@@@@........@@@@@@@@@@.........@.........@...@@@....
@@@@@..........@...@@@@@...........@@...@.......@@.....
@@@@@@.......@@@@@..@@@...............@.@....@@........
@@@@@.....@..@@@@.....@@.............@@......@@........
@@@@........@@@@@..........@.........@@...@@.@@........
@@@@@.....................................@...........@
@@@@@@.........@.......@@..............@..............@
@@@@@@@........@......@@..............................@
@@@@@@....@............@.......@@@@@.....@...........@@
@@@@@@..........@..............@@@@@@...............@@@
@@@@@@......@@..@...........@@....@.......@........@@@@
@@@@@@.......@@...@.....................@.@@......@@@@@
@@@@@@.......@@..............@@@...@@.....@@...........
@@@@@@@@...@@@....@.........@@@@@..@@@....@@...@.....@@
@@@@@@@@@.@@@@@@@@.............@@@@@@@.............@@@@
@@@@@@@...@@@@@............@...@@@@@.............@.@@@@
@@@@@@@............................@...............@@@@
@@..@@@....................@...........@@@@@@......@@@@
@...@@...@.................@...@....@@....@.@@...@@@@@@
@............@.............@........@....@........@@@@@
@..................@........................@....@@@@@@
@.............@......@..@.@.................@@..@@@@@@@
@.............................................@@@@...@@
@..........@@..........@.......................@@....@.
.......................@@...@..........................
..........@.....@@@......@.........................@@@@
...@@..@........@@@.....@@@@@@..@..................@@@@
...@...@...............@@@@.....@@@@@............@@@@@@
.......@................@@@.....@@@@@.......@.....@@@@@
........................@@@..@@@@@@@.........@....@@@@@
.........................@@..@@@@@@@..............@@@@@
@...............@@@.......@@@@@@@@@@.....@........@@@@@
@@......................@.@@@@@@@@@..................@@
..@.@..............@@@@@@@@@@@@@@@@@.........@........@
.....................@@@@@@@@@@@@@@@................@..
....@....@...........@@@@@@@@@@@@@@...................@
......@..@...........@@@@@@@@@@@@@@.......@..@.........
...@.@@@.............@@@@@@@@@@@@@@.@@@@.......@@@.....
@@@@@@@@@......@.....@@@@@@@@@@@@@@@@@@@.......@@@....@
@@@@@@@@.........@...@@@@@@@@@@@@@@@@@@....@...@@@.@@@@
@@@@@@@@.............@@@@@@@@@@@@@@@@@@........@@@@@@@@
@@@@@@@@@@@@@.......@@@@@@@@@@@@@@@@@@@........@@@@@@@@
@@@@@@@@@@@.........@@@@@@@@@@@@@@@@@@@@@...@@@@@@@@@@@
@@@@@@@@@@@@........@@@@@@@@@@@@@@@@@@@@...@@@@@@@@@@@@
@@@@@@@@@@@.........@@@@@@@@@@@@@@@@@@@@@@@@@@@@@@@@@@@
@@@@@@@@@@........@.@@@@@@@@@@@@@@@@@@@@@@@@@@@@@@@@@@@
@@@@@@@@@@.@........@@@@@@@@@@@@@@@@@@@@@@@@@@@@@@@@@@@
@@@@@@@@@@@@@@@.....@@@@@@@@@@@@@@@@@@@@@@@@@@@@@@@@@@@
@@@@@@@@@@@@@@@.....@@@@@@@@@@@@@@@@@@@@@@@@@@@@@@@@@@@
@@@@@@@@@@@@@@@@@@@@@@@@@@@@@@@@@@@@@@@@@@@@@@@@@@@@@@@
@@@@@@@@@@@@@@@@@@@@@@@@@@@@@@@@@@@@@@@@@@@@@@@@@@@@@@@
@@@@@@@@@@@@@@@@@@@@@@@@@@@@@@@@@@@@@@@@@@@@@@@@@@@@@@@
@@@@@@@@@@@@@@@@@@@@@@@@@@@@@@@@@@@@@@@@@@@@@@@@@@@@@@@
@@@@@@@@@@@@@@@@@@@@@@@@@@@@@@@@@@@@@@@@@@@@@@@@@@@@@@@
8
24 21 0
8 17 0
18 19 0
19 44 0
36 22 0
50 2 0
8 4 0
50 10 0

54 37 0
46 6 0
19 23 0
48 28 0
15 34 0
20 13 0
47 3 0
5 24 0
