width 55
height 55
@@@@@@@@@@@@@@@@@@@@@...........@@@@@@@@@@......@@....@
@@@@@@@@@@@@@@@@@@@@............@@@@@@@@@@.............
@@@@@@@@@@@@@@@@@@@@............@@@@@@@@@@.....@.......
@@@@@@@@@@@@@@@@@@@@...........@@@.@@@@@@@.............
@@@@@@@@@@@@@@@@@.@@@@.........@@@...@@@@...........@@@
@@@@@@@@@@@@....@.@@@..........@@@...@.@@..@..@@..@..@@
@@@@@..@@@@@.@.....@@........@..@....@.....@@@@@......@
@@@@@.@@@@@.....................@..........@@.@@......@
@@@@..@@@@..............@......@@.@........@@.....@@@@@
@@@....@@..................@@..@@@@............@@@@@@@@
..@.....@...................@@@@@@@.............@@@@@@@
.............@@..............@@@@@@.............@@@@@@@
..............@@..@..........@@@@@@..........@...@@@@@@
@@@.........@.@@...@@........@@@.@@@..@......@...@@@@@@
@@@......@@....@@.@@@@@......@@@.@@........@.....@@@@@@
@@.......@@.......@@@@@.......@..............@...@@....
@.....@..@@.........@@@.......@..@....@@@@...@@........
@.....@@............@@@@...@...........@@@.............
@.....@.......@.....@@..@@........@...............@@...
.............@@@@@@.@.............@......@@.......@@...
.........@.@@@@@@@@.........................@@...@@....
........@@@@@@@@@@@@.@......................@......@@..
....@.....@@@@@@@@@@........@.....................@@...
...........@@@@@@@@@....@...@..................@..@@...
...........@@@@@@@@@@@..@.@.@.......@@..@.@....@......@
..@........@@@@@@@@@@@....@....................@...@...
..@.........@@@@@@@@@.....@.................@@@........
@.@.........@@@@@@@@@................@...@@@@@....@....
@.@.........@@@@@@@@@...@................@@@.@@........
@@@.........@.@@@@@@@...................@@@@...........
@@@@...@@@..@.@@@@@@@@.@................@@@@..........@
@@@@....@@....@@@@.@....@@@..@........@@@@............@
@@@@..........@@@@........@............@@..............
@@@..............@........@@...........@@.....@........
@....@.................................@@..............
....@@..@....@@..........@......@....................@@
....@..............................@..@..............@@
.............@..............@................@@@@@..@@@
.....@@......@.......@...@@@@.@@.........@..@@.@@...@@@
..................@.......@@.....@@.........@@..@......
...@@......@@............@@.................@..........
..............................................@@@.....@
@@@..............................................@@@@.@
.@...............@...............................@@@@.@
.................@@@.............@...............@@@@@@
.@..............@.@@.......................@.....@@@@@@
@....@...............................@...........@@@@@@
@........@.....@......@@........................@@@@@@@
...@................@..@..@@....................@@@@@@@
@.......@..............@@@.@........@.......@...@@@@@@@
.......@@@@.........................@...........@..@@@@
.....@.@@@@@@@@@@..........@@..@.........@.........@@@@
.....@@@@@@@@@@@@...@......@.....@@..@................@
@@@..@@@@@@@@@@@@.@.@....@.......@@..........@.........
@@@@.@@@@@@@@@@@@...@....@.....@@@@....@.....@....@@.@.
8
43 39 0
6 37 0
42 54 0
25 34 0
14 39 0
2 20 0
41 24 0
23 2 0

47 36 0
44 4 0
32 44 0
54 18 0
42 6 0
46 54 0
49 30 0
26 41 0
