width 55
height 55
@@@@@@@@@@...@@@....@@@@@@@@@@@@@@@@@@@@@@@@@@.....@@@@
@@@@@@@@@@@.........@@@@@@@@@@@@@@@@@@@@@@@@@@.....@@@@
@@@@@@@@@@@..........@@@@@@@@@@@@@@@@@@@@@@@@@.....@@@@
@@@@@@@@@@@@.......@@@@@@@@@@@@@@@@@@@@@@@@@@.......@@@
@@@@@@@@@@@@.......@..@@@@@@@@@@@@@@@@@@@@@@........@@@
@@@@@@@@@@@...........@@@@@@@@@@@@@@@@@@@@@@@.......@.@
@@@@@..@@@........@...@@@@@@@@@@@@@@@@@@@@@@@@.........
@@@@....@@............@@@@@@@@@@@@@@@@@@.@@@@@..@......
............@@........@@@@@@@@@@@@@@@@@..@@@@...@......
..........................@@@@@@@@@@@...@@.............
.....@@........@@.........@@@@@@@@@@...................
...@@@@@..@....@@.........@@..@@...................@...
...@@@............................@................@...
...@@.....................................@.....@@...@.
...@@...........................................@@@@@@@
............................@...@.......@......@@@@@@@@
.................@..............@..............@@@@@@@@
@..........@....................@....@.......@@@@.@@@@@
@.@..........@@.....@@.@........@.............@@...@@@@
@............@@..............@..@.................@@@@@
@@...........@@..........@@..@..........@.........@@.@@
...@..........@@@......................................
@@@@@@@@...@..@@@........@@......@...............@.....
@@@@@@@@...............@......@.@.........@.@......@@@@
@@@@@@@@..@@@..@....@.............................@@@@@
@@@@@@@@@@@@@@@@..............@..................@@@@@@
@@@@@@@@@@@@@@@@..............@..................@@@@@@
@@@@@@@@@@@@@@@@...................................@@@@
@@@@@@@@@@@@@@@@@@...............@................@@@@@
@@@@@@@@@@@@@@@@@@@@@........@...@..@@..@........@@@@@@
@@@@@@@@@@@@@@@@@@@@@....@..........@...@........@@@@@@
@@@@@@@@@@@@@@@@@@@@@...............@....@@....@..@@.@@
@@@@@@@@@@@@@@@@@@@@@...........@.................@....
@@@@@@@@@@@@@@@@@@@@@.............@............@.......
@@@@@@@@@@@@@@@@@@@@@..@.......@.........@.....@.......
@@@@@@@@@@@@@@@@@@@@@..........@@..@@@@..@..@..........
@@@@@@@@@@@@@@@@@@@@@..........@@@@@@@@@@.......@...@..
@@@@@@@@@@@@@@@@@@@@@.......@.@@@@@@@@@@@@@@........@@.
@@@@@@@@@@@@@@@@@@@@.........@@@@@@@@@@@@@@@@..........
@@@@@@@@@@@@@@@@@@@@..........@@@@@@@@@@@@@@@.....@@@.@
@@@@@@@@@@@@@@@@@@@@......@@.....@@@@@@@.@@@@......@@@@
@@@@@@@@@@@@@@@@@@@@@.....@@........@.@...@@@........@@
@@@@@@@@@@@@@@@@@@@@@@@@..@................@..........@
@@@@@@@@@@@@@@@@@@@@@..............@...@@@........@@..@
@@@@@@@@@@@@@@@@@@@..........@@@.......@@....@.....@...
@@@@@@@@@@@@@@@@@@@@...@...........................@...
@@@@@@@@@@@@@@@@@@@........................@...........
@@@@@@@@@@@@@@@@@@@........................@@@.........
@@@@@@@@@@@@@@@@@@....@@......@......@@...@@@@@.@@@@@..
@@@@@@@@@@@@@@@@@@@...@@@.........@@@@@.@@.@....@@@@@..
@@@@@@@@@@@@@@@@@@@@@@@@@@@@........@@@@@.......@@@@@@.
@@@@@@@@@@@@@@@@@@@@@@@@@@@@..........@@@....@....@..@@
@@@@@@@@@@@@@@@@@@@@@@@@@@@@.@.@@@@@......@..@.......@@
@@@@@@@@@@@@@@@@@@@@@@@@@@@@@@@@@@@@....@...@@......@@@
@@@@@@@@@@@@@@@@@@@@@@@@@@@@@@@@@@@@@@@....@@@.....@@@@
8
29 47 0
39 52 0
45 50 0
11 7 0
35 27 0
53 11 0
19 28 0
35 22 0

51 4 0
44 44 0
50 40 0
35 27 0
19 5 0
19 47 0
54 6 0
15 19 0
