width 55
height 55
@@@@@@@@....@@....@@@@@@@@@@@@@@@@@@@@@@@@@@@...@@@@@@@
@@@@.@............@@@@@@@@@@@@@@@@@@@@@@@@@@@@..@@@@@@@
@.................@@@@@@@@@@@@@@@@@@@@@....@.....@@@@@@
@@..............@@@@@@@@@@@@@@@@@@@@@@@........@@@@@@@@
@...............@@@@@@@@@@@@@@@@@@@@@@@.......@@.@@@@@@
.@........@.......@@@@@@@@@@@@@@@@@@@@@@@.........@@@@@
.............@@.@@@@@@@@@@@@@@@@@@@@@@@...@@.......@@@@
@............@@@@@@@@@@@@@@@@@@@@@@@@....@@@@@..@..@@@@
@@............@.@@@@@@@@@@@@@@@@@@@@@.....@@@@..@@@@@@@
@@@.....@...@.....@@@@@@@@@@@@@@.@@@......@@@@..@@..@@@
@@@@@@..@...@.......@@@@@@@@@@@@.......@@@@@@@..@...@@@
@@@@@@@@.............@@@@@@@@@@.......@@@@@@@.......@@@
@@@@@@@@@@...........@@@@@@@@@@........@@@@@@......@@..
@@@@@@@@@..............@@@@@@@@.......@@@@@@@..........
@@@@@@@@@............@....@@@@@.......@@@@@@...........
@@@@@@@@@.............................@@@@@@@........@@
@@@@@@.@........@...@..................@@@@@@.........@
@@@@@.......@......@@@@......@..........@@@@...@.......
@@@@.@....@........@@@..................@@@......@.....
@@@@...............@........@..@.........@@..........@@
@@@@...................@@......@........@@@.........@@@
@@@@........@.@@@.........................@@..........@
..............@@..........@@......@@...........@@.....@
..............@........................@...........@.@@
..............@.................................@....@@
..........@......@@@...........@@......@@.......@.....@
..........@....@.@@@..@...............................@
.....@@...@@@.........@................................
..@..@@.............@.@..........@@..........@.........
................@@@@@@..@@.@.....@@@.@@@..........@@...
@..@............@@@@@@.@..............@@..........@....
@........@@.....@@@@.@.............@@.................@
@..............@@.............@@@...@.................@
@.......@.....@@@.............@@......@.............@@@
.....@@@@.@..............@.....@.....@@.............@@@
.......@@..................................@....@..@@@@
..........@...@.......@.....@......................@@@@
@.............@...@...............................@@@@@
...................................................@@@@
.........@@............@@@....@@@.......@....@......@@@
@......................@@@.............@@..............
@..............@..@....@@@.......................@@....
@......................@.................@@@...........
@...@...............@@@...........@@.....@............@
...@@@@......@....................@@@@.................
..@@@@@@..........@........@@.....@@@......@@..........
.@@@@@@@@@@@.....@@@.......@@@@...@@@.......@@.........
.@@@@@@@@@@@@@@@@@@@@........@....@@........@@@@@@.....
@@@@@@@@@@@@@@@@@@@@@@......................@@@@@@@...@
@@@@@@@@@@@@@@@@@@@@...................@@@@@@@@@@@@...@
@@@@@@@@@@@@@@@@@@@@..............@@.@.@@@@@@@@@@...@@@
@@@@@@@@@@@@@@@@@@................@@@@@@@@@@@@@@@...@@@
@@@@@@@@@@@@@@@@@@@..........@....@@@@@@@@@@@@@@@...@@@
@@@@@@@@@@@@@@@@@@@@@@............@@@@@@@@@@@@@@...@@@@
@@@@@@@@@@@@@@@@@@@@@@@@@@@@@.....@@@@@@@@@@@@@@.@@@@@@
8
25 43 0
35 27 0
23 52 0
45 16 0
50 36 0
9 25 0
45 24 0
20 31 0

28 18 0
0 38 0
25 44 0
44 6 0
3 27 0
44 40 0
32 30 0
21 37 0
