width 55
height 55
@@@@@@@@@....@.......@........@@@@..........@@@@@@@.@@.
@@@@@@@@.....@................@@@..@.....@..@@@@@@.....
@@@@@@@@@....@@@........@@.........@........@@@....@...
@@@@@@@@......@@............................@.@.......@
@@@@@@........@......@...............................@@
@@@@@@........@@..............@.........@...........@@@
@@@@@@@.....@.@..............@@@..@@..@.@......@@...@@@
@@@@@@.....@...................@..........@@@@@@@@..@@@
@@@@@@......................@.............@@@@@@@@@@@@@
@@@.@@.@@.............@...................@@@@@@@@@@@@@
@@@..@@@.......@@.....@@.....@....@.......@@@@@@@@@@@@@
@@@@.@@............@.@@@@@......@@@.......@@@@@@@@@@@@@
@@@@.@@....@...@...@@@@@@....@.....@....@@@@@@@@@@@@@@@
@@@@.....@@@...@@.@@@@@@..........@.....@@@@@@@@@@@@@@@
@@@@.......@.@.......@@..................@@@@@@@@@@@@@@
@@@@@..............@..@..................@@@@@@@@@@@@@@
@@@@@....@...@@....@.....@@...@....@@....@@@@@@@@@@@@@@
@@@@@.....................@...@@@...@@@.....@@@@@@@@@@@
@@@@@......@....@....@@@@@@...@@@.....@.....@@@@@@@@@@@
@@@@@.....@....@@...@@@@@@@......@...........@..@@@@@@@
@@@@@.........@@@.....@@@@@.....@..................@@@@
@@@@@@@.....@@@........@@@.............@.....@..@@@@@@@
@@@.........@@@......@@@@@..........@..........@@@@@@@@
@@@@........@@@@@...@@@@@@...............@@..@@@@@@@@@@
@@@@.......@@@@@@@.@@@@@@@@@.@@..@@.@@.......@@@@@@@@@@
@@@@@@.....@@@@@@@@@@@@@@@@@@@@.........@....@@@@@@@@@@
@@@@@.....@@@@@@@@@@@@@@@@@@@@@.....@.......@@@@@@@@@@@
@@@@@.....@@@@@@@@@@@@@@@@@@@.............@..@@.@@@@@.@
@@@@..@...@@@@@@@@@@@@@@@@@@@@..................@@@@@.@
@@@@@@@@@@@@@@@@@@@@@@@@@@@@@@@.@@@.............@@@@@.@
@@@@@@@@@@@@@@@@@@@@@@@@@@@@@...@...............@@@@@.@
@@@@@@@@@@@@@@@@@@@@@@@@@@@....................@@@@@@..
@@@@@@@@@@@@@@@@@@@@@@@@@@..@....................@.@@..
@@@@@@@@@@@@@@@@@@@@@@@@@...@..........................
@@@@@@@@@@@@@@@@@@@@@@@@@.................@........@@..
@@@@@@@@@@@@@@@@@@@@@@@@@@........................@@@..
@@@@@@@@@@@@@@@@@@@@@@@@@@........@....@.........@.....
@@@@@@@@@@@@@@@@@@@@@@@.@@............@@.........@.....
@@@@@@@@@@@@@@@@@@@@@@@.....@@.........@@.....@@.......
@@@@@@@@@@@@@@@@@@@@@@@...@@@@..........@..@.......@...
@@@@@@@@@@@@@@@@@@@@@@@...@@@..........................
@@@@@@@@@@@@@@@@@@@@@@@....@@..........................
@@@@@@@@@@@@@@@@@@@@.@......@.....@...@................
@@@@@@@@@@@@@@@@@@@...............@@@.@................
@@@@@@@@@@@@@@@@@@@.....@........................@.....
@@@@@@@@@@@@@@@@@@@............@.................@@....
@@@@@@@@@@@@@@@@@@@...@.......@@@@...............@@....
@@@@@@@@@@@@@@@@...............@@@@.....@@..@..@@@@@@..
@@@@@@@@@@@@@@@@..................@...@.........@@@@@..
@@@@@@@@@@@@@@@@...................@............@@@@@@@
@@@@@@@@@@@@@@@....@@@@.......@@@..@..........@@@@@@@@@
@@@@@@@@@@@@@@@....@@@@@....@@@@@..@......@..@@@@@@@@@@
@@@@@@@@@@@@@@@......@.......@@@@..@@..@.@@@@@@@@@@@@@@
@@@@@@@@@@@@@@@..............@@...@@.....@@@@@@@@@@@@@@
@@@@@@@@@@@@@@@......@......@@@...@@@@...@@@@@@@@@@@@@@
8
16 9 0
30 38 0
35 44 0
30 33 0
13 20 0
35 22 0
25 43 0
52 33 0

26 9 0
35 3 0
9 2 0
13 19 0
11 16 0
39 6 0
47 35 0
44 39 0
