width 55
height 55
@@@@@@@@@@@@....@@@@@@@@@@@@@@@@@@@@@@@@@@@@@@@@@......
@@@@@@@@@@......@@@@@@@@@@@@@@@@@@@@@@@@@@@@@@@@.....@.
@@@@@@@@@........@@@@@@@@@@@@@@@@@@@@@@@@@@@@@.........
@@@@@@@@@........@@@@@@@.@@@@@@@@@@@@@..@@@@@@.........
@@@@@@@@@.....@....@@@@@.@.@@@@@@@......@@@@@@.........
@@@@@@@@.......@....@@@....@@@@@@........@@@@@@........
@@@@@@@@@.@...........@....@@@@@@@...@@@.@@@@@.........
@@@@.@@@..........@........@@@@@@...@@@@@@@@@@....@.@..
@@@@.........@..............@@@@....@@@@@@@@@@....@@@@@
..@@......@.........@@@..@..@@........@@@@@@@@....@@@@@
.......@@...........@@................@@@@@@..........@
...........@@.................@@......@@@@@@.....@@....
...........@...@...............@..@.....@@.............
...........@..................@...@.........@..........
@.........@@@...@.@@.@@@@@@.......................@....
@@.@@....@@@@...@@@@@@@@@@...................@.......@.
@@.@@@@@@@@@.......@@@@@@..@...........................
@@@@@@@@@@@@..............@........@@.@................
@@@@@@@@@@......................@...@...@.........@@...
@@@@@@@@@@.........@......@....@........@..@......@@...
@@@@@@@@@@........@@..@................................
@@@@@@@@@@@@....@..............@@......................
@@@@@@@@@@@@............@@...@@@@......................
@@@@@@@@@@@@@....@.....@@@................@..........@@
@@@@@@@@@@@@@....@@@@.@@...@........@@@...........@...@
@@@@@@@@@@@@@@@@.......@............@@@.@@............@
@@@@@@@@@@@@@@@@....................@@@.@@.............
@@@@@@@@@@@@@@@@..........@......@.......@...........@.
@@@@@@@@@@@@@@@@...........@@......@.@@@@@.............
@@@@@@@@@@@@@@@.......................@@@@..@.@@...@..@
@@@@@@@@@@@@@@@.......................@@.......@...@@.@
@@@@@@@@@@@@@@@@...............@......@@.......@...@...
@@@@@@@@@@@@@@@@@.@...@@@......@@....@@..........@.....
@@@@@@@@@@@@@@@@..@.@@@@@......@@@@..........@@........
@@@@@@@@@@@@@@@@@@@@@@@@@......@.@@...@................
@@@@@@@@@@@@@@@@@@@@@@@@@.................@@........@.@
@@@@@@@@@@@@@@@@@@@@@@@@....................@......@@@@
@@@@@@@@@@@@@@@@@@@@@@@@............................@@@
@@@@@@@@@@@@@@@@@@@@@@@@.@@@.@...............@......@@@
@@@@@@@@@@@@@@@@@@@@@@@@@@@@@@.@........@......@@@@@@@@
@@@@@@@@@@@@@@@@@@@@@@@@@@@@@@.............@..@@@@@@@@@
@@@@@@@@@@@@@@@@@@@@@@@@@@@@@@@.......@@@........@@@@@@
@@@@@@@@@@@@@@@@@@@@@@@@@@@@@@@.......@@@@....@..@@@@@@
@@@@@@@@@@@@@@@@@@@@@@@@@@@@@@...@......@@........@@@@@
@@@@@@@@@@@@@@@@@@@@@@@@@@@@@...........@...........@@.
@@@@@@@@@@@@@@@@@@@@@@@@@@@@.....@..........@@@..@.....
@@@@@@@@@@@@@@@@@@@@@@@@@@@@......@....................
@@@@@@@@@@@@@@@@@@@@@@@@@@@@......@@..@................
@@@@@@@@@@@@@@@@@@@@@@@@@@@@@@@.....@...@..............
@@@@@@@@@@@@@@@@@@@@@@@@@@@@@@@...@@...................
@@@@@@@@@@@@@@@@@@@@@@@@@@@@@@@..@@@...................
@@@@@@@@@@@@@@@@@@@@@@@@@@@@@@@.@@@@............@......
@@@@@@@@@@@@@@@@@@@@@@@@@@@@@@@@@@@@@@.......@@........
@@@@@@@@@@@@@@@@@@@@@@@@@@@@@@@@@@@@@@@.............@.@
@@@@@@@@@@@@@@@@@@@@@@@@@@@@@@@@@@@@@@@............@@.@
8
24 13 0
33 8 0
35 21 0
42 52 0
47 28 0
40 33 0
13 19 0
37 22 0

30 25 0
39 52 0
38 49 0
36 50 0
48 30 0
3 11 0
51 24 0
0 13 0
