width 55
height 55
@@@@@@@@@@@@@.......@@@..@...@@@@.............@@@......
@@@@@@@.....@..................@@.............@@@......
@@@@@@@.....@@.@......@...@...................@@@......
@@@@@......@...@...............................@.......
@@@.........@..............................@.....@@@...
@...............................@.................@@...
....................@.....@...............@.......@@@..
..@..................@.........................@@@@@@@@
.............@@...........................@...@..@@@@@@
@............@@..............@......@.............@@@@@
@..........@..........@...........@............@.....@@
...........@......................@@......@.......@..@@
@...@..................@....@....@............@......@@
@...........@..........@@@@......................@....@
@@@.............@@......@@@....@.@...............@@.@.@
@@@.@@@@.......@......@@@@@....@.............@....@....
@@@@@@@@@@@..@@......@@@@@@........@@@....@@@@@@.......
@@@@@@@@@@@@@........@@@@..........@@@@.....@.....@@@.@
@@@@@@@@@@......@.@..@@@@@.....@.@.@@@@.....@.....@@@@@
@@@@@@@@@@........@@.@@@@@........@@@@............@@@@@
@@@@@@@@@@........@@...@@@....@@@@@.............@@@@@@@
@@@@@@@@@..........@...@.........@@............@@@@@@@@
@@@@@@@@@.........@@@..@....................@..@@@@@@@@
@@@@@@@@@............@.@...@.@@@................@@@@@@@
@@@@....@....@@......@@@......@@................@@@@@@@
@.@@@@.......@@@....@@@@@@@@....................@@@@@@@
..@@.........@@@@...@@@@@@@@......@@.@..........@@@@@@@
..............@@@@...@.@@@@@......@@............@@@@@@@
....@@.........@.@.....@@@@@......@@@......@......@@@@@
...@@@........@........@@@.@.....@@@@...........@@@@@@@
...@@@................@@.........@@@@..........@@@@@@@@
...@@@.....@................@@...@@@...........@@@@@@@@
..........@@.................@...@@@......@@@@@@@@@@@@@
..........@@@.@...................@.......@@@@@@@@@@@@@
.@........@@@..................@.............@@@@@@@@@@
....@..............@@..........................@@@@@@@@
...@.....@.........@.@....@....................@@@@@@@@
@.......@@..@.............@@............@@@....@@@@@@@@
@..................@......@@.............@....@@@@@@@@@
@..................@.......@.@................@.@@@@@@@
@.........@@...................@.......@@@@.....@@@@@@@
...@@...................@...............@.....@.@@@@@@@
.....................................@@@......@@@@@@@@@
.........@.........@......@......@@....@@......@@@@@@@@
@..............@@@@@@@..@....@..................@@@@@@@
@...............@@@@@@..@@@..@..@@@@.@...........@@@@@@
.........@...@..@@@@@@@@@@@..@@@@@@@@...........@@@@@@@
.........@@..@..@@@@@@@@@@@@@@@@@@@@@@@..........@@@@@@
@............@@@@@@@@@@@@@@@@@@@@@@@@@@..........@@@@@@
..............@@@@@@@@@@@@@@@@@@@@@@@@@@..........@@@@@
..........@@.@@@@@@@@@@@@@@@@@@@@@@@@@@@.........@@@@@@
@@....@@@.@@@@@@@@@@@@@@@@@@@@@@@@@@@@@.....@@..@@@@@@@
@@....@@@@@@@@@@@@@@@@@@@@@@@@@@@@@@@.......@@@@@@@@@@@
@@@...@@@@@@@@@@@@@@@@@@@@@@@@@@@@@@@.......@@@@@@@@@@@
@@@....@@@@@@@@@@@@@@@@@@@@@@@@@@@@@@...@...@@@@@@@@@@@
8
11 46 0
46 23 0
6 33 0
28 15 0
47 19 0
3 7 0
11 22 0
24 32 0

36 20 0
43 30 0
16 17 0
27 12 0
10 30 0
38 35 0
54 6 0
6 35 0
