width 55
height 55
@@@@@@@@@..@@@@@@@@...@@@@....@@@..@@@@@@@@@@@@@@@@@@@@
@@.@@@@@....@@@.......@@@@....@@..@@@@@@@@@@@@@@@@@@@@@
@..@@@@@.....@@.........@.........@@@@@@@@@@@@@@@@@@@@@
......@..........@..................@@@@@@@@@@@@@@@@@@@
...........@.................@@.......@@@@@@@@@@@@@@@@@
........@@.......................@....@@@@@@@@@@@@@@@@@
.....@@.......@@.....................@@@@@@@@@@@@@@@@@@
......@.......@.................@...@@@@@@@@@@@@@@@@@@@
..@.......@@.............@@....@@@@@@@@@@@@@@@@@@@@@@@@
@.@......@@@.............@@....@@@@@@@@@@@@@@@@@@@@@@@@
@@@@....@@@..............@@.@@@@@@@@@@@@@@@@@@@@@@@@@@@
@@@@@....@@..............@@@@@@@@@@@@@@@@@@@@@@@@@@@@@@
@@@@@...............@....@@@@@@@@@@@@@@@@@@@@@@@@@@@@@@
@@@@@.........@@@...@@....@@@@@@@@@@@@@@@@@@@@@@@@@@@@@
@..@@....@@@@.....@@@@..@@@@@@@@@@@@@@@@@@@@@@@@@@@@@@@
........@@@.....@..@@@@@@@@@@@@@@@@@@@@@@@@@@@@@@@@@@@@
....@....@@....@@.@@@@@@@@@@@@@@@@@@@@@@@@@@@@@@@@@@@@@
@@....@@......@@@@@@@@@@@@@@@@@@@@@@@@@@@@@@@@@@@@@@@@@
@@..@@.........@@@@@@@@@@@@@@@@@@@@@@@@@@@@@@@@@@@@@@@@
@...@@@........@@@@@@@@@@@@@@@...@@@@@@@@@@@@@@@@@@@@@@
@..@@..........@@@@@@@@@@@@@@@....@@@@@@@@@@@@@@@@@@@@@
@..@...........@@@@@@@@@@@@@@@...@@@@@@@@@@@@@@@@@@@@@@
............@..@@@@@@@@@@@@@@.......@...@@..@@@@@@@@@@@
.........@@@...@@@@@@@@@@@@@@..@........@.....@@@@@@@@@
.........@@....@@@@@@@@@@@@@..................@@@@@@@@@
..@..@.........@@@@@@@@@@@@@.@@...............@@@@@@@@@
...............@@@@@@@@@@@@..........................@@
......@..........@@@@@@@@@......................@....@@
@...@.........@......@@@@@........@.................@@@
@...@........@..........@.....................@.....@@@
.............@.....@....@@...........................@@
@..........@@@..........@.........@...@@@@...........@@
@..@.......@@.................@.......@@......@......@@
@@...............@....................@@.............@@
........@....@.@@@@@@.....................@..........@@
.........@.....@@@@................................@@@@
.....@@..@......@@@................................@@@@
@@...@@..@@@....@@@@......@@..............@@@...@@.@@@@
@@@...@..@@......@@@.....@@@.............@@@@...@@...@@
@@@@..@..@@.....@@@@....@@@@@....@......@.@@@...@....@@
@@@.......@...@@@@@@......@@@........................@@
@@@.@...@@@....@@@@@...@@.@@@...@..@.................@.
@@@.@..@@@@...@@@.....@@@............................@.
@@@@.....@@...@@@..................................@...
@@.......@@...........@........@@..@.@.................
..........@...........@@@@@@@..@@.....@@........@..@...
....@.....@.....@......@@@@@...........@@..............
..@@@@@@@......@........@@@@@@@...................@....
@@@@@@@@@@............@@@@@@@@@........@...............
@@@@@@@@@@@..........@@@@@@@@@.............@@..........
@@@@@@@@@@.........@.@@@@@@@@@........@...@............
@@@@@@@@@....@@...@@@@@@@@@@@@@@................@......
@@@@@@@@@.....@...@@@@@@@@@@@@@@@@@@@.@.@....@.........
@@@@@@@@@@..@......@@@@@@@@@@@@@@@@@@...@...@@@@.......
@@@@@@@@@@.........@@@@@@@@@@@@@@@@@@...@@@@@@@@@......
8
9 13 0
2 20 0
38 29 0
41 52 0
12 15 0
14 53 0
4 23 0
36 37 0

52 47 0
42 43 0
47 42 0
23 8 0
30 28 0
11 3 0
11 33 0
19 8 0
