width 55
height 55
@@@@@@@@@@@@@@@@@.........@@@@@@@@@@@@@@@@@@@@@@@@@@@@@
@@@@@@@@@@@@@@@@@..@@.....@@@@@@@@@@@@@@@@@@@@@@@@@@@@@
@@@@@@@@@@@@@@@@@........@@@@@@@@@@@@@@@@@@@@@@@@@@@@@@
@@@@@@@@@@@@@@@..........@@@@@@@@@@@@@@@@@@@@@@@@@@@@@@
@@@@@@@@@@@@@@@@........@.@@@@@@@@@@@@@@@@@@@@@@@@@@@@@
@@@@@@@@@@@@@@@@@..@......@@@@@@@@@@@@@@@@@@@@@@@@@@@@@
@@@@@@@@@@@@@@@@@.@@......@@@@@@@@@@@@@@@@@@@@@@@@@@@@@
@@@@@@@@@@@@@@@@@.@@@.....@@@@@@@@@@@@@@@@@@@@@@@@@@@@@
@@@@@@@@@@@@@@@@@..@@@....@@@@@@@@@@@@@@@@@@@@@@@@@@@@@
@@@@@@@@@@@@@@@@@@.@........@@@.@@@@@@@@@@@@@@@@@@@@@@@
@@@@@@@@@@@@@@@@@@..........@@..@@@@@@@@@.@@@@@@@@@@@@@
@@@@@@@@@@@@.@.@@..........@@...@@@@@@@...@@.@@@@@@@@@@
@@@@@@@@@..........@...@@..................@.@@@..@@@@@
@@@@@@@@@..............@@.....................@@.....@@
@@@@@@@@............@@@@@..................@.........@@
@@@@@@@@...........@@@@@@.@........@.................@@
@@@@@@@@@..........@@@@@@@@............@.....@@........
@@@@@@.............@@@@@@@@.......@..@@@@..............
@@@@@@...@.........@@@@@@@@@.....@@...@................
@@@@@@..@@.........@@@@@@@@@.@...@@....................
@@@@.@...@...@....@@@@@@@@@@@@....@....@...............
@@@@.........@@@@@@@@@@@@@@@@@....@....@@@@....@.......
@@@@......@.......@@@@@@@@@@@..........@@@@......@@..@@
@@@@@..............@@@@@@@@@@.........@@@@@@.....@...@@
@@@@..................@@@@@@@....@....@@@@@@@........@@
@@@@...................@..@@@.........@@@@@@@........@@
@@@@......................@@@..........@@@@@@.....@.@@@
@@@..@@....@.............@@.........@@@@@@@@@@@......@@
@@...@.@..........@..................@@@@@@@...........
@@@........@@.....@.......@.........@@@@@@@@@..........
@@.........@@.@....................@@.@...@@@..........
@@.......@.@@.@.@.@.......................@.....@......
.....@..........@@@...................@........@......@
.........@.................@@.........................@
........@@@...........................................@
.......@@@....@....@...............@.@.....@@.......@@@
.......@...@..................@@....@@.....@@.....@@@@@
.............@........@@@....@............@@@@@...@@@@@
...@@........@@.@...............@@@.....@@@@@@....@@@@@
..@@@@@.............@.............@....@@@@..@..@@@@@@@
...@@@..........@.......@..............@@@......@@@@@@@
...@@@@@......@..................@@...@@@......@@@@@@@@
...@.@@@....................@@...@@...@@@@......@@@@@@@
@.............@@.....@......@@........@@@@@.....@@@@@@@
.............@@@@..@.................@@@@.....@@@@@@@@@
@.............@@@..@......@@.........@@@@@.@@@@@@@@@@@@
@.......@...@.@@@..............@.....@@@@@@@@@@@@@@@@@@
....@.........@@@@@...................@@@@@@@@@@@@@@@@@
......@......@@@@@@......@@...........@@@@@@@@@@@@@@@@@
.............@@@@@@@@@........@........@@@@@@@@@@@@@@@@
................@@@@@@..............@@@@@@@@@@@@@@@@@@@
@..........@....@@@@@@@@............@@@@@@@@@@@@@@@@@@@
...@......@@....@@@@@...............@@@@@@@@@@@@@@@@@@@
.@.......@@@@.....@...............@@@@@@@@@@@@@@@@@@@@@
..........@@@@@...@@........@@....@@@@@@@@@@@@@@@@@@@@@
8
41 33 0
0 42 0
37 40 0
21 0 0
34 50 0
52 27 0
13 25 0
22 36 0

35 32 0
51 16 0
47 35 0
15 36 0
34 50 0
45 30 0
20 10 0
23 6 0
