width 55
height 55
@@.@....@@@@@@@@.....@.@@...@@@@@@.@@@@@.........@@@@@@
@@.@....@@@@@@.......@.......@@....@@@...........@@@@@@
@@...@..@@@@@@@..........@....@....@@@........@@..@@@@@
@@@......@@@@@@.....................@.............@@@@@
@@@...........@......@..............@@........@..@@@@@@
@@@@.................@...................@@@@....@@@@@@
@@@@@@..........@@..........@................@.@.@@@@@@
@@@@@@..............@...@@..@.@@.....@.......@@@..@@..@
@@@@@@@@.............@...........@@...........@.......@
@@@@@.............@@...@...............................
@@@.......@............@........................@......
@@@@....@..@...........@..@.@....@......@..@.@..@@.....
@@..........................@@.............@...@@@....@
@@......@@@..............@@@@@.......@...@.....@@@...@@
@@......@@......@..@@......@@......@@@......@@@@@....@@
@@@.........@.......@........@@.....@@......@@@@@@...@@
@@@.............@@.@@......@@@@.............@@@@@@@....
@@@..........@@@@@..........@@@@...@.........@...@@....
...........@@@@@@..................@..................@
............@@@.@@.......@....@@.................@....@
@....@.......@@..@..@@...@@...........................@
@.........................@..........................@@
..........@..@@@@...@..................................
...@@.....@@@@@@@@.......@................@......@.....
...@@.....@@@@@@@@..................................@..
.............@@@@@@@....................@@.......@.@@..
.............@@@@@@..@@@..............@.@@.....@@@@@@..
@............@@@@@@@.@.........................@@@@@@.@
@...@@.......@@@@@@............................@@@@@@@@
.....@@......@...........................@......@@@@@@@
......@.....@@...@...@.@.....@.......@...@......@@@@@@@
............@@.........@..........@@@@@@@@......@@@@@@@
............@@...@...........@.....@@@@@@....@@@@@@@@@@
............@@.....................@@@@......@@@@@@@@@@
@........@...@.@..................@.@@@....@@@@@@@@@@@@
.............@...........@@@...................@@@@@@@@
@....@@...@..@@@..............@@...............@@@@@@@@
.....@@........@...@@..@..@...........@..@.....@@@@@@@@
...............@..........@@..........@@@@@@....@@@@@@@
......@........................@@....@@@@@@@@@@@@@@@@@@
...............@..@.................@@@@@@@@.@@@@@@@@@@
.......@..@@........................@@@@@@@@..@@@@@@@@@
...........@@...................@..@@@@@@@@....@....@@@
...........@@..........@...........@@@@@@@@.......@..@@
...@........@...@.....@@..@..@.....@@@@@@@........@....
..........................@.......@@@@.....@...........
.................@................@.@.@@...............
................@@@.....................@.@@@@.@.......
..@......@@.....@@@..@............@.......@@@@.........
..@.@@@.@@@....@@@@@@@@...................@.@@......@..
@@@@@@@@@@@..@@@@@@@@@@@@@.@................@@.@@.@....
@@@@@@@@@@@@.@@@@@@@@@@@@@@@@....@.............@@.@....
@@@@@@@@@@@..@@@@@@@@@@@@@@@@......@......@...@@@@@....
@@@@@@@@@@@@..@@@@@@@@@@@@@@@.@@@@@@......@@..@@@@@....
@@@@@@@@@@@@@@@@@@@@@@@@@@@@@@@@@.......@@@@@@@@@@@....
8
34 1 0
41 47 0
18 43 0
8 41 0
47 18 0
13 48 0
8 34 0
11 19 0

46 44 0
4 1 0
18 36 0
9 41 0
23 32 0
26 47 0
38 18 0
31 40 0
