width 21
height 21
@@@@@@@@@@@@@@.@..@@@
@@@@@@@@@@@@@@.....@@
@@@@@@@@@@@@@@.....@.
@@@@@@@@@@@@@........
@@@@@@@@@@@@@........
@@@@@@@@@@@@.........
@@@@@@..............@
@@@@@@...............
@@@@...............@@
@@@@...............@@
@@..................@
.....@........@@....@
....@@@...@....@@....
...@@@...............
...@@....@...........
....@....@@..........
.........@@.....@@...
.........@..@.......@
@@..@................
@@...................
@............@@.@..@@
8
17 12 0
8 19 0
16 3 0
10 10 0
5 9 0
11 16 0
16 15 0
6 6 0

0 14 0
18 19 0
16 6 0
1 14 0
7 12 0
9 7 0
14 15 0
8 20 0
