width 21
height 21
@@@@@@@@@@@@@@@@@@@@@
@@@@@@@@@@@@@@@@@@@@@
@@@@@@@@@@@@@@@@@@@@@
@@@@@@@@@@@@@@@@@@@@@
@@@@@@@@@@@@.@@@@@@@@
@@@@@@@@.......@@.@@@
....@.@..............
......@@...@@....@...
.....................
@..............@.....
@.....@.......@@.....
.........@...........
.........@...........
.....................
...................@.
....@@...........@.@@
..@.@...@@..@@@@@@.@@
.........@@@@@@@@@@@@
.........@@@@@@@@@@@@
........@@@@@@@@@@@@@
.......@@@@@@@@@@@@@@
8
6 11 0
10 7 0
3 6 0
10 6 0
8 12 0
2 20 0
9 8 0
14 12 0

20 9 0
3 14 0
20 14 0
4 11 0
20 12 0
2 20 0
5 20 0
19 11 0
