width 21
height 21
@@@@@@@@@@@@@@@......
@@@@@@@@@@@@@@.......
@@@@@@@@@@@@@........
@@@@@@@@@@@..........
@@@@@@@@@@@....@.....
@@@@@@@@@@...@@@@@@@.
@@@@@@@@.....@@@@.@@@
@@@@..@......@@@.....
@@@..................
@@@............@.....
@@............@......
@@..@...........@....
....@..........@..@..
.........@.....@..@..
................@@@@@
.................@@@@
.@@@@......@.@@@.@@@@
..@@@.....@@@@@@@@@@@
..@@......@@@@@@@@@@@
....@.@@..@@@@@@@@@@@
....@@@@@@@@@@@@@@@@@
8
7 18 0
16 12 0
10 12 0
7 17 0
20 2 0
6 17 0
19 10 0
9 9 0

7 9 0
5 14 0
11 5 0
15 14 0
18 3 0
13 12 0
17 0 0
5 7 0
