width 21
height 21
..@@........@@@@@@@@@
.......@.....@@@@@@@@
.............@@@@@@@@
.............@@@@@.@@
..............@@...@@
..............@@..@@@
..................@@@
..................@@@
@.@................@@
@@@@.............@@@@
@@@@.......@....@@@@@
@@@@............@@@@@
@@@@.........@@..@@@@
@@@@..@@.........@@@@
@@@@@@@@@..@.@....@@@
@@@@@@@@@..........@.
@@@@@@@@@.@@@.@......
@@@@@@@@@@@@@@@@.....
@@@@@@@@@@@@@@@......
@@@@@@@@@@@@@@.......
@@@@@@@@@@@@@@@.....@
8
18 15 0
13 8 0
7 2 0
1 0 0
9 16 0
9 6 0
12 3 0
4 12 0

13 15 0
17 20 0
7 5 0
13 13 0
9 16 0
17 17 0
20 18 0
17 5 0
