width 52
height 52
.@...........@@@@@@@......@@.....@@...@@.@@@@@@@@@@@
...............@@@@.......@........@...@.@@@@@@@@@@@
......@........@@@@@...................@...@@@@@@@@@
.@.............@@@@@.......................@@@@@@@@@
..............@@@@@@........................@@@@@@@@
...@.........@@@@@@@@......@..............@...@@@@@@
.............@@@@@@@...........@...@@..@..@....@@@@@
.............@@@..@@...@@@..........@.....@.....@@@@
..............@...@.....@@............@..........@@@
@.............@.......................@....@@....@@@
@.............@......................@@....@.....@@@
.................................@...@@@......@@@@@@
......@............@..........................@@@@@@
...@...........................@@.............@@@@@@
..............@..........@...@@@@.............@@@@@@
...........@.......@....@.....................@@@@@@
..............................@@.@..@........@.@@@@@
.......@@@.......................@.........@@...@@@@
...........................................@@...@@@@
...@....@....@@..........@......................@@@@
...@....@.@@@@.....@......@.@.................@@@@@@
@.......@@@@@@...............................@@@@@@@
@@@@@@@.@@@@@@.@....................@@.......@@@@@@@
@@@@@@@@@@@@@@@@@..........@..........@......@@.@@@@
@@@@@@@@@@@@@@@@@@..@@.......................@@....@
@@@@@@@@@@@@@@@@@............................@@@..@@
@@@@@@@@@@@@@@@..@@...............@......@........@@
@@@@@@@@@@@@@@..............@@@@@@@.............@@@@
@@@@@@@@@..@@@@...............@@@@@.............@@@@
@@@@@@@@@..@@..................@@@@............@@@@@
@@@@@@@@.........................................@@.
@@@@@@@@..@........@@..............@.....@..........
@@@@@@@...........@@....@.........@@................
@@@@@@@@........@@@@....@@..........@@......@@......
@@@@@@@@......@@@@......@@.........................@
@@@@@@@.......@@@@...............................@.@
@@@@@@@......@@@@@@@....................@@@@..@@@@..
@@@@@@@@....@@@@@@@@....@..............@@@@@..@@@@@@
..@@@@@...@..@..........@............@@@@@@@@@@@@@@@
..@@@@@@.................@....@@@@@@@@@@@@@@@@@@@@@@
.....@.........@.@.......@........@@....@@@@.@@@@@@@
...................................@@........@@@..@@
..............................@...@................@
....................@.........@...@..@.@@@..........
.....@........@.............@........@.@@@@@@......@
.............@@.........@............@...@.@......@@
.........@...@@............................@........
........@@..@@@..@........@.........@@@@...@..@....@
.........@@@@@@@@@..................@@@@@@@@@.....@@
.........@@@@@@@@@@..@............@@@@@@@@@@@@...@@@
.....@@...@@@@@@@@@@@@@@..........@@@@@@@@@@@@@@@@@@
....@@@...@@@@@@@@@@@@@....@@@...@@@@@@@@@@@@@@@@@@@
8
45 9 0
16 18 0
31 32 0
19 30 0
21 33 0
14 2 0
30 46 0
15 13 0

7 40 0
42 42 0
25 4 0
22 29 0
6 49 0
12 4 0
20 32 0
8 49 0
