width 52
height 52
@@@@@@@@@@@@@@@@@@.........@@@.................@@@@.
@@@@@@@@@@@@@@@@........@.@@@@@.................@@@.
@@@@@@@@@@@@@@@...@@@.....@@@..........@.........@@.
@@@@@@@@@@@@@@@@@@@@@................@.@.@..........
@@@@@@@@@@@@@@@@@@@@@.................@..@..........
@@@@@@@@@@@@@@@@@@@@@.............@@.....@@.........
@@@@@@@@@@@@@@@@@@@@@....................@@.@@......
@@@@@@@@@@@@@@@@..@...........................@@....
@@@@@@@@@@@@@@@..........@@@@...........@@...@@.....
@@@@@@@@@@@@@@@........@@@@................@.@@@@@@@
@@@@@@@@@@@@@@@@......@@.....................@@@@@@@
@@@@@@@@@@@@.......@....................@.....@@@@@@
@@@@@@.@@@@@.....@............................@@@@@@
@@@@@@..........................@@.@..@@......@@@@@@
@@@@@@.........................@@@....@@......@@@@@@
@@@@@@.........@................@..@...@..@@@.@@@@@@
@@@.........................................@..@@@@@
@@....................@.......................@@@@@@
@@.@@@...........@...@@@........@..............@@@@@
@@@@@@.........@@@...@@@......@........@@.......@@@@
@@@@@.........@@@@....@@.@@@@...................@@@@
..@@..........@@......@@@@.@..@...........@@.@@.@@@@
..................@.....@@.................@.@@.@@@@
.......@@............@.............@..........@@@@@@
.......@@......@.....@.............@......@..@@@@@@@
...........................................@@..@@@@@
...............................@..................@@
..@..@@............@.........@@@.@@................@
@@...@....................@..@.@@@@@.@........@.....
@@........................@....@@@@@@...............
...........@..@...............@@@@@@@....@@@........
..............@@@..............@@@@@@....@@@.....@..
..........@......@@@...........@@@@@@...@@@@@...@@@.
............@@@@..@@@.@........@@@@@....@@@@@.......
...........@@@@@@@@@@@.........@@@@.....@@@@.......@
.@..............@@@@.....................@@@......@@
@@@@......@.....@@@@@.....................@@......@@
@@@@@@........@@@@@@@...@...........@..............@
@@@..........@@@.@@@@@...........................@..
@@@............@...@@@....@@.........@@.......@@@@@.
@..............@@.............@......@@.....@@@@@@@@
........@............@...@............@.@...@@@@@@@@
@.....................@................@....@@@@@@@@
@@...........@@..@...................@@@@@..@@@@@@@@
......@@....@@......@@.@............@@@@@@@@@@@@@@@@
.................@...@..............@@@@@@@@@@@@@@@@
............@........@@@@.........@.@@@@@@@@@@@@@@@@
...............................@..@@@@@@@@@@@@@@@@@@
....@@.............@@@............@@..@@@@@@@@@@@@@@
.....@@................@.@.@@.........@@@@@@@@@@@@@@
@@@...@..@@@@.........@@.@@@@@......@@@@@@@@@@@@@@@@
@@@@@@@@@@@@@@@..@....@@@@@@@@@@....@@@@@@@@@@@@@@@@
8
35 49 0
3 31 0
10 33 0
10 28 0
11 13 0
21 35 0
11 15 0
5 21 0

24 44 0
13 32 0
36 35 0
51 5 0
7 16 0
44 8 0
45 26 0
15 26 0
