width 52
height 52
@@@@@@@@@@@@@@@@@@@@@@@@@@@@@@@@@@@........@..@.....
@@@@@@@@@@@@@@@@@@@@@@@@@@@@@@@@..@..@...@..........
@@@@@@@@@@@@@@@@@@@@@@@@@@@@@@@@...@..........@.....
@@.@@@@@@@@@@@@@@@@@@.@@@@@@@@@....@@....@.........@
.........@@@@@@@@@....@@@@@@@@@...@@@....@@...@....@
..@.....@@@@@@@@@@....@..@@@@@@.....@@@.@@.....@.@..
@..........@@@@@@@...@@..@@@@@@.@...@@@@@@.....@.@..
...........@@..@.@..@.@...@@@........@@@@@.....@....
.@.........@@....@........@@@@.@@@..@...@@....@@....
.....@@..@.......@...@...@@@@@........@....@@@@.....
...........@............@@@@.@..........@@@@@@@.....
.....................@..@@@...........@...@@@@@@@...
.................@........@...............@@@@@@....
.........@.....@@.........@..................@@@....
.........@....@@@...................................
...@@.........@.............................@.......
...@@......@.........@@@@@...@.............@@.....@.
...@..@@.................@......@..........@.....@@@
....@.@@.......@......................@@@@.....@@@@@
..........@...........@@...............@@@@...@@@@@@
.......................................@@@@@@@@@@@@@
@...................................@...@@@@@@@@@@@@
.........@.....................@@...@..@@@@@@@@@@@@@
..@.@@@@@..@...................@@......@@@@@@@@@@@@@
....@@@@.....................@@@@@..@@@@@@@@@@@@@@@@
@....@@@@@...........@.......@@.....@@@@@@@@@@@@@@@@
.....@@@@.........@........@@@@@@...@@@@@@@@@@@@@@@@
......@@@........@@........@@@@@@@@@@@@@@@@@@@@@@@@@
................@@@@........@@@@@@@@@@@@@@@@@@@@@@@@
..................@@@.@.@..@@@@@@@@@@@@@@@@@@@@@@@@@
........................@....@@@@@@@@@@@@@@@@@@@@@@@
....@.........@@.....@..@.....@@@@@@@@@@@@@@@@@@@@@@
@......@....@@@@@@@......@.@@@@@@@...@@@@@@@@@@@@@@@
..........@@@@....@........@@@.......@....@@@@@@@@@@
...........@@@..............@@............@@@@@@@@@@
......@....@@........@......@@............@@@@@@@@@@
......@..............@@......@...........@@@@@@@@@@@
@.....@@.............@@..@@..........@@@@@@@@@@@@@@@
@...@.....@......@@@@@@@@@@@.........@@@@@@@@@@@@@@@
......@..........@@@@@@@@@@@..........@@@@@@@@@@@@@@
......@..........@@@@@@@@@@@@@........@@@@@@@@@@@@@@
@................@@@@@@@@@@@@@........@@@@@@@@@@@@@@
............@@....@@@@@@@@@@@@.........@@@@@@@@@@@@@
.............@@@.@@@@@@@@@@@@@........@@@@@@@@@@@@@@
.@..............@@@@@@@@@@@@@........@@@@@@@@@@@@@@@
..@@@........@..@@@@@@@@@@@@@@@.@@....@@@@@@@@@@@@@@
..@@@............@@@@@@@@@@@@@@@@@....@@@@@@@@@@@@@@
..@@@...........@@@@@@@@@@@@@@@@@@@.@@@@@@@@@@@@@@@@
....@@@.........@@@@@@@@@@@@@@@@@@@@@@@@@@@@@@@@@@@@
@.@@@@@.....@...@@@@@@@@@@@@@@@@@@@@@@@@@@@@@@@@@@@@
@@@@@@......@@..@@@@@@@@@@@@@@@@@@@@@@@@@@@@@@@@@@@@
@@@@@@......@@.@@@@@@@@@@@@@@@@@@@@@@@@@@@@@@@@@@@@@
8
32 14 0
25 20 0
2 3 0
19 32 0
4 29 0
23 34 0
24 28 0
35 15 0

13 22 0
46 16 0
43 1 0
41 11 0
31 36 0
7 16 0
8 37 0
2 36 0
