width 52
height 52
@@@@@@..................@@@.@...@@@@@@@@@@@..@@@@@@.
@@@@@@...................@@......@@@@@@@@@@...@@@.@.
@@@@@.......................@...@@@@@@@@@@@@..@@@...
@@@@@.................@@@.....@@..@@@@@@@@@@..@@@...
@..@..................@...@.@@@@..@@@@@@@@@@..@@@...
....@......@.@.@.....@@...@..@@@..@@@@@.@@@@@.......
...........@@@...@...@@.......@..@@@@@@.@@@@@.......
@@..@..@@@......@@.......................@@@........
@...@..@@.................@...@.........@...........
@@@@@@@@@@@..................................@@..@..
@@@@@@@@@@@............@....................@@@..@.@
@@@@@@@@@@@@....@..............@@@.........@@@@....@
@@@@@@@@@@@@@..........@.......@........@..........@
@@@@@@@@@@@@@..........@...@............@@........@@
@@@@@@@@@@@@@@@@@..............@..@.....@...@.....@@
@@@@@@@@@@@@...@@@......@...............@@.....@@...
@@@@@@@@@@@....@@.......................@@..........
@@@@@@@@@@@@.........@@.................@@@@........
@@@@@@@@@@@@.............................@@@..@....@
@@@@@@@@@@@@@.............@.@...........@.@...@.@...
@@@@@@@@@@@.....@....@........................@@....
@@@@@@@@@@@.........................................
@@@@@@@@@@...@@.@@@.............@@..................
@@@@@@@@@@......@@@..............@@.................
@@@@@@@@@@......@@@......@..@@....@...@@.......@@@@@
@@@@@@@@@@....@@@@...@@...............@@@......@@@@@
@@@@@@@@@@@..@@@.....................@@@@@@....@@@@@
@@@@@@@......................@.....@@@@@@@@@@@@@@@@@
@@@@..@...@@@.........@@.....@......@@@@@@@@@@@@@@@@
@@@@@.......@..@@@@@@..............@@@@@@@@@@@@@@@@@
@@@@@@@....@@...@@@@.....@.........@@@@@@@@@@@@@@@@@
@@@@@@@..........@...@...@.......@.@@@@@@@@@@@@@@@@@
@@@@@@@.....................@..@....@.@@@@@@@@@@@@@@
@@..@@@...............................@@@@@@@@@@@@@@
@@......@...............................@@@@@@@@@@@@
@@@..................................@..@@@@@@@@@@@@
@@@.........................@.....@@@@..@@@@@@@@@@@@
@@@...@...@@.....@..@@.........@.@@@@@@@@@@@@@@@@@@@
..@.......@@.....@@................@@@@@@@@@@@@@@@@@
......................@............@@@@@@@@@@@@@@@@@
......................@............@@@@@@@@@@@@@@@@@
...................................@@@@@@@@@@@@@@@@@
@@@@@............@...........@@@@@@@@@@@@@@@@@@@@@@@
@@@@@...............@.@......@@@@@@@@@@@@@@@@@@@@@@@
@@@@@......@..........@.....@@@@@@@@@@@@@@@@@@@@@@@@
@@@@@@@....@..........@.....@.@@@@@@@@@@@@@@@@@@@@@@
@@@@@......@.............@@...@@@@@@@@@@@@@@@@@@@@@@
@@@@@..........@....@@@@@@@@@@@@@@@@@@@@@@@@@@@@@@@@
@@@@..............@@@@@@@@@@@@@@@@@@@@@@@@@@@@@@@@@@
@@@@............@@@@@@@@@@@@@@@@@@@@@@@@@@@@@@@@@@@@
@@@@..........@.@@@@@@@@@@@@@@@@@@@@@@@@@@@@@@@@@@@@
@@@@@@@......@@@@@@@@@@@@@@@@@@@@@@@@@@@@@@@@@@@@@@@
8
11 36 0
41 14 0
10 25 0
15 13 0
21 45 0
44 19 0
50 5 0
13 2 0

44 1 0
15 42 0
10 22 0
6 48 0
31 35 0
8 35 0
49 1 0
44 16 0
