width 52
height 52
...........@@@@@@@@@@..@@@@@.......@@@@@@@@@@@@@@@@@
...........@@@@@@@@@@@.....@.......@@@@@@@@@@@@@@@@@
...........@@@@@@@@@@.........@....@@@@@@@@@@@@@@@@@
............@@@@@@@@..........@...@@@@@@@...@@@@@@@@
.......@....@@@@@@@@.......@.....@@@@@@@@...@@@@@@@@
...@.........@@@@@@@......@@......@@@......@@@@@@@@@
...@.........@@@@@@@.........@......@@.....@@@@@@@@@
@............@@@@@@@..@....................@@@@@@@@@
..............@....@..@@...@......@........@@@@@@@@@
.....................@..........@........@@@@@@@@@@@
.@..................@@.........@@.........@@@@@@@@@@
....................@@@@........@...@.....@@@@@@@@@@
........@..@.......@@@.......@@.....@@.....@@@...@.@
@..............@@@.@@@@@@.......@...@@....@@@@...@.@
@@.............@@@..@@...........@.........@@@.....@
@@................@...........@.@..................@
@@..............@@.@............@..........@.@@@...@
@@...............@.......@@.@...@...........@@@.....
@@....@.........@...............@.............@@....
@@.........@@.............@@.......................@
@@....@@...@@........@@...@........................@
..........@@@..........@@@@@@............@@........@
..........@@@............@@@@@..@@@.....@@........@@
...........@@........@...@@.....@.....@@@@........@@
........@..@.......@.@@...............@@@.........@@
.....................@@@.............@@@@.........@@
.....@................@....@...@@....@............@@
.....@@@..........................................@@
.......@.......................................@...@
...@.......@@......@@..........@@......@...........@
@..@................@@.........@@@................@@
@............@.....@@@........@@.....@...@@........@
...........@.@...@.@@@@....@.........@.....@@......@
..................@@@@.....@............@.@@........
...........@@......@@.@.@...........................
.@.........@@@@...@@@.......@@......................
.........@@@@@@....@........@@@@.....@........@.....
............................@@@@....................
............@@@@...........@@@@@@.............@.....
.....@........................@@@@....@.............
..........................@@...@@.............@.@@..
...............@@@@@.....@.....@@@@@................
..@......@@....@@.@@...........@@@@@.....@@.........
........@@@..@....@.................................
.@......@.........@......@.........@................
.@.......................@@.........................
......@............@.....@@@........................
.....@........@@............@@......................
@@@@........@@@@........@.@.......................@.
@@@@@@........@..@@@......@....................@....
@@@@..........@@@@@.........@@@..@@@.@..............
@@@@@@@@..@@@@@@@@@@.@.....@@@@...@..@.@@..@@@....@.
8
0 44 0
34 17 0
4 26 0
3 37 0
35 6 0
17 19 0
12 39 0
33 32 0

17 35 0
34 16 0
22 3 0
45 34 0
40 42 0
6 49 0
11 39 0
39 33 0
