width 52
height 52
@@@@@@@@@@...........@@@........@@@@@@@@@@@@@@@@@@@@
@@@@@@@@@@...........@@@@.......@@@@@@@@@@@@@@@@@@@@
@@@@@@...............@@@..........@@@@@@@@@@@@@@@@@@
@@@@@@............................@@@@@@@@@@@@@@@@@@
@@@@@....@......@.................@@@@@@@@@@@@@@@@@@
@@@@...........@@.................@@@@@@@@@..@@@@@@@
@@@@..........@@@.@.................@..@.......@@@@@
@@@............@@.@....................@.......@@@@@
@@@...............@...@.......@...@@..........@@@@@@
@@@.............@@@@@.@@..........@@@.........@@@@@@
@@@.....@@...@@@@@@@@@@@....................@@@@@@@@
@@@@@...@@..@@@@@@@@@@@@@.@............@@....@@@@@@@
@@@@....@@..@@@@@@@@@@@....................@.@@@@@@@
.........@....@@@@@@@@.......................@@@@@@@
..@...........@@@@@@@@..........@.............@@@@@@
..............@@@@@@@@............@...........@@@@@@
...........@..@@@@@@..............@.....@.....@@..@@
......@........@@@@@..@@@@..@@.............@.......@
..@@........@@.@@@....@@@@........@@...........@..@@
@@@.........@@@@@@....@@@........@@@..@.....@.......
@@@.....@......@@......@....@@@..@@@@@@..........@..
@@@...@@@..............@...@@@@@@@@@@@..............
@@....@@@@@@......@.....@.@@@@@@@@...@.....@........
.....@@@@@@@...............@@@@@@...................
......@@@@@@@.............@@@@@.@.....@.............
@@@@.@@@@@@@@@............................@@@.......
@@@@@@@@@@@@@@...@........@...............@@@.......
@@@@@@@@@@@@@@..............................@..@@...
@@@@@@@@@@@@@@......@@........................@@@...
@@@@@@@@@@@@@@.@..@.@@.@.......@....@@...@.....@...@
@@@@@@@@@@@@@@@@..@@......@@...@....@@...@@@.......@
@@@@@@@@@@@@@@@@..@@......@@@..@...@@....@@@....@...
@@@@@@@@@@@@@@@@..........@@@@.@...@@...@@@@......@.
@@@@@@@@@@@@@@@...........@@@@.........@@@@@.......@
@@@@@@@@@@@@@@@....@.....@@..........@@@@@@..@......
@@@@@@@@@@@@@@@..........@..............@...........
@@@@@@@@@@@@@@@...........................@@..@.....
@@@@@@@@@@@@@..............................@........
@@@@@@@@@@@@@@@@@@..................................
@@@@@@@@@@@@@@@@@.............@.......@@............
@@@@@@@@@@@@@@@@..............@.......@@@@@@@@..@@..
@@@@@@@@@@@@@@@@......................@@@@.@@@......
@@@@@@@@@@@@@@@............................@@.......
@@@@@@@@@@@@@@@@..............@.....................
@@@@@@@@@@@@@@@@........@...........................
@@@@@@@@@@@@@@@.............@@@....@..@@............
@@@@@@@@@@@@@@@@......@@@....................@@.....
@@@@@@@@@@@@@@@@.......@@.......@............@......
@@@@@@@@@@@@@@@@@@@@@@@@@......@@..........@@@......
@@@@@@@@@@@@@@@@@@@@@@@@@@......@@@@...@...@@@....@@
@@@@@@@@@@@@@@@@@@@@@@@@@@......@@.....@...@@@@@....
@@@@@@@@@@@@@@@@@@@@@@@@@@@....@@@.....@@@@@@@@@....
8
47 49 0
42 47 0
30 35 0
6 18 0
32 32 0
41 37 0
48 30 0
34 13 0

21 25 0
32 7 0
22 30 0
9 14 0
30 25 0
15 9 0
22 29 0
41 49 0
