width 52
height 52
..@..........@@.....@......@@@@@@@@@@@.......@@@@@@@
...........................@@@@@@@@@@@@........@@@@@
....@...................@....@@@@@@@@.@.........@@@@
....@........................@@@.@@.............@@@@
.....@@.......................@...@............@@@@@
...............................................@@@@@
@@....................@@@.......................@@@@
@..........@..........@@@@.....................@@@@@
@.........@@@.........@@@@@.............@.....@@@@@@
@..@@......@@......@@.@@........@@@.....@@.....@@@.@
@@@@@.....@@@......@@.@@...........@@...@@.@...@@@.@
@@@@@....@@..@...@..@.........@.....@@......@......@
@@@@@@...@.......@@@@................@.............@
@@@@@............@@@@@............@.........@......@
@@@@@............@@@@...............@...@..........@
@@@@@............@@@@...............................
@@@@........@@...@@@..................@@@..........@
..@@........@.....@@..@@.......@@......@@...........
..@@@.............@............@@.....@@.....@@.....
...............................@@..................@
......@..........@.....@...@.............@@.....@...
......@@.................................@@........@
...........@.......@@..............................@
.............................@.......@..............
.@...............@@@.....@...@..........@....@...@..
.................@@@@...............................
................@@@@@@...................@@@........
................@@@@@@@...............@@@@@@@.......
@@@............@@@@@@@@..@........@...@@@@@@@@@....@
@@@@......@.......@@@@@...@.......@..@@@@@@@@@@.....
@@@.......@.......@@@............@@@@@@@@@@@@@@.....
@@@@......@@...@@.............@@@@@@@@@@@@@@@@@...@@
@@@@..............@...........@@@@@@@@@@@@@@@@@@@@@@
@@@@.@.........@...............@@@@@@@@@@@@@@@@@@@@@
@@@............@@@..@@@........@@@@@@@@@@@@@@@@@@@@@
@@@.......@....@....@@@@........@@@@@@@@@@@@@@@@@@@@
@..............@....@............@@@@@@@@@@@@@@@@@@@
@@@@@........@@@@@@...............@@@@@@@@@@@@@@@@@@
@@@@@@@......@@@@@@@.........@....@@@@@@@@@@@@@@@@@@
@@@@@....@@.@@@@@@@@..@.........@@@@@@@@@@@@@@@@@@@@
@@@@@..@.@..@@@@@@@@.........@.@@@@@@@@@@@@@@@@@@@@@
@@@@@.......@@@@@@@@.........@..@.@@@@@@@@@@@@@@@@@@
@@@@.......@@@@@@@@@..............@@@@@@@@@@@@@@@@@@
@@@@.......@@@..@@@@.........@@.....@@@@@@@@@@@@@@@@
@@@..@......@...@@@@.........@......@@@@@@@@@@@@@@@@
@@@@@@...........@@.................@@@@@@@@@@@@@@@@
@@@@......@....@...........@@@.....@@@@@@@@@@@@@@@@@
@@@@.......@@.....@........@@@.@@.@@@@@@@@@@@@@@@@@@
@@...............@@........@@@@@@...@@@@@@@@@@@@@@@@
@...............@@@.......@@@@@@....@@@@@@@@@@@@@@@@
@..........@......@...........@@..@@@@@@@@@@@@@@@@@@
@@.....................@..@@..@@..@@@@@@@@@@@@@@@@@@
8
37 14 0
23 31 0
11 32 0
1 17 0
44 22 0
39 23 0
9 6 0
16 24 0

36 28 0
0 5 0
48 12 0
8 34 0
4 30 0
33 6 0
33 46 0
6 48 0
