width 52
height 52
@@@@@@@@@@@@@@@@@@@...........@@@@@@@@@@@@@@@@@@@@@@
@@@@@@@@@@@@@@@@@@@...........@@@@@@@@@@@@@@@@@@@@@@
@@@@@@@@@@@@@@@@@@@...........@@@@@@@@@@@@@@@@@@@@@@
@@@@@@@@@@@@@@@@@@@@@........@@@@@@@@@@@@@@@@@@@@@@@
@@@@@@@@@@@@@@@@@@@@@.........@@@@@@@@@@@@@@@@@@@@@@
@@@@@@@@@@@@@@@@@@@@@@........@@@@@@@@@@@@@@@@@@@@@@
@@@@@@@@@@@@@@@@@@@@@.........@@@@@@@@@@@@@@@@@@@@@@
@@@@@@@@@@@@@@@@@@@@@@...........@@@@@@@@@@@@@@@@@@@
@@@@@@@@@@@@@@@@@@@@@...@........@@@@@@@@@@@@@@@@@@@
@@@@@@@@@@@@@@@@@@@@@............@@@@@@@@@@@@@@@@@@@
@@@@@@@@@@@@@@@@@@@@............@@@@@@@@@@@@@@@@@@@@
@@@@@@@@@@@@@@@@@@@@......@.@...@@.@@@@....@@@@@@@@@
@@@@@@@@.....@@@.@@@........@@.....@@......@@@@@@@@@
@@@@@@...........@@................@@@.....@@@@@@@@@
@@@@@@......@....@@.....@..........@.@@....@@@@@@@@@
.@@@@.......@...............................@@@@@@@@
......@...@...@@..........................@.@@@@@@@@
...@.......@...@@...........@@......@.....@@@@@@@@@@
.....@@.@.................@@@@......@.......@@@@@@@@
...........................@................@@@@@@@@
@@@@@.............@..@.....................@@@@@@@@@
@@@@@............@.@.....@.@.@@@............@@@@@@@@
@@@@@@@..........@...........@@@..........@...@@@@@@
@@@@@@.......................................@@@@@@@
@@@@@@.....@................@......@.....@@@@@@@@@@@
@@@@@@@@........@................@@..@@...@@@@@@@@@@
@@@@@@@@.@......@....@.......@.......@@.....@@@@@@@@
@@@@@@@...........@............@.....@@...@@@@@@@@@@
@@@@@@@...@.........@@.........@.....@....@@@@@@@@@@
@@@@@@@..@@......@..@@...@.....@........@@@@@@@@@@@@
@@@@.............@..@..........@@@......@@@@@@@@@@@@
@@@@@...@........@..@..........@@@......@@@@.@@@@@@@
@@@@@.@@@@.......@..@..@..@............@@@@@.@@@@@@@
@@@...@@@@@...................................@@@@@@
@@.....@@@@.................@@................@@@@@@
@@..................@.......@...........@@@..@@@@@@@
@@........@.......@@@.......@@..........@.....@@@@@@
@@.....@@@...................................@@@@@@@
@......@@.......@.............................@@@@..
@......@@..@....@......@.......................@@@..
@...@@...........@................@.@...........@...
@....@.................@@@.....@..@@@....@......@...
@...@@...........@.....@.......@..@@............@...
......@...............................@..@@@.......@
.@.................@....................@@@@@@..@@@@
........................................@@@@@@...@@@
....@..............@....................@@@@@@@@@@@@
....................@..........@@......@@@@@@@@@@@@@
@.........@@........@........@@@@......@@@@@@@@@@@@@
..........................@.@@@@@@@....@@@@@@@@@@@@@
............................@@@@..@.....@@@@@@@@@@@@
...............@..@@....@@@@@@@@....@@.@@@@@@@@@@@@@
8
51 40 0
8 28 0
37 23 0
40 21 0
14 38 0
16 50 0
10 47 0
32 7 0

35 47 0
38 51 0
14 51 0
18 50 0
30 8 0
21 8 0
14 45 0
0 51 0
