width 51
height 51
..@@@@@@@...@....@@@@@@@@@@@@@@@@@....@@@@@@@@@@@@@
@..@@@@@.........@@@@@@@@@@@@@@@@@..@@@@@@@@@@@@@@@
@..@@.@@.........@@@@@@@@@@@@@@@@@..@@@@@@@@@@@@@@@
@@..............@@@@@@@@@@@@@.@@@@..@@@@@@@@@@@@@@@
...............@@.@.....@@@@@..@....@@@@@@@@@@@@@@@
...............@@.........@@@........@@@@@@...@@@@@
@..............@@...........@........@@@@@...@@@@@@
@@@@...........@.....................@@@@...@@@@@@@
@@@@@..........@@........@...@@......@.......@@@@@@
@@@@@@..@@@....@.......@........@...@........@@@@@@
@@@@@@..@........@........@..................@@@@@@
@@@@@.....................@@.................@@@@@@
@@@@@@....................@@.................@@@@@@
@@@@@@..............@.....@@..............@..@@@@@@
@@@@@@@........@@..........@..............@@@@@@@@@
@@@@@@@........@@........@@@.........@....@@@@@@@@@
@@@@@@@@.......@@.....@@.@@@.........@......@@@@@@@
@@@@@@@@........@.......................@......@@@@
@@@@@@@@................................@.....@@@@.
@@@@@.@..@........@.......@...........@@@..........
@@@@.....@........................@.....@..........
@@@@................@.......@..........@@@......@..
@@@@.............@...................@@@...........
.........@@...@..................@............@....
.........@...@@.........@@.....@.@@................
.................................@@@..@@@@@......@@
..................................@...@@@@@@@....@@
.........@...........@..........@.....@@@@@@@@@...@
@@.......@@..@...............@@@@.......@@@@@@@.@@@
@@....@............@.........@..@....@......@@@@@@@
@@@.......@......@.@...........................@@@@
@...............@@@.............................@@@
...........@......@.............@.@@.......@....@@@
..............@........................@..@@.....@@
.........................................@@@......@
@@............@..........................@@@....@@@
@@@...@@......@@............@............@@@.@.....
@........@...@@@.@@@@.............@...@@@@@@.......
.........@........@@@...............@@@@@@@@@@@....
@@@..........@.......@@...............@@@@@@@@@@...
@@@@.................@@.......@.......@@@@@@@@@@@..
@@@@@@...............@@..............@@@@@@@@@@@@..
@@@@@@@............@.@@.....@........@@@@@@@@@@@@@.
@@@@@@@@@@..........@@@.............@@@@@@@@@@@@@@.
@@@@@@@@@@..........@.@.............@@@@@@@@@@@@@..
@@@@@@@@@@..@..............@@...@.@.@@@@@@@@@@@@@@@
@@@@@@@@@@..@.......@...@@@@@...@...@@@@@@@@@@@@@@@
@@@@@@@@@@@@@@@.........@@@@@@.......@@@@@@@@@@@@@@
@@@@@@@@@@@@@@@.........@@@@@@.......@@@@@@@@@@@@@@
@@@@@@@@@@@@@@@@@.........@@@@....@@.@@@@@@@@@@@@@@
@@@@@@@@@@@@@@@@@..@@.@@@@@@@@....@@@@@@@@@@@@@@@@@
8
10 45 0
18 28 0
12 37 0
48 38 0
15 25 0
12 2 0
31 14 0
19 10 0

43 12 0
31 46 0
10 36 0
12 14 0
35 16 0
22 49 0
37 31 0
18 11 0
