width 51
height 51
@@..@@@@@@...@@@@@@@@@.@@@@@.@@@@@@@@@@..@@@@@@@@@@
@@@.@@@@@.....@@@@@@....@@@..@@@@@@@@@@..@@@@@@@@@@
@@@..@@@@.....@@@@@@....@@@..@@@@@@@@@.....@@@..@@@
@@@............@@@@@.........@@@@@@@@@.....@@@.....
@@@@@..........@@@@@.......@@@@@@@@.@....@.@@......
@@@@...@..@....@@@@........@@@@@@.......@@.@@..@...
@@@@............@@.........@@.@@........@@@@...@@..
@..@......@.....@@.........@@...........@..........
@.......................@@.@@......@..@@@@@..@...@@
......................................@@@@@..@...@@
@.@@@....@.....@@@....@@..@...........@@@@@@......@
@@@@@@...@....@@@@.....@...............@@.........@
@..@@..........@.....................@.............
...........................@.......................
.@.......@...@......@@.....@.........@.............
...................................................
.........................@@@................@@.....
@@@@.......@.............@@@....@......@.@..@......
@@@@..............@.......@@...........@@@@..@.....
@@@@..............@@@@@@@@@@@..........@@......@@@.
@@@@@..........@@..@@.@@@@@@@.........@@@@.........
@@@@...........@@..@...@@@@...........@@@@....@....
@@@...........@@@......@@@@.....@......@@...@.....@
@@@@........@.@@@......@@@@@@.........@...@@......@
@@@@@.@................@@@@................@@.....@
..@@@@@@...............@@@.......@@........@@@...@@
..@@@@@................@..............@@@.......@@@
.....@................@......@@.......@@@.......@@@
..........@.........................@@@@@.......@@@
@@@.......@................@.......@.@@@@@@..@@.@@@
@@..............@.............@..@...@@@@@@.......@
@@....................................@@@@@......@@
@...............@.........@...........@@@@@.......@
@@.....@.................@@@@....@............@..@@
@.............@.....@@@@.@@@@.............@....@.@@
..........@..@@.....@@@@.......................@@@@
.............@.....@@@@@......................@@@@@
...................@@@@@.......@..@@@........@@@@@@
........@@........................@@@@......@@@@@@@
.@......@@....@@@....@....@@.......@@@.......@@@@@@
.......@@@....@@.......@@.........@@@@@.......@@@@@
@.......@@.............@@...@.....@@@........@@....
@@@........@........@.............@@.@.............
@@..@@..........@..........@.........@.............
.................@.........@.........@@.....@@@@@@.
..............@@@@@@.................@@......@@@@@.
..............@@@@@..@..............@@@@...@@@@@@@@
@....@.......@@@@@@........@.......@@@@...@@@@@@@@@
@..............@..............@....@@@@@.@@@@@@@@@@
@@@@...............................@@@@@@@@@@@@@@@@
@@@@@@.......@...................@@@@@@@@@@@@@@@@@@
8
2 39 0
48 15 0
36 24 0
13 6 0
23 32 0
41 13 0
34 33 0
31 10 0

2 39 0
3 48 0
37 11 0
38 42 0
19 5 0
6 39 0
5 22 0
38 35 0
