width 51
height 51
@@@@@@@@@@@@@@@@@@@@@@@@@@@@@@@@@@@@@@@@@@@@@@@@@@@
@@@@@@@@@@@@@@@@@@@@@@@@@@@@@@@.@@@@@@@@@@@@@@@@@@@
@@@@@@@@@@@@@@@@@@@@@@@@@@.@@@@.@@@@@@@@@@@@@@@@@@@
@@@@@@@@@@@@@@@@@@@@@@@@@@.......@@@@@@@@@@@@@@@@@@
@@@@@@@@@@@@@@@@@@@@@@@@@@@......@@@@@@@@@@@@@@@@@@
@@@@@@@@@@@@@@@@@@@@@@@@@@@@.....@@@.@@@@@@@@@@@@@@
@@@@@@@@@@@@@@@@@@@@@@@@@@@@@..........@@@.@@@.@@@@
@@@@@@@@@@@@@@@@@@@@@@@@@@@@@@.........@@........@@
@@@@@@@@@@@@@@@@@@@@@@@@@@@@@@.........@@.....@..@.
@@@@@@@@@@@@@@@@@@@@@@@@@@@@@.......@...@.@........
@@@@....@@@@@@@@@@@@@@@@@@@@@.......@@.............
@@.....@@@@@@@@@@@@@@@@@@@@@@@.@..................@
.......@@@@@@@@@@@@@@@@@@@@.......................@
..........@@.....@@@@@@@@@@@..@..................@@
..............@@.@@@@@@@@@@@@@@....@...@@.@@.....@@
...............@@@@@@@@@@@@@@@@....@...@@.@@.....@@
..............@@@@@@@@@@@@@@@@............@......@@
................@@@@....@@@@.........@......@.....@
.....@..........@@@@....@@@....@.....@.@@......@@..
................@@@@....@@@....@.....@@@@@.........
..................@@@....@@@.........@@@@@.....@...
...................@@....@@@@........@@@@@@@...@...
......@..@@@@......@....@@@@@.......@@@@@@.........
..@......@@@@@..........@...........@@@@@@......@..
@.......@@@@@@........@...........@@@@@@....@...@..
@@...@...@@@@.............@....@@.@@@@@@@@.........
............@............@@@....@@@@...............
............@....@...........@...@@................
.@@.......@@@@...................@.....@...........
.........@@.@@@........................@@..........
@.........................@........@..@@@@@........
@@....@...............................@@@@@@@......
@@......@.....@......@...................@@@@@@...@
@@.......@...........@............@@@.@@@@@...@....
@@..............@.....@......@@@@.@@@@@@@@@@.......
@@..............@.............@@@@@@@@@@...........
@@@........@..@@@@............@..@@@@@@@...........
@@@.....@..@...@@...@............@@@@@@@@.........@
@@@...........@@.............@@.@@@@@@@@@.@.......@
@@@@@@....@@.@@@@@@@@@@......@@...@@@@@@@@.........
@..@.....@@@@@@@@@@@@@@...........@@@@@............
@..@...@@@@@@@@@@@@@@@@..............@@....@.......
@.....@@@@@@@@@@.@@@@................@@.....@@.....
@.....@@@@@@@@@@.@@@@.....@........................
@...@@@@@@@@@@@@.@@@@@....@......................@@
@...@@@@@@@@@@@@....@@...............@.........@..@
....@@@@@@@@@.......................@@............@
...@@@@@@@@@@..............@...@@@@@@@......@.....@
.@@@@@@@@@@@@......@@@.........@@@@@@@@............
.@@@@@@@@@@@........@@@@.........@@@@@@@@@.........
@@@@@@@@@@@@@@......@@@@@....@@@@@@@@@@@@@@@.......
8
1 18 0
39 47 0
48 27 0
19 49 0
32 15 0
24 49 0
18 37 0
11 17 0

35 10 0
4 25 0
15 50 0
21 27 0
2 44 0
48 40 0
21 37 0
44 28 0
