width 20
height 26
....................
......@....@........
@...................
@...................
..............@.....
....@.......@...@...
.....@..............
........@...........
..............@.....
.....@..@.@.........
................@...
.@....@.............
..................@.
......@.....@....@..
........@...........
.............@......
..@.................
......@........@....
..@.@.........@..@..
.......@...@........
..@...............@.
..............@.....
..@.................
.....@..............
.......@..@......@..
@...................
6
2 4 0
11 0 0
5 1 0
10 16 1
14 10 1
0 17 1

4 10 0
9 1 0
9 6 0
0 10 1
7 13 1
5 14 1
