width 20
height 26
..........@.........
........@.....@.....
............@...@...
....................
......@.@....@......
....@.........@.....
.......@............
....@........@.....@
...@...............@
............@@.....@
.@...@...@....@...@@
..@....@...........@
...................@
....@.@............@
..........@..@....@@
.........@........@@
..@....@..@..@....@.
......@...........@.
...@.........@......
......@.@......@....
..........@..@......
...@...@@...........
....@...............
.................@..
..............@.....
@..@@...............
6
11 8 0
5 7 0
11 7 0
12 21 1
17 16 1
17 20 1

11 4 0
19 25 0
18 11 0
18 9 1
0 0 1
7 20 1
