width 20
height 26
...........@........
.........@.....@....
@.@...@.............
..........@.@.......
.......@............
...@...@............
.......@.@..@.......
.@....@.....@.......
.............@...@..
....@@..............
............@.@.@...
....................
....@...@.@.........
....................
........@...........
...............@....
.@..@......@....@...
....................
...........@....@...
........@...........
..@..............@..
......@.@.@.....@...
....................
.......@.....@......
@...................
@.........@@........
6
5 8 0
0 21 0
19 0 0
9 5 1
12 15 1
11 2 1

1 22 0
18 21 0
12 2 0
10 17 1
1 4 1
10 7 1
