width 20
height 26
......@@............
...........@........
...............@....
............@.......
........@.....@.....
.............@......
...@...@........@.@.
.................@..
.............@......
.......@.@..........
...............@....
.......@......@.....
....@.......@.......
...............@....
....@.@...@@........
....................
@@..................
..@........@.@.@...@
....................
.........@..........
....@..........@....
..........@.........
.............@......
...@.....@......@...
..........@....@....
.............@......
6
18 8 0
13 13 0
11 5 0
13 23 1
10 23 1
8 3 1

1 25 0
9 14 0
16 9 0
1 14 1
5 24 1
3 22 1
