width 20
height 26
.......@............
.............@......
....................
.............@...@..
.....@..@.@.@.......
...@................
...............@..@.
.....@..@.@.........
..@.................
....@.@...@.....@.@.
.@......@...@..@....
....................
.........@...@......
.@...............@.@
...@....@...........
...........@....@...
....................
....@.....@.........
.......@....@.@...@.
....@...........@...
...@................
......@...@.........
..@.................
.....@..............
......@.............
@.....@@.@.......@@.
6
6 8 0
11 23 0
2 15 0
12 24 1
19 22 1
15 18 1

5 9 0
9 17 0
3 12 0
17 23 1
2 1 1
1 9 1
