width 20
height 26
........@...........
....@...............
.@..................
..........@.........
......@.............
............@..@....
@.@......@.@........
..........@..@....@.
...@................
........@....@......
.......@...........@
.@......@...........
...@.......@.@.@....
........@.........@.
.......@...@........
.@..@..@.......@....
.........@...@......
....@........@..@...
........@..@.......@
.@.......@..........
...@.@.....@.....@..
.............@......
..............@.....
..@.......@.@.......
..................@.
....................
6
6 2 0
10 5 0
14 8 0
1 21 1
13 19 1
12 0 1

7 3 0
18 15 0
5 2 0
19 12 1
13 19 1
2 10 1
