width 47
height 47
@@@@@@@@.@@@..@@@@@@@@@@@@@........@@@@@@@@@@@@
@@@@@@@@.@@.....@@@..@@@@@@@........@@@@@@@@@@@
@@@@..............@@..@@@@............@@@@@@@@@
@@@@..............@@..@@@@@................@@@@
.....@..................@@@@...............@.@.
@@........................@@.............@.....
@@@.......................@....................
@@@....@........@..............................
@@@...@.........@.@..........................@@
........@.....@.@.@........@.@@@.@........@@@@@
@...@@..........@......@...@.@...........@@@@@@
..........@............@.....@............@@@@@
@@@............@.........@@@@@.............@@@@
......@...................@................@@@@
....@......@@.......@....................@.@@@@
...@@@......@..@@......................@.@@@@@@
....@@......@@@@@...............@......@@@@@@@@
....@@......@@@@........................@@@@@@@
.............@@@.....@@.................@@@@@@@
.......@@..@........@@@....................@@@@
........@@@........@@@@....................@@@@
.......@@@@@.......@@@....................@@@@@
..........@..........@.......................@@
.....@......................................@@@
.....@...............@....@.....@...........@@@
........@.....@.....@@....@@..............@..@@
........@.....@............@@............@@@@@@
........@...@..........@@..@@............@@@@@@
.....@......@@.........@....@..........@@@@@@@@
...@@@.....@@@@@.......@@............@.@@@@@@@@
....@.....@@@@@@......@@@.........@@@@@@@@@@@@@
@...@.....@@@@@@@.....@..........@@@@@@@@@@@@@@
...........@@@@@@...........@@@@@@@@@@@@@@@@@@@
.....@.....@@@@@@@@@...@@@@@@@@@@@@@@@@@@@@@@@@
@...@@.....@@@@@@@@.....@@@@@@@@@@@@@@@@@@@@@@@
@@..@@.....@@@@@@...@.@@@@@@@@@@@@@@@@@@@@@@@@@
@@@@@@.....@@@@@@.........@@@@@@@@@@@@@@@@@@@@@
@@@@@..@.@@@@@@@@@@@...@@@@@@@@@@@@@@@@@@@@@@@@
@@@@@..@@@@@@@@@@@@@@@.@@@@@@@@@@@@@@@@@@@@@@@@
@@@@@@..@@@@@@@@@@@@@..@@@@@@@@@@@@@@@@@@@@@@@@
@@@@@@@@@@@@@@@@@@@@@@..@@@@@@@@@@@@@@@@@@@@@@@
@@@@@@@@@@@@@@@@@@@@@@@@@@@@@@@@@@@@@@@@@@@@@@@
@@@@@@@@@@@@@@@@@@@@@@@@@@@@@@@@@@@@@@@@@@@@@@@
@@@@@@@@@@@@@@@@@@@@@@@@@@@@@@@@@@@@@@@@@@@@@@@
@@@@@@@@@@@@@@@@@@@@@@@@@@@@@@@@@@@@@@@@@@@@@@@
@@@@@@@@@@@@@@@@@@@@@@@@@@@@@@@@@@@@@@@@@@@@@@@
@@@@@@@@@@@@@@@@@@@@@@@@@@@@@@@@@@@@@@@@@@@@@@@
8
40 5 0
21 10 0
29 31 0
17 7 0
28 21 0
38 14 0
27 29 0
33 21 0

1 25 0
27 14 0
0 4 0
16 6 0
31 8 0
37 3 0
5 2 0
3 4 0
