width 47
height 47
@@@@@@@@@@@@@@@@@@@@@@@@@@@@@@@.....@@@@..@@@@@
@@@@@@@@@@@@@@@@@@@@@@@@@@@@...@@.@..@@@..@@.@@
@@@@@@@@@@@@@@@@@@@@@@@@@@@....@@@@...........@
@@@@@@@@@@@@@@@@@@@@@@@@@@...................@@
@@@@@@@@@@@@@@@@@@@@@@@@@@@.................@@@
@@@@@@@@@@@@@@@@@@@@@@@@@@...................@.
@@@@@@@@@@@@@@@@@@@@@@@@@............@.@@@.....
@@@@@@@@@@@@@@@@@@@@@@@.@...........@@..@@.....
@@@@@@@@@@@@@@@@@@@@@@@........@...@.......@@@.
@@@@@@@@@@@@@@@@@@@@@@...@...................@.
@@@@@@@@@@@@@@@@@@@@@....@@@@.........@@.......
@@@@@@@@@@@@@@@@@@@@@.....@@@.........@.......@
@@@@@@@@@@@@@@@@@@@@........................@..
@@@@@@@@@@@@@@@@@@@..............@@@...........
@@@@@@@@@@@@@@@@@@@..............@.............
@@@@@@@@@@@@@@@@@@@....@@......................
@@@@@@@@@...@..@.@..............@@@............
@@@@@@@@....@..@..@..............@@.......@@...
@@@@@@@@@@........@.....@@..........@..........
@@@@@@@@@@....@...@.....@.@.......@.@..........
@@@@@@@.@@@@...........@.......................
@@@@....@@.............@......@................
@@@@@@..........@.@..@.........................
@@@@@@@@@@@@@..............@..@@@.............@
@@@@@@@@@@@@@............@@@....@@.......@.....
@@@@@@@@@@@@.............@@.........@@.........
@@@@@@@@@@@@.....@.............................
@@@@@@@@.....@.............@...........@@...@.@
@@@@@@@@.........................@.....@@...@.@
@@@@@@@@.....@...................@@....@@..@@.@
..@@@@@@.........................@...@@@@..@@.@
..@@@............................@@..@@....@.@@
....@...........@@....@@.........@......@....@@
.........@............@@@@@@.....@@@.........@@
.......................@@@@@@....@@....@@..@@@@
@.......................@@@@....@............@.
@..............@..........@@.........@.........
@..................@@..........................
.........@@........@@......@.......@...........
.........@@@@......@.........@.....@...........
.....@..@@@@@@@....@...........................
.@...@@..@@@@@@.@@..................@@@........
.........@@@@@@@@@..........@.@.....@..........
@@....@..@@@@@@@@@.......@..@................@.
@@@@.....@@@@@@@@@.............@..........@@...
@@......@@@@@@@@@@.@.....@...@.@@..............
@@....@@@@@@@@@@@@@@@@..@@@@@@.@@.@@@........@@
8
45 10 0
10 32 0
34 6 0
35 15 0
21 39 0
30 34 0
19 13 0
44 20 0

3 32 0
40 13 0
28 35 0
36 14 0
5 32 0
29 28 0
44 31 0
38 43 0
