width 47
height 47
..@@@@@@@@@.......@@....@@@@@@@@@@@@@@@@@@@@@@@
...@@@@.....@....@@.......@@@@@@@@@@@@@@@@@@@@@
....@.....@.@............@@@@@@@@@@@@@@@@@@@@@@
............@@@......@@.@@@@@@@@@@@@@@@@@@@@@@@
..............@.......@@@@@@@@@@@@@@@@@@@@@@@@@
................@@@@@@@@@@@@@@@@@@@@@@@@@@@@@@@
...............@@@@@@@@@@@@@@@@@@@@@@@@@@@@@@@@
......@.....@@@@@@@@@@@@@@@@@@@@@@@@@@@@@@@@@@@
.@.......@@.@@@@@@@@@@@@@@@@@@@@@@@@@..@@@@@@@@
@@...@......@@@@@@@@@@@@@@@@@@@@@@@@@..@@@@@@@@
@@@@@@.....@@@@@@@@@@@@@@@@@@@@@@@@@@..@@@..@@@
@@@@@@......@@@@@@@@@@@@@@@@@@@@@@@@@.......@@@
@...@@......@@@@@@@@@@@@@@@@@@@@@@@@@@@.......@
@....@......@@@@@@@@@@@@@@@@@@@@@@@@@@@@.....@@
.....@.......@@@@@@@@@@@@@@@@@@@@@@@@@@........
...........@@@@@@@@@@@@@@@@@@@@@@@@@@@@@@@@@...
.........@.@@@@@@@@@@@@@@@@@@@@@@@@@@@@@@@@@...
.........@..@@@@@...@@@@@@..@@@@@@@@@.@@@@@@...
..@.@......@@@@@@.....@@@@....@@@..@@.@@@@@...@
........@@@@@@@@@......@@@@@....@..@@...@@@....
.....@..@@@@@@@@@......@...........@........@..
@....@...@@@@@@@@....@@@.@@.................@..
@...@....@@@@@.@.........@@.......@@...........
........@@@@@@...................@@@@@...@@@...
...........@@......@........@@@@@@@@@@@..@.@...
......@....@@..............@@.@@@@@@@@@........
.@@............................@@@@@@@.@.......
.......................@........@@@@@@.........
.@@.....@..@@......@@.@@@........@@@@..........
.@@.........@......@@.@@@@@.@......@@@@....@...
@@@.........@......@@@@@@..........@@......@...
@@@.........@@.....@@@@....................@.@.
@@@@..@@@@@@@.......@@.@@.....@................
@@@@@@@@@@@.........@@....@@.@@.......@....@...
@@@@@@@@@@@.........@@.@@@@@@@.............@@..
@@@@@@@@@@...........@....@.@..................
@@@@@@@@@@................@.......@............
@@@@@@@@@@@@.@....................@............
@@@@@@@@@@@@..@....@...........................
@@@@@@@@@@@@..@..............@@...@@...........
@@@@@@@@@@@.......@........@@@@@@@@@..@......@.
@@@@@@@@@................@@@@@@@@@@@.@@@@......
@@@@@@@@@@................@@@@@@@@@...@@@.@@...
@@@@@@@@@@@...............@@@@@@@@....@@......@
@@@@@@@@@@@................@@@@@@.....@........
@@@@@@@@@@@...........@....@@@@@@...........@@@
@@@@@@@@@@@..........@.....@@@@...@........@@@@
8
33 46 0
19 26 0
20 19 0
24 21 0
15 23 0
0 7 0
8 26 0
40 34 0

43 37 0
5 18 0
25 1 0
19 3 0
37 36 0
0 8 0
27 31 0
20 45 0
