width 47
height 47
@@@@@@@@@@@@@@@@@@@@@@@@@@@@@@@@@@@@@@@@@@@@@@@
@@@@@@@@@@@@@@@@@@@@@@@@@@@@@@@@@@@@@@@@@@@@@@@
@@@@@@@@@@@@@@@@@@@@@@@@@@@@@@@@@@@@@@@@@@@@@@@
@@@@@@@@@@@@@@@@@@..@@@@@@@@@@@@@@@@@@@@@@@@@@@
@@@@@@@@...@@@@.....@@@@@@@@@@@@@@@@@@@@@@@@@@@
@@@@@@@@....@@@@@@..@@@@@@@@@@@@...@@@@@@@@@@@@
@@@........@@@@@@@..@@@@@@@@@@......@@@@@@@@@@@
@@@........@@@@@..........@@@.......@@@@@@@@@@@
@@@@.....@..@@@@.........@@@@.....@...@@@@@@@@@
@..........@@@...........@@...........@@@..@@@@
@............@@.....................@.......@@@
@@@.....@...@@......@........................@@
@@@@@@@...........@.@.@@@..........@....@......
@@@@@@@....................@...@.@@@@...@......
@@@@@@@@@......@...................@....@@@@@..
@@@@@@@.........................@.......@@@@..@
@@@@@@.............................@@@@@@@@@@@@
@@@@@.....................@........@@@@@.@@@@@@
@..@@...............................@@@..@@@@@@
@..@@.@........@..................@..@......@@@
@...........................................@@@
................@......@....@..@............@@@
................@..@..........@.............@@@
........................@@...............@@...@
..........@.........@@@................@.@@...@
...............@...@@@@..@....@..........@@...@
@@..................@@@@....................@.@
.........@@..........@@@@....................@@
.......@..@.@@@......@@@..@....@@.........@...@
......@@..@.@.@@@@..@@@........@@..............
......@@@.....@@@@@.@@@........@@@@@@..........
@......@@......@@@@@@@.........@.@@@.........@@
@...............@@@@@@.......................@@
................@@@@@@................@@@....@@
....@...@.........@@@@....@......@..@@@@@....@@
......@..@........@@@@.........@@@@..@@......@@
.........@@.......@@@@@...........@@......@..@@
@@@...............@@@@@............@..........@
@@@.........@...@@@@@@@............@..........@
@@@...........@@@@@@@..@......................@
@.....@.......@@@@@@@.....@....................
@@.............@@@@@....@.@@@.................@
@@@.....@......@@@@.....@..@.@............@...@
@@@@@@@@@@@....@@@@@@@@...........@...........@
@@@@@@@@@@@...@@@@@@@@@...@@....@............@@
@@@@@@@@@@@...@@@@@@@@@...@@...@@@@.......@@@@@
@@@@@@@@@@@@.@@@@@@@@@@@@@@@...@@@@@.....@@@@@@
8
24 18 0
34 38 0
23 16 0
25 7 0
19 6 0
37 44 0
40 19 0
10 18 0

25 16 0
43 44 0
19 20 0
29 21 0
18 7 0
22 20 0
7 42 0
44 25 0
