width 20
height 16
.................@..
................@...
.............@......
...@...@............
..........@...@.@.@.
..@.....@...........
...@................
....@.....@@....@...
..@.....@...........
....@...............
...@.........@@.....
@........@..........
.............@......
........@..........@
@...............@..@
@...@........@@@@...
6
10 8 0
0 3 0
1 12 0
13 9 1
5 5 1
18 14 1

17 4 0
14 2 0
18 0 0
5 0 1
8 14 1
17 10 1
