width 20
height 16
......@...........@@
.......@.@........@@
...@..@......@.@....
..@.............@...
.....@...@..........
..........@...@.....
........@....@......
.......@............
..@........@........
...@............@..@
...@.@.@.........@.@
..@........@........
@...................
@.............@.....
.............@.@...@
@...@..@...........@
6
17 0 0
3 14 0
7 3 0
17 11 1
11 4 1
19 7 1

17 5 0
10 3 0
4 9 0
1 11 1
10 2 1
3 5 1
