width 20
height 16
...................@
......@............@
.....@........@....@
....................
...@................
..@..........@......
@.........@.........
.@..@...............
...@................
......@.............
.@.@........@.@.@...
..@...@..@........@.
.............@.@....
..........@.........
...............@....
....................
6
11 5 0
9 3 0
10 8 0
2 10 1
8 13 1
13 3 1

13 3 0
8 14 0
3 9 0
4 6 1
6 14 1
14 5 1
