width 20
height 16
....................
..........@....@....
...@.....@..........
......@.........@...
..@..@..@...@.......
.......@............
....@......@........
.................@.@
.........@..........
....@........@......
...@................
........@.@...@.@...
...........@........
.......@............
...............@....
..@...@@@........@@@
6
4 8 0
10 3 0
1 13 0
6 4 1
0 4 1
11 9 1

13 1 0
5 6 0
9 11 0
1 0 1
19 14 1
18 12 1
