width 20
height 16
@....@@@@@..........
.......@......@....@
............@....@..
......@........@....
....@....@..........
.............@......
....................
....@..............@
...@.......@......@@
..................@@
...............@....
.....@.......@...@..
.@......@...........
...@......@.........
.................@..
.@..............@@..
6
2 2 0
19 15 0
2 3 0
8 3 1
15 1 1
0 7 1

18 11 0
11 11 0
8 3 0
6 6 1
15 0 1
18 13 1
