width 20
height 16
....................
...@..........@.@...
@.......@..@@.......
.....@..............
..@.......@....@..@.
.......@............
@................@..
...........@........
.....@.........@....
........@.@.........
...............@.@..
..@.................
.@..@.......@...@...
........@.........@@
.........@..........
.@...@...@@..@......
6
8 5 0
14 13 0
7 9 0
0 10 1
19 9 1
15 1 1

13 7 0
16 10 0
3 7 0
14 4 1
2 1 1
0 14 1
