width 20
height 49
@@..........@@@@@@@@
@.......@...@@@@@@@@
......@...@.@@@@@@@@
..@.........@@@@@@@@
.............@@@@@@@
.....@...@...@.@@@@@
..@............@@@@@
.............@.@@...
....................
...........@.....@..
...@...@........@...
@....@@@.....@......
.....@@@@.@......@@.
...@................
.......@..@.........
@...................
@.......@.@.........
@.@....@.@....@.@...
..........@.........
....................
...@.......@....@...
....@..@............
.@........@.........
...@.....@..@.@.....
....................
@...@.....@.....@...
@...................
......@........@....
.........@.......@..
........@...........
..@.........@...@...
...@.......@@....@..
...........@........
..........@...@.....
...............@....
.@..@....@..........
.......@.......@....
...........@........
......@.............
...............@....
...........@....@...
.......@..@.@.......
....................
.....@.@.@..........
..@..............@..
@@@..@@@............
@@@@@@@...........@@
@@@@@@@...@......@@@
@@@@@@@.......@....@
6
3 21 0
7 47 0
9 37 0
6 44 1
7 28 1
17 10 1

2 28 0
19 18 0
9 2 0
1 39 1
12 32 1
0 44 1
