width 20
height 49
............@......@
..........@......@..
...@.@..@....@......
....................
...........@........
..@.........@.......
.............@...@..
....@..@............
@...........@.@.@...
....@...@..@........
...@...@.......@....
@..@............@...
.......@.@...@......
.@.........@...@.@..
....................
........@..@........
...@.........@.@....
@@.........@........
@@....@.............
...........@....@...
....................
......@.............
....................
@...@...@...........
.........@.@.@......
...@............@...
....................
............@.......
....@..@.....@......
.......@............
....................
.@.@.......@.....@..
................@...
....@.@...@.........
...@................
.........@...@...@..
..@.@.@.............
....................
....................
.....@..............
....................
...@...........@....
....................
......@...@.........
...............@....
...@.....@..........
......@.............
..........@....@....
..................@@
6
0 20 0
17 43 0
17 32 0
3 42 1
12 42 1
5 12 1

18 13 0
1 10 0
17 34 0
3 38 1
12 37 1
19 1 1
