width 20
height 49
...................@
......@.............
........@...........
.....@.....@.@......
............@.......
.....@...@@.......@.
....................
...@.............@..
......@..@.@...@....
.@..................
.....@..............
@........@......@...
.............@...@..
......@.............
...........@.....@..
.....@..............
..@......@.....@....
...@@........@......
....@...............
....................
@@..........@.......
...@................
.......@..@..@.@....
....................
...@..@........@....
.....@...........@..
@........@...@.@....
@......@............
.....@....@..@..@...
.........@..........
....@...@.......@...
..............@..@..
.@...@..............
...@...@.@..@.......
..@..........@..@...
.................@..
.@....@.......@.....
........@...........
.........@.......@..
.@............@.....
...............@....
...@..@......@.....@
....................
................@...
.......@.....@......
..................@.
.....@..............
@.@@.....@......@...
@.....@.........@...
6
10 10 0
10 41 0
3 44 0
14 2 1
6 44 1
10 16 1

8 12 0
1 46 0
3 44 0
10 6 1
14 7 1
15 14 1
