width 20
height 49
..........@..@......
..........@........@
.@...@.@............
........@......@....
....................
................@...
..............@...@.
..@...@.............
.....@.....@@.......
...........@@.......
..@....@............
..@.................
.@@..@.....@........
....................
.........@...@..@...
....@.@....@..@.....
@...@..@............
..@.@...........@...
.........@..@.......
....................
.....@.....@...@.@..
....................
..........@........@
...............@.@..
.....@@..@..........
...........@........
.........@..........
....@..............@
..........@....@...@
........@..@..@.....
....................
.@.@.@..............
..@.@...@.@..@....@.
.........@..........
....@...............
................@.@@
....@...@.@.@.@...@@
......@.............
..................@.
.......@............
...........@....@...
....................
.......@......@.....
.......@@@...@......
................@@@@
.@..............@@@@
........@.......@@@@
......@.........@@@@
................@@@@
6
13 47 0
9 22 0
0 48 0
2 9 1
13 31 1
5 6 1

1 28 0
1 47 0
18 0 0
10 5 1
6 5 1
4 43 1
