width 31
height 31
@.....@@@@@@@@@@@@@@@@@@@@@@@@@
@.....@@@@@@@@@@@@@@@@@@@@@@@@@
@.....@@@@@@@@@@@@@@..@@@@@@@@@
@....@@@@@@@@@@@.@@@..@@@@@@@@@
.....@@@@@@@@@@@.....@@@@@@@@@@
.....@@@@@@@@@.@@.........@@@@@
......@@@@..@.....@......@@@@@@
....................@@@..@@@@@@
............@........@....@@@@@
..@@........@.............@@@@@
...@@.....@@@...@.......@@@@@@@
........@.@@............@@@@@@@
.......@@.......@.@...@@@@@@@@@
.@..@@................@@.@@@@@@
.......@@.@...........@@.@@@@@@
.......@@@................@@@@@
.@@@@@.@@@.@@.............@@@@@
@@@@@@@@@@..@..............@@@@
@@@@@@@@@@.............@@.@@@@@
@@@@@@@@@@@@@..........@.@@@@@@
@@@@@@@@@@@@.............@@@@@@
@@@@@@@@@.........@...@..@.@@@@
@@@@@@@@@....................@@
@@@@@@@@@.@...............@..@@
@@@@@@@@@...................@@@
@@@@@@@@@.................@@@@@
@@@@@@@@@@................@@@@@
@@@@@@@@@@...@@@@@...@@..@@@..@
@@@@@@@@@@@@.@@@..........@...@
@@@@@@@@@@@@..................@
@@@@@@@@@@@@....@.............@
8
22 29 0
17 25 0
24 27 0
18 29 0
15 10 0
6 9 0
10 21 0
23 30 0

14 30 0
5 2 0
19 13 0
0 12 0
15 9 0
19 20 0
12 20 0
13 8 0
