width 31
height 31
@@@........@....@@@.@@@@.@@@@@@
@@..@@..........@@........@@@@@
@@@@@@.............@........@@@
..@@@@..............@.......@@@
....@...........@@@@........@@@
..............@....@.........@@
...................@........@@@
@.@...........................@
@....@............@...........@
@@................@.....@......
@@............................@
@................@.........@..@
@................@.........@...
.............@...@........@@...
.@......@@@....................
........@@@.........@..@.....@@
....................@....@@@@@@
@@@@@@@@......@@...@@...@@...@@
@@@@@@@@@.@@@@@@@@..@@.......@@
@@@@@@@@@@@@@@@@@@@@@@@@@....@@
@@@@@@@@@@@@@@@@@@@@@@@@@@...@@
@@@@@@@@@@@@@@@@@@@@@@@@@@....@
@@@@@@@@@@@@@@@@@@@@@@@@@.....@
@@@@@@@@@@@@@@@@@@@@@@@@..@...@
@@@@@@@@@@@@@@@@@@@@@@@@......@
@@@@@@@@@@@@@@@@@@@@@@@@@......
@@@@@@@@@@@@@@@@@@@@@@@@@.....@
@@@@@@@@@@@@@@@@@@@@@@@@@.@...@
@@@@@@@@@@@@@@@@@@@@@@@@@@@....
@@@@@@@@@@@@@@@@@@@@@@@@@@@....
@@@@@@@@@@@@@@@@@@@@@@@@@@@@...
8
19 15 0
16 11 0
1 12 0
1 3 0
23 17 0
22 9 0
22 13 0
26 14 0

0 3 0
15 11 0
29 27 0
29 29 0
25 10 0
16 5 0
1 7 0
21 2 0
