width 31
height 31
@@@@@@@@@@@@@@...........@@@@@@
@@@@@@@@@@@@@@...........@@@@@@
@@@@@@@@@@@@@@............@@@@@
@@@@@@@@@@@@@@@.........@@@@@@@
@@@@@@@@@@@@@@@........@@@@@@.@
@@@@@@@@@@@@@@........@@@@.....
@@@@@@@@@.@............@@@.....
@@@@@@@@@.....@....@...@@@.....
@@@@@@@@@@...@@................
@@@@@@.......@@......@.........
@@@@@......@@@@@@.@..@.........
@@@..........@@@@@@@..........@
@@@............@@.............@
@@@@....@@@@...@...............
@@@...@...@.@.......@....@.....
@@.............................
@@...............@........@....
@.............@.@@@@@..........
..............@@@@@@@@.....@...
........@.....@@@..@@@.@@@.....
........@@@@@@@@.....@.@@@.....
.........@@@@@@@.....@@@@@..@@.
...@....@@@@@@@@.....@@@@@@@@..
@.......@@........@@@@@@@@....@
..................@@..@@..@....
......................@@..@....
...@..@................@.......
...............................
.......................@.@..@..
@@...@@@@@@...@@.......@....@..
@....@@@@@@@..@@.@@@.@.@@@..@..
8
17 6 0
15 25 0
13 13 0
2 19 0
5 24 0
12 30 0
5 12 0
5 21 0

27 15 0
14 25 0
30 24 0
28 19 0
5 24 0
6 11 0
7 16 0
7 9 0
