width 31
height 31
@@......................@@@.@..
...............@.........@@.@..
.........@.....................
...............................
......@@.......................
......@@.......................
@......@@@@@...........@...@@@@
.......@..@@..............@@@@@
..................@.......@@@@@
.......................@@@@@@@@
......................@@@@@@@@@
..........@...........@@@@@@@@@
............@.........@@@@@@@@@
.........@@..........@@@@@@@@@@
@........@@@@@@.....@@@@@@@@@@@
..@......@@@@@@.....@@@@@@@@@@@
..........@@@@@.......@@@@@@@@@
...........@@@@.......@@@@@@@@@
...........@@@...@.@@@@@@@@@@@@
.@.......@.@@.....@@@@@@@@@@@@@
...........@@......@@@@@@@@@@@@
@.........@@@@......@@@@@@@@@@@
@@....@@@@@@@@..........@@@@@@@
@@.@@@@@@@@@@@..........@@@@@@@
@@@@@@@@@@@@@@@.........@@@@@@@
@@@@@@@@@@@@@@@..@.@@@..@@@@@@@
@@@@@@@@@@@@@@..........@@@@@@@
@@@@@@@@@@@@@@@@........@@@@@@@
@@@@@@@@@@@@@@@@@@....@@@@@@@@@
@@@@@@@@@@@@@@@@@@..@@@@@@@@@@@
@@@@@@@@@@@@@@@@@...@@@@@@@@@@@
8
3 8 0
16 27 0
4 13 0
4 21 0
15 7 0
18 9 0
12 9 0
17 4 0

5 2 0
16 23 0
14 10 0
15 13 0
3 1 0
4 2 0
23 4 0
7 0 0
