width 31
height 31
@@@@@@@@@@@@@@@@@@@@@@@@@@.....
@@@@@@@@@@@@@@@@@@@@@@@@@@.....
@@@@@@@@@@@@@@@@@@@@@@@@@@.....
@@@@@@@@@@@@@@@@@@@@@@@@@@.@...
@@@@@@@@@@@@@@@@@@@@@@@@@.....@
@@@@@@.....@@@@@@@@@@@@@.......
@@@@.........@.@...@@@.........
@@.............@....@@.........
.............@................@
@..@....@@@..@....@...........@
@@@@.....@@....................
@@@@........@@@................
@@......@......................
@@@@...........................
@@@@@....@@....................
@@@@@@...@@@...................
@@@@....@......................
@@@........................@...
@@@............................
@@@@@@@@.................@@....
@@@@@@@@.....@.@....@..@.......
@@@@@@@@@@@...@.......@@@.....@
@@@@@@@@@@@...........@@@@@....
@@@@@@@@@@@.@......@..@@@@@.@..
@@@..@@@@@@.@......@..@@@@@...@
@@@....@@.....@....@..@@@@@...@
@@@.....@.............@@@@...@@
@@@@@@@...@.@.........@@@@...@@
@@@@@@@.....@@.@@..@@@@@@...@@@
@@@@@@@...@@@@..@@@@@@@@@@@@@@@
@@@@@@@@@@@@@@@@@@@@@@@@@@@@@@@
8
27 24 0
2 7 0
30 12 0
13 19 0
29 5 0
19 19 0
18 26 0
20 8 0

29 21 0
20 10 0
11 28 0
17 17 0
17 26 0
17 8 0
27 25 0
30 22 0
