width 31
height 31
@@@@..@......................@@
@@@@@............@...........@@
@@@@@...@...........@........@@
@@.....@@..........@@@.......@@
@......@..........@@@@........@
@@................@...........@
@@...@.......................@@
.....@@@@....................@@
....@........................@@
.......@.......................
......@@.......................
......@@..............@..@.....
.......@............@@@@@@@....
..............@@.....@@@@@@@@@@
@.....@@......@@.....@@@@@@@@@@
@@.........@...........@@@@@@@@
........................@@@@@@@
........@..@............@@@@..@
........................@@....@
.................@.............
...@...........................
..........@...................@
.............@...@............@
.......@.........@........@@...
@@@@@...........@..............
@@@@@..........................
@@@...@...........@............
@@@..@@@@..@@@.....@.........@@
@@@@@@@@@............@...@...@@
@@@@@@@@@......@.............@@
@@@@@@@@@@...........@.......@@
8
27 0 0
2 16 0
19 13 0
20 30 0
20 6 0
4 22 0
12 13 0
15 23 0

19 21 0
20 26 0
9 14 0
16 25 0
3 26 0
10 19 0
1 7 0
21 9 0
