width 83
height 83
@@@@.........@..@........@@.....@@@@....@@...@@@@@@@@@@@@@@@@@@@@@@@@@@@@@.......@@
.......@@....@..........@@@@.@..@@@@.........@@@@@@@@@@@@@@@@@@@@@@@@@@@@@......@@@
....@.....................@@...@@@@@@........@@@@@@@@@@..@@@@@@@@@@@@@@@@@.@....@@@
...@.........@..@...............@@@.....@@...@@@@@@@@@..@@@.@@@@@@@@@@@@@@@@....@@@
.....................@.@@@@.....@@@......@@@.@@@@@@@@@......@@@@@@@@@@@@@@@@....@@@
.........@..........@..@@@@@...@@@...........@@@@..@@......@@.@@@@@@@@@@@@@@..@@@@@
........@@@@.............@.............@......@@...@@......@@.@@@@...@@@@@@@@...@@@
.......@@@@...........@..................@.....@........@..@@...@@....@@@@@@@.....@
.......@@@@....................@@...@..........@.......@@..@@.........@@@@@@@....@@
.....@........@................@@@................@@.......@.....@..@.@@@@@......@.
.....@........................@@@............@................@.....@@@@@@@........
..............................@@@............@@...@......................@@........
............@....@..@....@...@@@@............@@.......................@@@@@........
..@..............@.......@...@@..........@..@@....@@..................@@@..........
@@...............@...@@@@@...@..........@@@......@@..........@..................@@@
..........@...........@@.........@@....@@@.................@@....................@@
..........@...........@@.....@.@.@.....@..................@...@............@@@@.@@@
...........................@..................@@......................@...........@
@@..@@@......@............@................@........@@..............@@@@..........@
@@..@@@@..................@................@......@@@@...........@@@@@@@..@@..@@.@@
@@...@@@.....@@@@@.............@..............@@@@@@@@.............@@@@@...@@@@..@@
@............@@@@@............................@@@@@@@...............@@.....@@@@@@@@
@...........@@.@@@.....@..................@....@@@@@@..................@.....@@@@@@
@...............@@.@@@@@@....................@@@@@@@@..@................@......@@@.
@........@.@....@@..@@@@@.....@.....@...@.....@@@@@@@..@@......................@@@.
@................@@.@@@@@.....@.....@.@@@..@@@@@@@@@@@@@@....@@.................@@.
.....@.....@........@@@@@@@.........@@@@@@@@@@@@@@@@@@@@.....@@@....@.........@@@@.
.....................@.........@@@..@@@@@@@@@@@@@@@@@@@@.....@@.@...@@@............
..@.......@.......@..@@@@......@@@@@@@@@@@@@@@@@@@@@@@@@@..........@@@@@...@@.....@
..........@@........@..........@@@...@@@@@@@@@@@@@@@@@@@...........@.....@.........
.@@.......@@...................@@@...@@@@@@@@@..@@@@@@@@........@..................
..@.@..@@.....................@@@@.....@@@@.....@@@@@@@@...@.....................@@
......@@@@.................@..@@.........@..@...@@@@@@........@..............@...@@
.................@@........@.............@.......@@@@.........@.........@@.....@@@@
...........@......@........@....@......@@.........@............................@@@@
.........@@@@@@..............@............................@...@........@.......@@@@
....@..@@@@@@@@.......@@.....@.@@@.....................................@.........@@
...@@.@@@@.@@@@@.............@......@@@....................@....................@@@
@@@@@.........@......@@......@......@@@................................@.....@..@@@
@@@@@@@@@@.@......@..@@@@...@@.......@@.....@....@@..............................@@
@@@@@@@@@@..........@@@@@...@....................@@.............@.@...........@.@@@
@...@@@@@@@........@@@@@....@........@@..........@................@....@@..........
@..@@@@@@@@....@..@@@@@@...@@@@..@................@@@@........@@......@@@@.........
@.@@@@@@@@@........@@@@.....@@..........@@........@@@@@@.......@@...@.@@@@.........
@....@@@@@@.........@@..................@@......@@@@@@@@..............@@@@@.......@
@....@@@@@@@.@@.....@@......@....................@..@.@@....@@@..@.....@@@@@......@
@....@@@@@@@.........@@...............................@.....@@@@@@...@..@@@.......@
@....@@@@@..@.............@.................................@@@@@@..@@@@@@@@...@@@@
@.....@@@@........@.......@@...............................@@@@@@@..@@@@@@@@@..@@@@
......@@..................@@@@@@...@...........@.@@..@....@@@@@@@@@.@@@@@@@@@..@@@@
......@@.............@..@@@@@......@.......................@@@@@@@@@@@@@@@@@...@@@@
....@..@@@@@@..@....@@...@@@@@@@....@@........@......@@...@@@@@@@@@@@@@@@@@@@@.@@@@
...@@...@@.@@............@@@@@@@......................@@..@@@@@@@@@@@@@@@@@@@@@@@@@
..@@....@@..............@@@@@@@@...........@@@........@@@.@@@@@@@@@@@@@@@@@@@@@@@@@
......@......@...........@@@@@@......@....@@@........@@@@@@@@@@@@@@@@@@@@@@@@@@@@@@
..@.........@@...@.......@@@@@@............@...........@@@@@@@@@@@@@@@@@@@@@@@@@@@@
.@..........@@...........@@@@@@...........@@..........@@@@@@@@@@@@@@@@@@@@@@@@@@@@@
.........................@@..@@@@.....@.@....@@.......@@@@@@@@@@@@@@@@@@@@@@@@@@@@@
.........@@@.....@.......@...@@@@.....@@@..@..@......@@@@@@@@@@@@@@@@@@@@@@@@@@@@@@
..........@@.@@.@@..@..@.@....@@@.......@@......@....@@@@@@@@@@@@@@@@@@@@@@@@@@@@@@
@@@@.......@.@@.....@..........@@@.......@............@@@@@@@@@@@@@@@@@@@@@@@@@@@@@
@@.....@@@....@....@@...@.......@@....................@@@@@@@@@@@@@@@@@@@@@@@@@@@@@
.....@@@@@.......................@@...................@@@@@@@@@@@@@@@@@@@@@@@@@@@@@
.......@@.........................@@..............@....@@@@@@@@@@@@@@@@@@@@@@@@@@@@
........@..@......................@@@@.................@@@@@@@@@@@@@@@@@@@@@@@@@@@@
....@@...........................@@@@@................@@@@@@@@@@@@@@@@@@@@@@@@@@@@@
@@.....@@.................@@..@.@@@@.@@@@......@....@@@@@@@@@@@@@@@@@@@@@@@@@@@@@@@
@@.....@@...............@@@@@....@@.....@.....@.....@@@@@@@@@@@@@@@@@@@@@@@@@@@@@@@
@@...................@@@@@@@@@......................@.@@@@@@@@@@@@@@@@@@@@@@@@@@@@@
.....................@@@@@@@@....................@....@@@@@@@@@@@@@@@@@@@@@@@@@@@@@
.....................@@@@@@@@....................@...@@@@@@@@@@@@@@@@@@@@@@@@@@@@@@
..@....................@@@@@@.............@..@.......@@@@@@@@@@@@@@@@@@@@@@@@@@@@@@
......................@@@@@@@.......@................@.@@@@@@@@@@@@@@@@@@@@@@@@@@@@
.........@.........@..@@@@@@............@.....@.@......@@@@@@@@@@@@@@@@@@@@@@@@@@@@
.........@.......@.@..@@@@@@@..............@@@@@@..@@@@@@@@@@@@@@@@@@@@@@@@@@@@@@@@
........................@@@@@@...........@@@......@@@@@@@@@@@@@@@@@@@@@@@@@@@@@@@@@
..........@.@.........................@@.@@@......@@@@@@@@@@@@@@@@@@@@@@@@@@@@@@@@@
.@@@@@.@....@...@.............@..........@@.......@@@@@@@@@@@@@@@@@@@@@@@@@@@@@@@@@
.@@@@@.....................@@@@...@............@..@@@@@@@@@@@@@@@@@@@@@@@@@@@@@@@@@
..@@@@@.....................@@.....................@@@@@@@@@@@@@@@@@@@@@@@@@@@@@@@@
....@@......................@@@@@@.@@............@.@@@@@@@@@@@@@@@@@@@@@@@@@@@@@@@@
.............@@.............@@@@@@@@..........@@@@@@@@@@@@@@@@@@@@@@@@@@@@@@@@@@@@@
@............................@@@@@@@@@@...@@....@@@@@@@@@@@@@@@@@@@@@@@@@@@@@@@@@@@
8
13 67 0
57 15 0
16 13 0
12 48 0
4 58 0
49 9 0
1 71 0
17 38 0

55 13 0
41 36 0
2 70 0
72 14 0
16 48 0
22 33 0
17 42 0
52 69 0
