width 83
height 83
@......@@@@@@@@@@@@@@@@@@@@@@@@@@@@@@@@@@@@@@@@@@@@@@@@@@@@@@@@@@@@@@@@@@@@@@@@@@@@
@@......@@.@.@@@@@@@@@@@@@@@@@@@@@@@@@@@@@@@@@@@@@@@@@@@@@@@@@@@@@@@@@@@@@@@@@@@@@@
@@......@@...@@@@@@@@@@@@@@@@@@@@@@@@@@@@@@@@@@@@@@@@@@@@@@@@@@@@@@@@@@@@@@@@@@@@@@
@.............@@@@@@@@@@@@@@@@@@@@@@@@@@@@@@@@@@@@@@@@@@@@@@@@@@@@@@@@@@@@@@@@@@@@@
@@@............@@@@@@@@@@@@@@@@@@@@@@@@@@@@@@@@@@@@@@@@@@@@@@@@@@@@@@@@@@@@@@@@@@@@
@@@............@@@@@@@@@@@@@@@@@@@@@@@@@@@@@@@@@@@@@@@@@@@@@@@@@@@@@@@@@@@@@@@@@@@@
@@@..............@@@@@@@@@@@@@@@@@@@@@@@@@@@@@@@@@@@@@@@@@@@@@@@@@@@@@@@@@@@@@@@@@@
@....@............@@@@@@...@@@@@@@@@@@@@@@@@@@@@@@@@@@@@@@@@@@@@@@@@@@@@@@@@@@@@@@@
@............@......@@@@@..@@@@@@@@@@@@@@@@@@@@@@@@@@@@@@@@@@@@@@@@@@@@@@@@@@@@@@@@
@@...@......@........@@@@...@@@@@@@@@@@@@@@@@@@@@@@@@@@@@@@@@@@@@@@@@@@@@@@@@@@@@@@
@@@@@@................@@....@@@.@@@@@@@@@@@@@@@@@@@@@@@@@@@@@@@@@@@@@@@@@@@@@@@@@@@
@@@@@@.....@..........@@.....@..@@@@@@@@@@@.@@@@@@@@@@@@@@@@@@@@@@@@@@@@@@@@@@@@@@@
@@@@@......@...............@....@@@@@@@@@@..@@@@@@@@@@@@@@@@@@@@@@@@@@@@@@@@@@@@@@@
@@@@@..@.@.@...........@.........@..@@@@@@......@@@@@@@@@@@@@@@@@@@@@@@@@@@@@@@@@@@
@@.................@@@..@@..........@@@@@....@..@@@@@@@@@@@@@@@@@@@@@@@@@@@@@@@@@@@
@@@..@@.@@..........@@@..@.........@@@..........@@..@@@@@@@@@@@@@@@@@@@@@@@@@@@@@@@
@@@...@@@@@@....@..@@@@.....@..@...@@@@..............@@@@@@@@@@@@@@@@@@@@@@@@@@@@@@
@@@...@@@@@@....@@.............@....@@@.....@@@.@@@@.@@@@@@@@@@@@@@@@@@@@@@@@@@@@@@
@@.....@@@@.........@...@@....@@....@.......@@@.@@@@@@@@@@@@@@@@@@@@@@@@@@@@@@@@@@@
.........................@..................@@@@@@@@@@@@@@@@@@@@@@@@@@@@@@@@@@@@@@@
..............@@........................@.....@@@@@@@@@@@@@@@@@@@@@@@@@@@@@@@@@@@@@
..@@..........@@.............@@...@..@........@@@@@@@@@@@@@@@@@@@@@@..@@.@@@@@@@@@@
...............@....@@@@@....@....@@@@........@@@@@@@@@@@@@@@@@@@@@@.....@@@@@@@@@@
.@...@@@.@...........@@@@.........@@@@...@...@@@@@@@@@@@....@@@@@........@@@@@@@@@@
....@@@@@@...........@@@@@@.......@@@@......@@@@@@@@@@@@@.@.@@@@.........@@@@@@@@@@
...@@@@@@@@@.........@@@@@.....@.............@@@@@@@@@@@@....@@...@@@...@@@@@@@@@@@
...@@@@@@@@@....@.............@@@.............@@@@@@@@@@@@@@.@....@@@@..@@@@@@@@@@@
...@@@@@@@@@....@............@@@@...........@@@@@@@@@@@@@@@@.....@@@@@...@@@@@@@@@@
@..@@@@@@@@@.................@@@@.......@..@@@@@@@@@@@@@@@@@........@....@@@@@@@@@@
@@@@@@@@@@@@.@.....@@.........@.....@@.....@@@@@@@@@@@@@@@@@@@@.......@..@@@@@@@@@@
@@@@@@@@@@@@@......@@@..@.................@@@@@@@@@@@@@@@@@@@@...@........@@@@@@@@@
@@@@@@@@@@@.......@.@@..@.................@@@@@@.@.@@@@@@@@@@...@.@@.....@@@@@@@@@@
@@@@@@@@@@@.....@...@@@..@.................@@@@......@@@@.@@......@.......@@@@@@@@@
.....@@@@@@....@....@@..........@@@...@....@@@..@......@..@@@@.@..@.....@@@@@@@@@@@
.......@@@.....@......................@...................@@@@..........@@@@@@@@@@@
...@...@.@....@@..........................................@@@@..@...@...@@@@@@@@@@@
@.............@.......@@@.....@....................@......@@....@@@@@..@@@@@@@@@@@@
.....................@@@@.......................@@@.......@@......@...@@@@@@@@@@@@@
......................@@.......@.............@..@@@@...................@@@@@@@@@@@@
.......................@@.....@@................@@@@...................@@@@@@@@@@@@
@......................@.......@...............@@@@@@@@...@........@...@@@@@@@@@@@@
........................@......@@.@@.@....@....@@@@@@@@............@..@@@@@@@@@@@@@
............@@@@@@............@@@............@.......@.............@@@@@@@@@@@@@@@@
......@.....@@@@@@.............@@..............................@@.@@@@@@@@@@@@@@@@@
............@@@@@@@......................................@.....@@@@@@@@@@@@@@@@@@@@
............@@@@@@@......................................@.....@@@@@@@@@@@@@@@@@@@@
.............@@@@@@@@..................@...@..............@.....@@@@@@@@@@@@@@@@@@@
...............@.@@@@...................@@@@.@............@@@@@...@@@@@@@@@@@@@@@@@
..................@.....................@@@@...............@@.@....@@@@@@@@@@@@@@@@
...@.............@@...@@@@@@@@............@@@..................@..@@@@@@@@@@@@@@@@@
............@.......@@@@@@@@@@.@@@@.......@@@.....@..............@@@@@@@@@@@@@@@@@@
............@..@@@@.@@@@@@@@@@@@@@@.............@@.....@.........@@@@@@@@@@@@@@@@@@
@..............@...@@@@@@.@@@@@@@..............@.@@..@...........@@@@@@@@@@@@@@@@@@
..........................@@@@@@@.............................@..@@@@@@@@@@@@@@@@@@
............................@@@@@@.......@........................@@@@@@@@@@@@@@@@@
..@@........@................@@@@@..@....@....@...@@..............@.....@@@..@@@@@@
............@@.@@............@@@@@..@...@@.@.....@@.......@....@........@....@@@@@@
............@@@@@...........@@@..@..@.@@@@@@....@@@.....@....................@@@@@@
..@..@.......@@@.......@....@.........@@@@@@@@@............@.................@@@@@@
.@@@@........@@@@@@@...@@@@.@@.......@@@@@@@@..............@................@@@@@@@
@@@@@........@@@@@@@...@@@.............@@@@......@.......@.........@.@......@@@@@@@
@.........@.@@@@@@@@....@@@......@.............@.....@@@@@..................@@@@@@@
..........@.@@@@@@@@.@..@@......@@....@...@....@.....@@..@..................@@@@@@@
......@......@@@@@@..@...@@...@..@....@........@.....@@.................@@..@@@@@@@
@.........@@@@@@@@@@........@@@......................@@@......................@@@@@
@@........@@@@@@@@@@..........@....@.....@...........@@@......................@@@@@
@@..@.....@@@@@@@@@@@.@.........@........@@.......@..@.......@@@@............@@@@@@
@@@@..@...@@@@@@@@@.....................@@@..@....@..........@@@@@..........@@@@@@@
@@@.......@@@@@@@@@..........@..........@@@............@.@@@@@@@.@..........@@@@@@@
@@@@.....@@@@@@@@@@.............@.......@@.....@..........@@@@@........@....@@@@@@@
@@@......@@@@@@..@.............@@........@........@........@.@@..........@@@@@@@@@@
@@@@.....@@@@@@......@@......................................@@@............@@@@@@@
@@@@@...@@@@@@@......@@@@....@.....@@....@@..........@.........@..........@@@@@@@@@
@@@@@...@.@.@@.........@@....@@@@...@@@@@@@@.........@.@...................@@@@@@@@
@@@@@..................@@.....@@..@...@@@@@@................@...@@....@@...@@@@@@@@
@@@@@@@..@..................@.@@.......@@@@@@@@@............@@@@@@@@..@@....@@@@@@@
@@@@@@@@.@...@@......................@..@@@@@@@@...............@@@@.........@@@@@@@
@@@@@@@@@@@@@@@....@....@@..@@...@@..@@@@@@@@@@@@.....@........@@@@@@......@@@@@@@@
@@@@@@@@@@@@@@@............@@....@@@@@@@@@@@@@@@@......@@@....@@@@@@@......@@@@@@@@
@@@@@@@@@@@@@@@@@@..............@@@@@@@@@@@@@@@@@@@@.@@@@@....@@@@@@@....@.@@@@@@@@
@@@@@@@@@@@@@@@@@@@...@@@.......@@@@@@@@@@@@@@@@@@@@@@@@@@@.@@@@@@@@..@@....@@@@@@@
@@@@@@@@@@@@@@@@@@@@..@@@@@.....@@@@@@@@@@@@@@@@@@@@@@@@@@@@@@@@@@@@..@@....@@@@@@@
@@@@@@@@@@@@@@@@@@@@@@@@@@@@@@@.@@@@@@@@@@@@@@@@@@@@@@@@@@@@@@@@@@@@@@@@....@@@@@@@
8
22 45 0
2 56 0
11 47 0
56 40 0
24 70 0
10 21 0
16 21 0
47 67 0

75 75 0
64 33 0
61 38 0
27 63 0
71 33 0
54 34 0
11 4 0
46 67 0
