width 83
height 83
@..@@@@@.........@@@@@@@@@@@@@@@@@@@@@@@@@@@.......@@@@@@@@@@@@.@@..........@@@@@@@
....@.@@........@@@@@@..@@@@@@@@@@@@@@@@@@@.........@@@@@@@@....................@@@
..........@........@@@....@@@@@@@@@@@@@.............@@@@@@@@@.................@@@@@
@@........@.@......@.....@@@@@..@@@...........@.....@@..@@.............@......@@@@@
@@...................@...@@@@..............@....@...@@..@@............@........@@@@
..................@..@....@@@.................@.....@.............................@
............................@...........................@@.......................@@
.....@........................@@........................@@.......@@..............@@
@...........@@......@..........@.....@..@@@.............@@....@@@@@.............@@@
@..........@@..................@.....@@@@@@@@............@..@...@...............@@@
@...............@.....@............@@@@@@@@.............@@.......@.....@@@.....@@@@
...........@......@..........@@..@@@@@@@@@@.....@......@@..............@......@@@@@
...@@......@...................@@@@@@@@@@@@@..........@.........@@@.......@...@@@@@
@.@@@@.........@.....@....@.@@.@@@@@@@@@@@@@@@...@@.............@@@......@@...@@@@@
..........@@@..@@..........@@@@@@@@@@@@@@@@@@...@@......@..........@.....@@..@@@@@@
...........@@..@@...@.......@.@@@@@@@@@@@@@@@...@...@......@.......@..@..@@@@@@@@@@
@...................@.......@.......@@@@..@.@..............@@............@@@@@@@@@@
......................@........................@@@.........@@@.........@@@@@@@@@@@@
..............@................................@@@....@@...@@@.....@....@@@@@@@@@@@
...@..........@..........@.........@@.....@@.....@@@.....@...@...........@@@@@@@@@@
..@@@.................@@@@..@...@@@@@......@...............@@@.........@..@@@@@@@@@
.@@@...................@@@..@...@.@@@@........@...........@@@@........@@....@@@@@@@
.....@@..............................@...................@@@...@............@@@@@@@
.....@@...@.................@............................@@........@........@@@@@@@
......@@...@...............@@....@..@...................@@@...........@........@@@@
..@...@@.........@.........@........@......@@......@....@@@.....@@@@...........@@@@
...@@.@@@........@.........................@@@...@@@.....@@.....@@..............@@@
............................@....@@.......@@.@............@@....@@...@@............
......................@...@.@.....@@@....@@@..............@@....@@@................
..........@@@@........@...@.......@@......@...............@@...@@@.................
...@.......@@@................@@..@@@...........................................@..
...@@........................@@@@@@@.......................................@.....@@
....@@@@@..@@@@.......@@....@@@..@@........@....@...@........@..@..................
...@@@@@@@.@@@@........@.....@@@..............@................@.....@.@.......@...
.....@@@@@@@@@@................................@.......................@.......@@@.
.@...@@@@@.@@@@..............@@.....@@......@@@.....@@............@@...........@@..
@@@....@@...@@..........@.@..........@@......@@@@..@@.......@.................@.@..
.@@.....@....@......@...@.@..........@@......@@@@@@@@..@....@......................
..@.....@....@......@@......@......@@@@...@...@@@@@@@@...........@@@@@@...........@
@....@......@......@@@@@.............@@@@@@@@@@@@@@@@............@@@@@@@..@.......@
.....@@.............@@@@............@@@@@@@@@@@@@@@@@...@..@....@@................@
.......@........@...............@...@@@@@@@@@@@@@@@@@..@.....@@.@@.................
.....@@@.......@@.......@.......@@@.....@@@@@@@@@@@@@........@@@@@.......@.........
......@@@@@@@@@@@@..@...........@@@....@@@@@@@@@@@@@..........@@@@.......@@........
......@@@@@@@@@@@@..............@@...@@@@@@@@@@@@@@...........@@@@.....@.@@.@......
@@....@@@@@@@@@@@@..............@....@@@@@@@@@@@@@@...@@.@@....@@@@@@@...@@@@.@@..@
@@.....@@@@@@@@@@@..............@....@@@@@@@@@@@@@@...@@..@@@....@@@@@.....@@@@@@@@
@@@....@@@@@@@@@@@@@.............@...@@@@@@@@@@@@@@..@@@@.@@....@@@@@@@@....@@@@@@@
@@@.....@@@@@@@@@@@@@...........@@....@@@@@@@@@@@@@@@@@.........@@@@@@@@@...@@@@@@@
@@@.....@@@@@@@@@................@@.....@@@@@@@@@@@@@.@.........@@@@@@@@@@..@@@@@@@
@.......@@@@@@@@@.......@........@@@@.........@@@@@@@...........@@@@@@@@@@@@@@@@@@@
@@@@@...@@@@@@@@@@@@@@@@@@..@...@@@@@............@@@@...........@@@@@@@@@@@@@@@@@@@
@@@@@...@@@@@@@@@@@@@@@@@@@@@.@.@@@@@@...@..@....@@.@@..............@@@@@@@@@@@@@@@
@@@@@..@@@@@@@@@@@@@@@@@....@..@@@@@@@..@.........@..................@@@@@@@@@@@@@@
@@@@@@@@@@@@@@@@@@..@@@.....@.@@@@@@@@@@@......@@.@......@@..........@@@@@@@@@@@@@@
@@@@@@@@@@@@@@@@@...........@.@@@@@@@@@@@......@.@@............@@......@@@@@@@@@@@@
@@@@@@@@@@@@@@@@@.............@@@@@@@@@@...@..........................@@@@@@@@@@@@@
@@@@@@@@@@@@@@@@@.............@@@@@@@@@@............@@...................@@@@@@@@@@
@@@@@@@@@@@@@@@@@@...........@@@@@@@@@@@.............@@@@@...@............@@@@@@@@@
@@@@@@@@@@@@@@@@@@@.........@@@@@@@@@@@@@...@.........@@@@.@..........@...@@@@@@@@@
@@@@@@@@@@@.@@@@@@@@.........@@@@@@@@@@@@.............@@...@@......@@@@....@@@@@@@@
@@@@@@@@@@@..@@@@@@@@.........@@@@@@@@@@@@..@..@@.....@@...@@....@..@@.....@@@@@..@
@@@@@@@@@@@.....@@@...........@@@@@@@@@@@@..@.......@...........@@@@@@.....@.......
@@@@@@@@@@@.@...@@......@.....@@@@@@@@@@@....................@@@@@@@@@......@.....@
@@@@@@@@@@@...................@@@@@@..............@..@.......@@@@@@@@@.............
@@@@@@@@@@@@...............@....@@@@.............@............@@@@@@@@.............
@@@@@@@@@@@@..................@.@@@@...................@....@@@@@@@................
@@@@@@@@@@@@......................@@.............@.........@@@@@..................@
@@@@@@@@@@@@..................@...@@@.......@.@.............@@@@..................@
@@@@@@@@@@@@@@................@...@@......@@@@................@@....@.@............
@@@@@@@@@@@@@.....................@@@.......@@.....@..@@.......@@..@@..............
@@@@@@@@@@@@@@................@....@@.......@.@........@.......@@@.................
@@@@@@@@@@@@@...............@......@@.@.......@.............@..@@@..............@..
@@@@@@@@@@@@......................@@@@@.....................................@......
@@@@@@@@@@@@@.............@...@...@@@@@.......@.......@.@@.@@.....@@.........@.....
@@@@@@@@@@@@@.....................@@@@@@......@.........@@.@@...........@..........
@@@@@@@@@@@@@@.@.........@..........@@@@.@@.................................@.....@
@@@@@@@@@@@@...@@.@............@.........@@.....@@.@..........@..@.@@.......@.....@
@@@@@@@@@@@.......@@.....@..@@@@.....@.@..@.....@@.@.............@@@@..............
@@@@@@@@@@@.............@@@@@@@.........@........@@@.......@.@..............@......
@@@@@@@@@@..@@...@.......@@@@@@@.....@...........@..........@@@@.@...........@@....
@@@@@@@@@@.@@@@@..........@@@@@@@@@@@@@@.@...@@@............@@@@@@............@....
@@@@@@@@@@..@@@@..........@@@@@@@@@@@@@@.....@.............@@@@@@@...........@@@@..
8
38 17 0
43 77 0
7 19 0
75 4 0
36 34 0
47 14 0
71 43 0
63 16 0

67 8 0
16 65 0
38 64 0
36 18 0
18 44 0
21 76 0
50 81 0
2 41 0
