width 83
height 83
@@@@@@@@@@@@@@@@@@@.......@@@...........@@@.....@@@@@@@@@@@@@@@@@@@@@@@@@@@@@@@@@@@
@@@@@@@@@@@@@@@@@@@.......@.............@@@@@@...@@@@@@@@@@@@@@@@@@@@@@@@@@@@@@@@@@
@@@@@@@@@@@@@@@@@@@@...................@@@@@@@...@@@@@@@@@.@@@@@@@@@@@@@@@@@@@@@@@@
@@@@@@@@@@@@@@@@@@@@.......@............@..@.....@@@@@...@.@@......@...@@@@@@@@@@@@
@@@@@@@@@@@@@@@@@@@...@....@............@.@@......@@@@.............@....@@@@@@@@@@@
@@@@@@@@@@@@@@@@@@@.....@.................@@........@@..................@@@@@@@@@@@
@@@@@@@@@@@@@@@@@@......@............@@@...@.......@@@@..@.............@@@@@@@@@@@@
@@@@@@@@@@@@@@@@@@.....@@.......@@...@@...@@..@@.....@@......@........@@@@@@@@@@@@@
@@@@@@@@@@@@@@@@........@................@@.........@@@@@.............@@@@@@@@@@@@@
@@@@@@@@@@@@@@@@........@@@..............@..........@@@@@.....@@......@@@@@@@@@@@@@
@@@@@@@@@@@@.@@@.....................................@@@@.....@@@@....@@@@@@@@@@@@@
@@@@@@@@...........@...@....................@@.......@.................@@@@@@@@@@@@
@@@@@@.........................@...........@@..@@.........@.......@@@@.@@@@@@@@@@@@
@@@@@@...........@....@.....@..@...............@@@..............@@@@@@@@@@@@@@@@@@@
@@@@....@........@@..........@@@@@...........@@@@@@@.@.@.@......@@@@@@@@@@@@@@@@@@@
@@@@@@.........@@@@...........@@@...........@@@@@@@@..............@@@.@@.@@@@@@@@@@
..@........@@.@@@@@...........@@@@@..@@@...@@@@@...............@....@.@...@@@@@@@@@
.........@@@@@@@@@@..........@@@@@@@.@.@.......@...............@....@.@..@@@...@@@@
.........@@@@@@@@@@@@@@@@@@@@@@@@@@@.@.........................@..........@@.....@@
........@@@@@@@@@@@@@@@@@@@@@@@@@@@@@@....................................@@......@
@...@.@.....@@@@@@@@@@@@@@@@@@@@@@@@@@...@@@@.............................@@@..@...
@@@.@@@@......@@@@@@@@@@@@@@@@@@@@@@@@...@@@@@..................@@@......@@@@......
@@@@@@....@@@.@@@@@@@@@@@@@@@@@@@@@@@@.@@@@@@@......@...@......@@@@....@@@@@.......
@@@@@@....@.@..@@@@@@@@@@@@@@@@@@@.....@@@@@@@@@@..............@@@@@@@@@@@@.......@
@@@@@@.........@@@@@@@@@@@@@@@@@@@.....@@@@@@@@@@@........@...@.@@@@@@@@@@@.......@
@@@@@...@...@@@@@@@@@@@@@@@@@@@@@@.........@@@@@@@..............@@@@@@@@@@@@@@.....
@@......@@@@@@@@@@...@@@@@@@@@@@@@@........@@@@@@@...........@...@@@@@@@@@@@@...@..
@@.......@@@@@@@@@.@.@@@@@@@@@@@@@@.........@@@@@..........@@@@@@@@@@@@@@@@@@......
@@@@....@@@@@@@@@@....@@@@@@@@@@@@@..........@@@................@@@@@@@@@@@......@.
@@@@@..@@@@@@@@@@@@...@@@@@@@@@@@@@@.........@.............@@...@@@@@@@@@@@.......@
@@@.........@@@@@@.....@@@@@.....@@.......................@@....@@@@..@@@@@........
@@@@........@@@@@@.......@.......@@.....@@....@.......@................@@@@........
@@@@.@@.....@@@@@@.......@..........@....@......@@......................@@@.....@..
@@@@........@@@@@........@..........@@...........@@..................@@..@@.@@@....
@@@@@...............................@...........@@@.@.............@@@@@..@.........
@@@@@...........................................@@@@@@.............@@@@.@@.........
@@@@@@@..............@.........@..@@@@..........@@@@@..........@@...@@............@
@@@@@@@.......@......................@..........@@@...........@@...................
@@.......@....@...............................@...........@...@..@..............@@@
@@........................@.@@......@..............@@............@..............@@@
@@...........................@@........@..................@.@@...........@.......@.
@@@@....@.....................@.......@@@..................@@.........@@...........
@@@.....@....@@@.................@@@@@@@@.......@@@@.....@@@..........@@@@.........
@.......@..@@@@@........................@@@.....@@@@@...@@..............@@.....@@..
@@.....@..@.......@....@@.............@.........@...@....@....@.......@........@@..
@@.............@..@....@@....@.............................@@..................@@@@
@@@........@.........@@@@@@@@@.............................@@@..................@@@
@@@.................@@.@.@@@@@.......@..............@.................@@........@@@
@@@@...@@................@@@@@.......@@..............@................@@........@@@
........@................@@@@@@......@.............@@.....@.........@...........@@@
@@....@..................@@@@@@.....@@@@...@......@@......@...@.....@@@.........@@@
@@....................@@@@@@@@@@@..@@@@@@@@@....@@@@@.@@@@@...@@....@.@..@......@@@
@@@.....................@@@@@@@@@@.@@....@@........@@.@...........@...@@@...@@@.@@@
@@@@...........@........@@@@@@@@@............................@........@@@@..@@@@@@@
@@@@.......@......@......@@@@@@@@@@..................@...@..@@........@@...@@@@@@@@
@@@@@...................@@@@@@@@@.....@............@...........@@@@...@..@...@@@@@@
@@@@@...................@@@@@@@...@...@...@..................@@@@@@@.........@@@@@@
@@@@@..................@@@@@@@.....@....................@........@@@.@...........@@
@@@@................@..@@@@@@@.................@..@....@@........................@@
@@.....................@@@@.@@....................@@........@....@..............@@@
@@.......@@....@........@@@.@@..............@..................................@@@@
@@@@@...@@@@.....@@....@@@@...........................@.@...@@..............@@@@@@@
@@@@@..@@@@@..@@@@.....@.....@............@.........@@..@...@@.........@@@..@@@@@@@
@@@@@.....@@@@@@@.........................@.@......@@..................@@...@@@@@@@
@@@@@@@...@@@@@@@...............@@.@......@@@......@.........@..............@@@@@@@
@@@@@@@..@@@@@@@...@@@@.........@@@.......@@.......@............@.......@...@@@@@@@
@@@@@@@..@@@@@@@......@.....@...@.......@...............@.......@.............@@@@@
@@@@@@@@@@@@@@@@@..@@@.........@...........................@..................@@@@@
@@@@@@@@@@@@@@@@@@@@@@...........@.........@......@......@@....@@......@......@@@@@
@@@@@@@@@@@@@@@@@@@@@@@.....@........................................@@@......@@@@@
@@@@@@@@@@@@@@@@@@@@@@@..@.......@........@.........@@@...............@@@@@@..@@@@@
@@@@@@@@@@@@@@@@@@@@@@@......@..@@@@..@@@@@......@..@@@....@.......@..@@@@@@@@@@@@@
@@@@@@@@@@@@@@@@@@@@@@@.........@@....@@@@.......@@.@@@@..........@@@@@@@@@@@@@@@@@
@@@@@@@@@@@@@@@@@@@@.......@...@....@@@@@@........@..@@@..........@@@@@@@@@@@@@@@@@
@@@@@@@@@@@@@@@@@@@@.@..............@@@.@@...........@.....@...@@@@@@@@@@@@@@@@@@@@
@@@@@@@@@@@@@@@@@@@@...........................................@@@@@@@@@@@@@@@@@@@@
@@@@@@@@@@@@@@@@@@@@.....@........@....@.....@............@.@@.@@@@@@@@@@@@@@@@@@@@
@@@@@@@@@@@@@@@@@@@@.........................@.................@@@@@@@@@@@@@@@@@@@@
@@@@@@@@@@@@@@@@@@@@@@@........................@@@.............@@@@@@@@@@@@@@@@@@@@
@@@@@@@@@@@@@@@@@@@@@@@...........@@...................@..@....@@@@@@@@@@@@@@@@@@@@
@@@@@@@@@@@@@@@@@@@@@@....@@.......@@@.......@@.........@.@....@@@@@@@@@@@@@@@@@@@@
@@@@@@@@@@@@@@@@@@@@@@@@@@@@........@@..@@...@@..........@@@@@@@@@@@@@@@@@@@@@@@@@@
@@@@@@@@@@@@@@@@@@@@@@@@@@@........@@@@@@@....@@...@...@@@@@@@@@@@@@@@@@@@@@@@@@@@@
8
11 12 0
7 28 0
29 5 0
78 20 0
64 43 0
63 13 0
30 78 0
49 66 0

14 14 0
35 33 0
47 4 0
53 41 0
5 18 0
51 12 0
23 17 0
58 41 0
