width 83
height 83
@@@@@@@@@@@..........@@@...@@@@@@@@@@@@@@@@@...........@@@@@@@@@@@@@@@@.@@.........
@@@.@.@@@@@@.........@@@...@@@@@@@@@@@@@@@@@...........@@@@@@@@@@@@@@@@.....@@.....
@@@....@@@...........@@....@@@@@@@@@@@@@@@@@@@@.......@@@@@@@@@@@@@@@@@@.@..@......
@..........................@.@@@@@@@@@@@@@@@@@..........@@@@@@@@@@@@@@@............
.....@@.......................@@@@@@@@@@@@@@@@...@@......@@@@@@@@@@@@@.............
.....@@@@..........@.....@...@@@@@@@@@@@@@@@@@@....@.....@@@@@@@@@@@@..............
...@@@@@@.....................@@@@@@@@......@@@@..........@@@@@@@@@@....@.@......@.
..@.@@..@........@.....@......@@@@@@@@......@@.............@@@@@@@@@....@......@@@@
................................@@@@@@......................@@..@@@@.........@@@@@@
..............................@@@@....@@@.........@..........................@@@@@@
.........@.....................@@@....@@@......@@@..........................@.@@@@@
........................@@@@@@..@....@..........@.............................@@@@@
@@@...@@................@@@@@@........................@....................@...@@@@
.......@..@..@............@@@..........@.........@...@@.....................@@@@@@@
.@..@@.@@@@.@@@........@.......@...............@.@@..@@....@.@@....@........@@@@@@@
@@@@@@.@@@@..@@@@@@@...@......@@...............@@@...@@.....................@@@@@@@
..@@...@@@@@.@@@@@@@@..@.................@....@@@....@@@.....................@@@@..
...@@.....@@@@@@@@@@@.........................@@@...@@@@...........@.........@@@..@
...........@@@@@@@@............................@...@@..@..........@@@.............@
..........@@@@....@....................@@...........@..@...........@@.............@
..@........@@@...@@...@@@............@.@@@@............@.@@@....@@.................
...........@@@@.....@.@@@@...........@.@@..........@...@.@@.@..........@...@.......
............@@@.........@@..........@@....@............@..@.@.........@@......@.@..
@............@............................@...........................@@........@@.
@@....@@.@....@...............................@.........................@........@.
@@....@@@@@..............@...........@@.........@.................................@
@@@...@@@@@@.........@@@@@@......@.........@...@@...........................@......
@@@@@@@@@@@..........@@@@.@.@@@@...............@@@@................@...@.@....@....
@@@@@@@@@@@..@............@@@@...........@.............................@@@.@..@.@@@
@@@@@@@@.@@........@...........@@..........................@............@@@........
@@@@@@@@..@@...@.....@.......@..@....@@.....@......@@.....@@@...........@@..@...@@@
@@@@@@@@..@@.......@@.................@@@..........@........................@...@@@
@@@@.@@@......@...@@@@@.......@.......@..........@.................@.............@@
@@@@............@.@@@@@......@.................@...@...............@......@@....@@@
@@@@@@..........@..@@..................@..@@@@.................@.@.@@.....@@@...@@@
@@@@@@@@@@@.....@..........................@@.............................@@@@@.@@@
@@@@@@@@@@@...............................@@@....@............@@@..@......@@@@@@@@@
@@@@@@@@@@@.....@.........................@@@....@...@...@....@@..@@@@@...@@@@@@@@@
@@@@@@@@@@@@..@............@...@.......@@...@......................@@@@@@@@@@@@@@@@
@@@@@@@@@@@..........@..@@.....@.......@@.@.@............@........@@@@@@@@@@@@@@@@@
@@@@@@@@@@@.........................@.......@@@@@........@..@.....@@@@@@@@@@@@@@@@@
@@@@@@@@@@@................@.....@...@...@..@@@@@@.......@.@@@....@@@@@@@@@@@@@@@@@
@@@@@@@...........@.....@.@............@...@@@@@@@.@.....@.@@@....@@@@@@@@@@@@@@@@@
@@@@@@@...........@.........@@@@@@.........@.@@@...@@@...@@@@@....@@@@@@@@@@@@@@@@@
@@@.@@......@....@..........@@@.@@@................@@....@@@@@@....@@@@@@@@@@@@@@@@
............@......@........@@@................@@..@@....@@@@......@@@@@@@@@@@@@@@@
...........................@@@@.....@....@@.....@.@@@.....@@@...@..@@@@@@@@@@@@@@@@
.@.....@..@@...@.............@............@@......@@@......@.....@@.....@@@@@@@@@@@
........@@@@@@@@@@@@.....@..@@............@...@............................@@@@@@@@
......@..@@@@@@@....@.......@@.....@......................@@................@@@@@@@
.........@.@@@@@@....................................@@@.....................@@...@
............@@@.......@..........@....................@@@...................@@@@...
................................................@@....@@@..........................
...........................@....................@@......@......@...................
......@@@@@........@......@@...........@@@......@@.@........@..........@@..........
.....@@@@@@@@..........................@@@@@@@@@@............@.........@@@.........
....@@@..@@@@@..@@....................@@@@@@@@@@@@....@................@@@@..@.....
...@@.....@....@@@@...........@......@@@@@@@@@@@@@.....................@@@@@......@
@.........@@.........................@@@@@@@@@@@@@@@................@..@@@.........
@......@@.........................@..@@@@@@@@@@@@@@@.......@@@.......@@@@@......@..
@@@@@@@@@.........................@.@@@@@@@@@@@@@@@@...@...@........@@@@@@.........
@@@@@@..@...@....................@@.@@@@@@@@@@@@@@@@.............@..@@.@@......@@@.
@@@@@@.....@@@.@....@............@@@@@@@@@@@@@@@@@@@....................@......@@@@
@...........@......@@.......@...@@@@@@@@@@@@@@@@@......@.........@.@@.@@.......@@@@
@......@@...................@...@@@..@@@@@@@@@@@@...@@.................@.......@@@@
...........@.............@......@@@@.@@@@@@@@@@@...@@@..............@.......@..@@@@
...........@..........@@.............@@@@@@@@@@@...@@..@......@.....@.......@@@@@@@
..@..@.................@..............@@@@@@@@@@@@@@..@@......@.............@@@@@@@
.@.....................@@...........@@@@@@@@@@@@@@@@..@@.@...............@..@@@@@@@
@@..@@.................@@.....@@......@@@@@@@@@@@@@@@@@...................@@@@@@@@@
....@@............@@@..@@@.............@@@@@@@@@@@@@.................@@..@@@@@@@@@@
......@...............@@.@.......@@....@@@@@@@@@.@@@.....@.....@....@@@@@@@@@@@@@@@
@@...@@..@@.......@..............@@.....@@@@@@@..@..................@@@@@@@@@@@@@@@
@.....@..@@.......@..............@@@@.....@@@@.....@.................@@@@@@@@@@@@@@
......@@@@@...@@.@@@......@@@....@@@@@....@@@@@@...@........@.....@@@@@@@@@@@@@@@@@
......@@@@....@@@@@@@....@@@@.@..@@@@@@@..@@@@@@...........@@..@@..@@@@@@@@@@@@@@@@
......@@@.....@@@@@@@@@@@@@@@@@@@@@@@@@@@@@@@@@@@...........@@..@@@@@@@@@@@@@@@@@@@
......@@@@....@@@@@@@@@@@@@@@@@@@@@@@@@@@@@@@@@@@@@............@@@@@@@@@@@@@@@@@@@@
...@...@@@...@@@@@@@@@@@@@@@@@@@@@@@@@@@@@@@@@@@@@@@.@..........@.@@@@@@@@@@@@@@@@@
........@@...@@@@@@@@@@@@@@@@@@@@@@@@@@@@@@@@@@@@@@..@.@..........@@@@@@@@@@@@@@@@@
@.......@.@@.@@@@@@@@@@@@@@@@@@@@@@@@@@@@@@@@@@..........@....@...@@@@@@@@@@@@@@@@@
@...@@.......@@@@@@@@@@@@@@@@@@@@@@@@@@@@@@@@@@@@........@.@@....@@@@@@@@@@@@@@@@@@
@...@........@@@@@@@@@@@@@@@@@@@@@@@@@@@@@@@@@@@@.@.....@@@@.....@@@@@@@@@@@@@@@@@@
8
8 30 0
70 12 0
14 56 0
45 17 0
57 14 0
71 1 0
2 11 0
20 22 0

45 51 0
16 67 0
31 26 0
51 76 0
69 30 0
16 74 0
73 61 0
34 27 0
