width 20
height 12
@.................@@
@..................@
@.......@...@....@.@
.......@...........@
............@.......
...............@....
@@.......@..........
@@..................
@@@@..@...@.....@...
@@@@.@..@...........
@@@@............@...
@@@@................
6
19 7 0
2 7 0
14 7 0
6 11 1
11 1 1
8 1 1

15 2 0
17 0 0
1 4 0
10 9 1
10 1 1
13 1 1
