width 20
height 12
........@...........
...................@
@........@....@.....
....@.@.@....@...@..
@.................@.
.@.......@.....@....
....................
......@...@........@
.....@.....@.@......
................@...
....................
......@@............
6
3 3 0
10 0 0
3 8 0
19 10 1
9 10 1
4 8 1

9 3 0
2 1 0
2 4 0
15 10 1
8 6 1
19 3 1
