width 20
height 12
@...................
@...................
@....@.@............
..........@.@.......
..@.................
....................
....@@@...@@........
....@@....@@@.......
...........@@......@
...........@@.....@@
...@....@@@@@.....@@
@.@@....@@@@@.@..@@@
6
17 0 0
7 4 0
9 8 0
9 7 1
19 1 1
4 4 1

18 1 0
1 11 0
17 4 0
7 7 1
16 6 1
17 8 1
