width 20
height 12
.....@.............@
...........@...@...@
.@.................@
...................@
................@..@
...............@....
.....@.....@........
.........@......@...
....................
...@........@@.@....
......@....@@@@@....
...........@@@@@@@..
6
1 11 0
1 4 0
8 10 0
17 7 1
2 1 1
0 5 1

10 3 0
6 8 0
1 0 0
0 7 1
2 11 1
19 11 1
