width 20
height 12
............@.......
....................
.................@..
...@.@..@....@@.....
....................
........@...........
...@......@.@...@...
.....@........@.....
....@...@.@.........
....................
....@...............
....................
6
3 4 0
5 11 0
1 1 0
4 9 1
0 1 1
19 2 1

19 8 0
6 9 0
13 1 0
1 2 1
9 3 1
15 3 1
