width 20
height 12
............@@@.....
....................
...@.@....@.........
...........@.@...@..
......@...........@.
....@.....@...@.....
....................
..@....@........@...
........@...........
....@@@.............
..@..@@@@....@......
@....@@@@...........
6
14 2 0
18 8 0
10 10 0
16 1 1
1 5 1
15 2 1

1 6 0
16 8 0
19 4 0
15 4 1
9 11 1
18 9 1
