width 19
height 19
....@.@@@..@@@...@@
........@...@@..@@@
..................@
..................@
........@.....@....
.............@@....
..@................
...................
@@.................
@@.........@....@..
.......@@.....@.@@.
........@..........
@............@@@@@@
@............@@@@@@
@...........@@@@@@@
......@.....@@@@@@@
......@.....@@@@@@@
..........@.@@@@@@@
..........@@@@@@@@@
8
7 17 0
3 16 0
8 5 0
0 7 0
4 11 0
2 15 0
8 13 0
11 5 0

9 6 0
4 8 0
8 8 0
0 11 0
10 14 0
8 6 0
5 14 0
2 18 0
