width 19
height 19
...@@......@@@@@@@@
...@@........@@.@@@
................@@@
...........@@...@@@
...........@....@@@
......@@@..........
....@@.@@@@.@@.....
........@@@@@......
......@@.@@@.......
...................
@@@......@@....@@..
@@........@@.......
.......@@@@@.....@.
........@@.........
.....@@@@@.........
..................@
..................@
...@@............@@
...@.........@@@.@@
8
8 2 0
16 5 0
10 3 0
13 3 0
17 15 0
9 11 0
17 10 0
15 2 0

15 1 0
16 5 0
6 0 0
0 18 0
0 0 0
14 5 0
8 2 0
18 13 0
