width 19
height 19
@...@@@...@.@@@@@@@
.....@@......@@@@@@
..................@
......@...........@
.....@............@
.....@...@......@@@
................@@@
...@@...........@@@
...@...........@@@@
.................@@
@............@@@@@@
........@....@@@@@@
.......@@...@@@@@@@
.......@@...@@@@@@@
........@@..@@@@@@@
....@@........@@@@@
..@@@..........@@@@
..@@@..........@@@@
..@@@@......@..@@@@
8
6 13 0
8 16 0
0 3 0
17 3 0
0 14 0
13 16 0
2 11 0
11 3 0

17 2 0
6 13 0
2 5 0
8 2 0
7 1 0
5 17 0
12 6 0
11 11 0
