width 19
height 19
..@@@@@@@@@@@@.@@.@
.......@@@@@@..@...
.......@@@@@...@...
........@@@@@......
........@@@@@@.....
.........@@@@@.@...
.....@...@...@.@..@
...................
@@..@............@.
@@...............@.
@@...@@............
@@.................
@@.................
@@@.......@........
@@@@@....@@@@....@.
@@@@@......@@......
@@@@@....@......@@.
@@@@@.......@...@@@
@@@@@@@....@@@.@@@@
8
7 16 0
6 2 0
6 15 0
17 0 0
3 12 0
16 7 0
16 12 0
16 1 0

12 9 0
4 9 0
3 13 0
15 13 0
1 4 0
16 4 0
1 1 0
6 6 0
