width 92
height 92
.@..@@@@@@@@@@@@@@@@@@.....@@@@@@@@@@.........@@@@@@@@@@..@@@@@@@@@@@@@@@@@@@@@@@@.....@@@@@
....@@@@@@@@@@@@@@@@@@..@..@@@@@@@@@@..............@@..@.....@@@@@@@@@@@@@@@@@@@@@.....@@@@@
..@@@@@@@@@@@@@@@@@@@......@@@@@@@@@@.......@@....@@@..@.....@@@@@@@@@@@@@@@@@@........@....
...@@@@@@@...@@@@@@@@@......@@@@@@@@......@@@.....@@.............@@@@@@@@@@@@@...@..........
....@@@@.@@..@@@@@@@@@.@....@@@@..........@.@@.....@@@@.@...@.....@@@@@@@@@@@@...........@@.
....@@@........@@@@@@.......@@@@....................@@@.......@....@@@@@@@@@@@...........@@@
...............@@@@@@..................@.......@....@@@@.@@...@......@@@@@@@@@....@@@@...@@@
.............@.@@@@@@@......@..................@....@@@........@.....@@@@@@@@@...........@@@
........@........@@@@@@@...................@@@@@@....................@@@@@@@@@@...........@@
@@@....@@.......@@@@@@@...............@@.....@@@@@.....@.............@@@@@@@@@@.@..@......@@
@.........@....@.......................@......@@@@............@..@....@@@@@@@@@...........@@
...........@@...........@..........@..........@@@@..@@.......@..@......@@@@@@@@.......@.....
...........@@.......@..................@@@@@...@@@...@..........@.....@@@@@@@@@@@...........
........@..@@....@@@@@@.......@@@.....@@@@@@.....@...@..@...........@@@@@@@@@@@@@...........
..@.....@...@@@.@@@@@@.@@@...@@@@....@@@.........@...................@@@@@@@@@..............
.@@...@.....@@@@@@@@@@.......@@@@.....@@..............@@....@...@....@@@@@@@@@..............
@@@...........@@@@@@@@........@@@@....................@...............@@@@@@@@......@..@...@
.@...@..@..........@@@.......@@@@@....@@..............................@@@@@..@..............
...................@@@@@@......@@......................................@@@@..@.............@
...................@@@@...@.........................@@@.........@@.....@@@@....@............
..............@....@@@@....@........@@@@....@@.............@..........@@@@@@..............@@
.......@......@..@@@@@....@@...@....@@@@@....@..@.........@@.............@@@@............@@@
.........@........@@@@........@.....@@@@@..@.........@@...................@@@........@...@@@
...............@...@...@....@@@...............@......@@....................@@@.......@@@.@@@
..............@@.......@....@................@@......@@............@@@.....@@@@@@...@@.@....
.......................@......................@..@@...............@@@@......@@@.....@@.@....
........................................@.....@.@...@.....@@@.....@@@@.....@@@@...@.........
....................................@.......................@.....@@@@@.....@.....@....@....
.........@@@......@....@................@...............@......@...@@@@.....@@..@.@.@..@....
.......@@.@...............................@@.....................@@@@@@..@.@@@@.............
@..@....@.................................@.......................@@.....@@@@@.............@
...@............................@......................@....@....@@@......@.................
.........@@@..@.........@.......@................@.....@@...@@@@@@@@......@@........@@......
................@...............@@@..@.................@@@..@@@@...........@........@.......
.........................@.................@...@............@@@@@@.........@................
@.......@@..@..................@........................@.@@@@@@@@...@@.....................
.........@@..@.....@.@.........@.............@........@@@@@@@@@@@@@...@.....................
.......@@@.........@@....@....@@..............@.......@..@@@@@@@@@..........................
@..................@....@@.....@........................@@@@@@@@@@..........................
.................@.....@@@........................@.......@@@@@@@...@......................@
..........@@@.........@@@@.........@...@....@@.@@.@.@@....@@@@......@@.................@...@
.......@....@...........@..........@.........@@@@@@@@@......@@.@...@@@@...............@@@@@@
..................@...........@....@........@@@@@@@@@@.....@@@.....@@.................@@@@@@
...@..........................@@.............@@@@@@@@@...........@@@@@.........@.@....@@@@..
...@....................@.....@...........@...@@@@.@@..............................@..@@@@..
...@.......................@@@@@...@...............................................@....@@..
.....................@....@@@@@@............................@@@........@..@.@......@....@@..
......@.......@.............................................@@@@.......@...@@@@....@........
@.....@@..................@@............@@..@.@.@@.........@@@@@...........@@@@.............
.....@@@@......@@.........@@................@@@.@@..@.....@@@@@@.........@@.@@@.......@.....
@....@@@@@.........@..@..@@@..@@...@@.......@@@@@@@@.......@@@@@.........@...@@......@@.....
@@@@@@@@@@@..................@@@...@@..@@@......@@@........@@@@@...@................@.......
@@@@@@@@........@....@.........@...@..@@@.......@@..........@@@@............................
@@@@@@@@@...............@@............@@@@................@.@@@@@.............@.............
@@@@@@@@@@............@................@@@..................@@@@@..@@@...@@.................
@@@@@@@@@@........................@...@@@..............@.@@........@.....@@.....@........@..
@@@@@@@@@...@.........@.....@@@@@@@@..@@..@.@.....@..@@@@@@......@.@.....@...............@..
@@@@@@@@@@..@...........@.@.@@@@@@...................@@@@@.......@.@........................
@@@@@@@@@@..................@@@@@@...@.........@.....@@@@@@........@.......@.........@@@.@..
@@@@@@@@@@...........@....@.@@@@@....................@@@@...@......@.......@.........@@....@
@@@@@@@@@...@..@@..........@@@@@@.@....@@@..........@@@@@..................@.........@@...@@
@@@@@@@@...@@@@@..........@@@@..................@..@@@@@@@....@......@....@......@@...@@@@@@
@@@@@@@@.@@@@@@......@@@....@........@..........@@.@@@@@@@....@......@@......@........@@@@@@
@@@@@@@@@@@@@@@@..@@@@@@.............@....@@....@@.@@@@@@@...@@@...@@@@@@.........@.....@@@@
@@@@@@@@@@@@@@@@@...@.....................@........@@@@@@@....@@@....@@@@....@...........@..
@@@@@@@@@@@@@@@@@.............................@...@@@@@@@............@@.@@...@............@.
@@@@@@@@@@@@@@@@@.....@@....................@@....@@@@@@@@...@.......@..@@@.................
@@@@@@@@@@@@@@@@................@............@...@@@@@@@@@@@............@@@@.@@.............
@@@@@@@@@@@@@.@..............@@@@@..............@@@@@@@@@@@@@...........@@@@@@@@@...........
@@@@@.....@@..................@@@....@.......@@@@@@@@@@@@@@@@@@@.....@@@@@@@@@@@@..........@
@@@@@............@.............@........@...@@@@@@@@@@@@@@@@@@@@@@.@@@@@@@@@@@@@@..@@@.....@
@@@@@.....@.............@...................@@@@@@@@@@@@@@@@@@@@@@@@@@@@@@@@..@@....@@....@@
@@@@@@.......@..@........................@....@@@@@@@@@@@@@@@@@@@@@@@@@@@@@@@.........@....@
@@@@@@...................................@@@@.@@@@@@@@@@@@@@@@@@@@@@@@@@@@@@@........@@@....
@@@@@@.@...........@.....@....@............@@@@@@@@@@@@@@@@@@@@@@@@@@@@@@@@@@........@@@@@..
@@@@@..............@@@..@..................@@@@@@@@@@@@@@@@@@@@@@@@@@@@@@@@@@.........@@@@..
.....@..............@@@@@.........@.@@.....@@@@@@@@@@@@@@@@@@@@@@@@@@@@@@@@@..........@@@...
....................@@@@@.................@@@@@@@@@@@@@@@@@@@@@@@@@@@@@@@@@@........@..@...@
........@............@...@@..............@@@@@@@@@@@@@@@@@@@@@@@@@@@@@@@@@@@@.......@......@
.....@..@...@............@@.............@@@@@@@@@@@@@@@@@@@@@@@@@@@@@@@@@@@@@@.............@
............@.........@@.............@...@@@@@@@@@@@@@@@@@@@@@@@@@@@@@@@@@@@@@..@......@@@@@
......................@@@......@......@..@@@@@@@@@@@@@@@@@@@@@@@@@@@@@@@@@@@@@.......@@@@@@@
........@.................@........@..@...@...@@@@@@@@@@@@@@@@@@@@@@@@@@@@@@@@.......@@@@@@@
..@.......@@@........@.........@@.............@@@@@@@@@@@@@@@@@@@@@@@@@@@@@@@@@...@@@@@@@@@@
..@.....@@@@@............@@...@@@..............@@@@@@@@@@@@@@@@@@@@@@@@@@@@@@@@@..@@@@@@@@@@
....@..@@@@@@............@@@.@@@@@............@@@@@@@@@@@@@@@@@@@@@@@@@@@@@@@@@@@@@@@@@@@@@@
........@@@@@.@@........@@@@@@@@.......@......@@@@@@@@@@@@@@@@@@@@@@@@@@@@@@@@@@@@@@@@@@@@@@
@....................@..@@@@@@@................@@@@@@@@@@@@@@@@@@@@@@@@@@@@@@@@@@@@@@@@@@@@@
@..@..............@....@@@@@@@@@........@......@@@@@@@@@@@@@@@@@@@@@@@@@@@@@@@@@@@@@@@@@@@@@
@.........@@@.....@.....@@@@@@@@...............@@@@@@@@@@@@@@@@@@@@@@@@@@@@@@@@@@@@@@@@@@@@@
@...@.....@@@@@...........@@@@@@@......@@@......@@@@@@@@@@@@@@@@@@@@@@@@@@@@@@@@@@@@@@@@@@@@
....@@@@..@@@@...........@@@@@@@@.....@@@@@@@@..@@@@@@@@@@@@@@@@@@@@@@@@@@@@@@@@@@@@@@@@@@@@
8
45 86 0
80 23 0
36 69 0
91 14 0
42 37 0
39 71 0
36 36 0
86 14 0

31 64 0
1 3 0
86 12 0
3 89 0
40 29 0
81 10 0
39 78 0
79 31 0
