width 92
height 92
@@@@@@..@...............@@@@@@@@...@@@@@@@@@@@@@@..........@@@.....@@@@......@..@@@@@@@@@@@@
@@@@@@................@..@@@@@@.......@@@@@@@@@@.@@.................@@.@.......@@@@@@@@@@@@@
@@@@...........@......@......@........@@@@@@@@@@.......................@....@......@@@@@@@@@
@@@@@@....@...........................@@@@@@@@@@.........@....@@@@@.....@@.........@@@@@@@@@
@@@@@@@...@.....@@@......@...........@@@@@@@@..............@...@.@@@@..........@@..@.@@@@@@@
@@@@@..@.................@......@.......@@@@@.......@@....@@@....@@@@.....@@.@.@.......@@@@@
@@@@@..@@...........................................@@.........@@@@@@..........@.......@@@@@
@@@@@@...@..............@............................@........@@@@@...........@....@@@@@@@@@
@@@@@@...............@@............................@@@..........@@@@..............@@@@@@@@@@
@@@@@@...............@@@@@....................@...........@.....@.@........@......@@@@@@@@@@
@@@@@@.............@@@@@@@..@@...............@@@........@....@....................@@@@@@@@@@
@@@@........@......@@@@@@.....................@@.....@............................@@@@@@@@@@
@@@@................@@@@@...............@.....@.............@..@................@.@@@@@@@@@@
@@@@.@@@............@@@@@....................@@..................@@..@..@.....@.@@@@@@@@@@@@
@@@@@@@@....@@@@..@.@@@@@........................................@......@@....@..@@@@@@@@@@@
@@@@@@@@....@@@@@@@@@@@@@.........................@@.................@..@@......@@@@@@@@@@@@
@@@@@@@@....@@@@@@@@@@@@@....................@....@@@...............@...@@@@@....@@@@@@@@@@@
@@@@@@@....@@@@@@@@@@@@@.....................@......@.....@..............@@@@....@@@@@@@@@@@
@@@@@@@....@@@@@@@@@@@@@....@.............@@...................@.@.......@@@@.@....@@@@@@@@@
@@@@@@@@@@@@@@@@@@@@@@@@................@@@@@........................@@@..@@........@@@@@@@@
@@@@@@@@@@@@@@@@@@@@@@@@..............@@@@@@..@@....................@@@@..@.@...@.@@@@@@@@@@
@@@@@@@@@@@@@@@@@@@@@@@@.............@@@@@@@@.@@....@................@@.....@......@@@@@@@@@
@@@@@@@@@@@@@@@@@@@@@@@@................@@@@@@@@.....@@@.....@@@@...@@@@...........@@@@@@@@@
@@@@@@@@@@@@@@@@@@@@@@@@.......@........@@@@@@@@.....@@@...@@@@@@....@.............@@@@@@@@@
@@@@@@@@@@@@@@@@@@@@@@@@@@@....@@.......@@@@.@@@.....@@@@@@@@@@@@.................@@@@@@@@@@
@@@@@@@@@@@@@@@@@@@@@@@@@@@..............@@@...@.....@@@@@@@@@@.....@.............@@@@@@@@@@
@@@@@@@@@@@@@@@@@@@@@@@@@@@@@@@@.........@@@...........@@@.@@@.....................@@@@@@@@@
@@@@@@@@@@@@@@@@@@@@@@@@@@@.@@...........@.....@.......@@..@......................@...@@..@@
@@@@@@@@@@@@@@@@@@@@@@@@@@...........@..............@.............................@.@.@@...@
@@@@@@@@@@@@@@@@@@@@...@@...........@@@@........................................@..........@
@@@@@@@@@@@@@@@@@@@.@...............@@........................@...........@................@
@@@@@@@@@@@@@@@@@@.................@@@@..................@.......@...@....@@...............@
@@@@@@@...@@@@@.@................@.@.@@..........................@...@...@@@................
@@@@@@@...@..................@.@@@.@.........................@...........@@@@...............
@..................@..@@....@@@@@@......................@@..............@@@@@@.......@......
......................@........@.........................................@@@@@.............@
.........@.....................@..@..............@.....................@.@@@..............@@
............@........................@...@@.......................@@@@@@..................@@
@.@..............................@..@@............................@@@@@@..............@.....
@@@..............................@@.............................@@@@@@......@............@@@
@@@..........@.@...@@.....................@@............@.......@@@@@@.....................@
@@..@......@..@...@@@............................@.....@@@........@@@@......................
@@@@@.........@@.@@@@.........@....@.........@.........@@@........@@@.............@.........
@@@@@.........@...........@.............................@@....@......@......................
@@@@@@....@@..@..........................................@...@............@........@........
@@@@@@...@.......@........@..@.....@@......@......@................................@........
@@@@@@...@.......@........@@@@@@.............@..........@...@.........................@@@@@@
@@@@@@...@@@@...........................@...............@...@....@..@.........@@@@@@@@@@@@@@
@@@@@....@@@@..........................................................@......@@@@@@@@@@@@@@
@@@@@...@@@@...@..........@........@@@.....@.....@.....@.....@@....@@.........@@@@@@@@@@@@@@
@@@@@...@....@..........@@@....@................@..........@.@....@@@@@......@@@@@@@@@@@@@@@
@@.@@@.......@...........@@@@@@...................................@@@@@...@.@@@@@@@@@@@@@@@@
@@.@@@........@@..@@@@@@@@@@@@@@@.............@...............@...@@@@...@@@@@@@@@@@@@@@@@@@
...@@.........@.@@@@@@@@@@@@@......@...@.....@.....................@...@.@@@@@@@@@@@@@@@@@@@
..@@...@........@@@@@@@.....@@.....@...................................@@@@@@@@@@@@@@@@@@@@@
................@@@@@@@.....@@@................@@@.....................@@@@@@@@@@@@@@@@@@@@@
@..@...@......@@@@@@@@@.....@@@..............@@@@........@@@.......@@.....@@@@@@@@@@@@@@@@@@
@@@@......@@@@@..@@..........................@..@..........@@..@..........@@@@@@@@@@@@@@@@@@
@@@@.......@@@..........@@..........@@...@.........@.............@.....@@.@@@@@@@@@@@@@@@@@@
@@@@.@@..............................@@@@@@.................@..........@@@@@@@@@@@@@@@@@@@@@
@@.....................................@@.......................@......@@@@@@@@@@@@@@@@@@@@@
.....@.........@......@..................................@...........@.@@@@@@@@@@@@@@@@@@@@@
.....@.........@....@..@@@........@...................@@...........@....@@@@@@@@@@@@@@@@@@@@
....@@....@............@@@@....@.....................@@@@..............@@@@@@@@@@@@@@@@@@@@@
@@...@..........@@......@@@.....@@@...@@.............@@..@.............@@@@@@@@@@@@@@@@@@@@@
@@@...........@..........@@@....@@@@@..@.........................@.......@@@@@@@@@@@@@@@@@@@
@@@@@@.........@...........@....@@@@@........@...@......@.......@@@..@...@..@@@@@@@@@@@@@@@@
@@@@@...........................@..............@............................@@@@@@@@@@@@@@@@
@@@@@@..........................................@@........................@.@@@@@@@@@@@@@@@@
@@@@@@@......@..@@....@.................................@.....@..........@@@@@@@@@@@@@@@@@@@
@@@@@@@@........@@...............................@@...........@..........@@@@@@@@@@@@@@@@@@@
@@@@@@@@......@@@@@............@.................@@.@@.@...@.............@@@@@@@@@@@@@@@@@@@
@@@@@@@@@@@...@@.@@..............................@@......................@@@@@@@@@@@@@@@@@@@
@@@@@@@@@@.................................@.....@@........@@........@@..@@@@@@@@@@@@@@@@@@@
@@@@@@@@@..@@.....@......@@.....@..........@............@.@@@..@@........@@@@@@@@@@@@@@@@@@@
@@@@@@@@@.@@@@...@@@....@@@..........................@..@@@@@@@@@@.......@@@@@@@@@@@@@@@@@@@
@@@@@@@@...@@@....@@....@...............................@@@@@@@@@@@@....@@@@@@@@@@@@@@@@@@@@
@@@@@@@@....@@.............@@..@@....@.....@@........@@@@@@@.@@@@@@.....@@@@@@@@@@@@@@@@@@@@
@@@@@@@@....@@@......................@.......@.......@...@@@.@@@@@...@.@@@@@@@@@@@@@@@@@@@@@
@@@@@@@.....@@@...@......@@@........................@@....@...@@....@@@@@@@@@@@@@@@@@@@@@@@@
@@@@@@@@....@@@@@@@......................@@........@@@.........@....@@@@@@@@@@@@@@@@@@@@@@@@
@@@@@@@@@..@@@@@@@@..............@..@...............@...............@@@@@@@@@@@@@@@@@@@@@@@@
@@@@@@@@@..@@@@@@@@@@@@...@@...@....@.........@................@@@.@@@@@@@@@@@@@@@@@@@@@@@@@
@@@@@@@@@..@@@@@@@@@@@...@@@@..@.......@@...@...........@.....@@@@@@@@@@@@@@@@@@@@@@@@@@@@@@
@@@@@@@@...@@@@@@@@@@....@@@@..@.......@...........@@.........@@@@@@@@@@@@@@@@@@@@@@@@@@@@@@
@@@@@@@....@@@@@@@@@@...@@@@.......................@@@@.@...@.@@@@@@@@@@@@@@@@@@@@@@@@@@@@@@
@@@@@@@..@..@@@@@@@@@@@...@.........@..............@@@@@@@..@.@@@@@@@@@@@@@@@@@@@@@@@@@@@@@@
@@@@@@@..@..@@@@@@@@@@..@@@@...................@@..@@@@@@@@@@@@@@@@@@@@@@@@@@@@@@@@@@@@@@@@@
@@@@@@@@.....@@@@@@@@..@@@@..............@@....@....@@@@@@@@@@@@@@@@@@@@@@@@@@@@@@@@@@@@@@@@
@@@@@@@@..@@@@@@@@@@@@.@@@.............@....@..@.@..@@@@@@@@@@@@@@@@@@@@@@@@@@@@@@@@@@@@@@@@
@@@@@@@@@@@@@@@@@@@@@@...@...@.....@.......@@........@@@@@@@@@@@@@@@@@@@@@@@@@@@@@@@@@@@@@@@
@@@@@@@@@@@@@@@@@@@@@@...@@@@@@@@@@@@@@....@@@....@@@@@@@@@@@@@@@@@@@@@@@@@@@@@@@@@@@@@@@@@@
8
38 22 0
76 46 0
36 87 0
33 48 0
28 85 0
58 8 0
30 38 0
19 48 0

33 87 0
11 11 0
66 10 0
37 50 0
11 73 0
8 77 0
80 3 0
22 89 0
