width 92
height 92
@@@@@@@@@@@@@@@@@@@@......@@@...@.@@@@@@@..@@@@@@@@@@@@@@@@.......@@@@@@@@@@@@@@@@.@@@......
@@@@@@@@@@@@@@@@@@@@@.....@@@.....@@.@@@@....@@@@@@@@@@@@.......@...@@@@@@@@@@@@@....@......
@@@@@@@@@@@@@@@@@@.@.............@@@...........@@@@@@@@.............@@@@@@@@@@@@.....@......
@@@@@@@@@@@@@@@@@@........@.....@@@..............@@@@@@.............@@@@@@@@@@@@.@..........
@@@@@@@@@@@@@@@@@@@.......@@@...@@................@.@@@.....@@@......@@.@@@@@@@@@@..........
@@@@@@@@@@@@@@@@@@@.......@@@........@@@............@@@@.....@@......@@...@@...@@@..........
@@@@@@@@@@@@@@@@@@....@@@@@........@@@@........@@..@@@@@........@.....@...@@...@@@..@.......
@@@@@@@@@@@@@@@@@@@@...............................@@@@@@@......@..........@...@@@..........
@@@@@@@@@@@@@@@@@@@@...................................................@@@@....@@@..........
@@@@@@@@@@@@@@@@@@@..............@.........@......@@.................@@@@@...@...@..........
@@@@@@@@@@@@@@@@@@@......@.@@@..@@..........@@....@@...@@@@...........@@@...................
@@@@@@@@@@@@@@@@@@@..@@....@@@@@@@....@..@@@@@.....@.@@@@@@...........@@..............@....@
@@@@@@@@@@@@@@@@@@@.......@@@@@..........@@@@@..@..@..................@.....................
@@@...@@@@@@@@@@@@@@@....@@..............@@@..........................@.........@.......@..@
..@.@@@@@@@@@@@@@@@@@..@.....@.......@..@@@@@.......@.......@.............@@....@@......@...
.......@@@@@@@@@@@@@@@......@@...............................@...@@@@@....@.......@....@@...
...@...@@@@@@@@@@@@@@......................@.......@................@.....@.................
.......@@@@@@@@@@.@@@@............................@...@....@..@@....@...............@.......
.........@@@@@....@@@.........................@..........@@@......@.....................@@.@
.....@@..@@@@....@@@...........................@@......@........@@@@........@...............
.........@@@..@..@......................@.......@@@@@@@@.......@@@@@........@...............
......@..@@@@..................@.....@............@@@@@..@.....@@@@@@.........@.......@@....
...........@@.................@@@...@......@......@@....@@.....@...@@@........@.......@@....
.@@.@@......@..............@@@@..........@@@............@......@..........@...........@@@...
.@@@@@....................@@@@@..........@@@...................@............................
.@@@@.........@.......@@@@@@@.........@@@@@@............................@@..................
.@@..@.......@@@......@@@@@@@@@...........@@....@...@@@.@@..............@...........@...@.@.
.............@@@.......@@@@@.............@.@...@....@@.....@....................@...@.......
....................@..@@@@@@.......@@@@@@.....@@@....................@..................@..
.......@@...........@@@@@...@.@......@@@.....@@@..................@@@...........@....@@.....
........@...@@@.....@@@@@@.@@@......@.@@..........................@@@..........@@...........
............@@@@......@.@..@@.........@..........................@@@@..........@@...........
...@....@...@@@....@@@............................................@............@@..@....@...
...@..........@@...@@@@@@@........@..........@@@............................................
..............@@...@@@@@@@...................@@@@..@...@@@@.....................@..@........
@....@.............@@@@@@@.@@...............@@@@@.@@@@@@@@@...................@@@@@@@@......
............@......@@@@.................@@....@@@@@@@@@@@@@.@........@@....@@..@@@@@@.......
@.........@.........@@@@@@..............@.......@@@..@..@@@@@@........@@@@@@@@..@@@@@....@..
...@..........@......@@.................................@@@@@@.........@@@@@@@..@@@@.@......
...............@@..@.@@..@..@.................@@@.........@@@........@@@@@@@@@.......@......
..............@@@....................@....@...........@.....@...@@...@@@@@@@@@.......@......
........@..@..@@@@@@..................................@@........@......@@@@@@@@@@.....@@@...
..............@@@@@@...@.@............................@@@@.............@@@@@@@@@.......@@...
@.............@@@@@@@@@@@@@@@.@........................@..........@....@@@@@@@@.............
@.............@@@@@@@@@@@@@@@@@....@...........@@@.......@..@@..@@....@@@@@@@@@@.......@....
@.@........@.@@@@@@@@@@@@@@@@@.....@...........@@@.............@....@@@@@@@@.....@@....@....
..............@@@@@@@@@@@@@@@@.................@@@...@...@.................@.....@@..@.@..@@
...........@@@@@@@@@@@@@@@@@@@................@@@@.................................@@@@@...@
........@@..@@@@@@@@@@@@@@@@@@..@.........@@....@..................................@@@@@...@
.............@@@@@@@@@@@@@@@@@@@@@@@@....................@...............@@@@@@@..@@@@@....@
..............@@@@@@@@@@@@@@@@.@@@@@@@..........@........@.............@@@@@..@@....@@@....@
......@...........@@@@@@@@@@@@..@@@@.....@....................................@@@@..........
@................@@@@@@@@@@@@@...@@@@....@..................................................
@@........@.............@@@@@@...@@@.........@..........................@.@......@....@.....
@@@..................@......@@...@@.....@@@@@@...................................@....@@....
@@..@@@@@......@....@@............@@...@@@@@@@..@.........@.........@@..........@@......@@..
@@.@@@@@...@@......@@@............@@..@@@@@@@@@.....@...@..........@@....................@..
@@@@@@@@....@.......@@.............@...@@@@@@@@@..................@@@@....................@@
@@@@@.......@..@..........@...@........@@@@@@@@@@..................@....@.....@...........@.
...@@@...@.@@@@@..............@...@....@@@@@@@@@@@@..@@@...................@.@@@@.....@...@.
.........@..@@@@......................@@@@@@@@@@@@..@@@@.................@@@@@@@......@.....
.....@@......@@@.@.@..@..@............@@@@@@@@@@@@@.@@@@.....@......@....@@@@@@@..........@@
.....@@@@..........@@............@....@.@@@@@@@@@@@@@@@@.....@@........@@@@@@@@...........@@
...@@@@@@...............@....@@@@@......@@@@@@@@@@@@@@@@@@...@@@@...@...@@@@@@@@...@@@@..@@@
@@..@.@............@....@.....@@@......@@@@@@@@@@@@@@@@@@@..@@@@@.....@@@@@@@@@@@@@@@@@@@@@@
@@.....@@...........@..................@@@@@@@@@@@@@@@@@@@@@@@@@....@@@@@@@@@@@@@@@@@@@@@@@@
...................@@........@@...@.@@@@@@@@@@@@@@@@@@@@@@@@@@@@@@..@@@@@@@@@@@@@@@@@@@@@@@@
..................@@.............@...@@@@@@@@@@@@@@@@@@@@@@@@@@@@...@@@@@@@@@@@@@@@@@@@@@@@@
....@............................@...@.@@@@@@@@@@@@@@@@@@@@@@@@@@@@.@@@@@@@@@@@@@@@@@@@@@@@@
.......@.................@..............@@@@@@@@@@@@@@@@@@@@@@@@@@@@@@@@@@@@@@@@@@@@@@@@@@@@
...@...@@@...@.@@@...@.....@@.....@@.....@@@@@@@@@@@@@@@@@@@@@@@@@@@@@@@@@@@@@@@@@@@@@@@@@@@
.@@@@@@@@@@.@@@@@@.........@@@...........@@@@@@@@@@@@@@@@@@@@@@@@@@@@@@@@@@@@@@@@@@@@@@@@@@@
.@@@@@@@@@@.@...............@......@@.......@@@@@@@@@@@@@@@@@@@@@@@@@@@@@@@@@@@@@@@@@@@@@@@@
.@@@@@@@@@@@@@..@....@.@@..@@.......@@@.....@@@@@@@@@@@@@@@@@@@@@@@@@@@@@@@@@@@@@@@@@@@@@@@@
@@@@@@@@@@@@@@......@@@@....@@.@@............@@@@@@@@@@@@@@@@@@@@@@@@@@@@@@@@@@@@@@@@@@@@@@@
@@@@@@@@@@@@@..................@@..@@.@......@@@@@@@@@@@@@@@@@@@@@@@@@@@@@@@@@@@@@@@@@@@@@@@
@@@@@@@@@..@........@........@@@@.@@@@@...@@@@@@@@@@@@@@@@@@@@@@@@@@@@@@@@@@@@@@@@@@@@@@@@@@
@@@@@@@@@..................@@@@@@@@@@@@@..@@@@@@@@@@@@@@@@@@@@@@@@@@@@@@@@@@@@@@@@@@@@@@@@@@
@@@@@@@...................@@@@@@@@@@@@@@.@@@@@@@@@@@@@@@@@@@@@@@@@@@@@@@@@@@@@@@@@@@@@@@@@@@
@@@@@@@@@@......@@.......@@@@@@@@@@@@@@@@@@@@@@@@@@@@@@@@@@@@@@@@@@@@@@@@@@@@@@@@@@@@@@@@@@@
@@@@@@@@@@@.....@@@.....@@@@@@@@@@@@@@@@@@@@@@@@@@@@@@@@@@@@@@@@@@@@@@@@@@@@@@@@@@@@@@@@@@@@
@@@@@@@..........@@......@@@@@@@@@@@@@@@@@@@@@@@@@@@@@@@@@@@@@@@@@@@@@@@@@@@@@@@@@@@@@@@@@@@
@@@@@@@...........@@......@@@@@@@@@@@@@@@@@@@@@@@@@@@@@@@@@@@@@@@@@@@@@@@@@@@@@@@@@@@@@@@@@@
@@@@@@@...........@@......@@@@@@@@@@@@@@@@@@@@@@@@@@@@@@@@@@@@@@@@@@@@@@@@@@@@@@@@@@@@@@@@@@
@@@@@@................@@....@@@@@@@@@@@@@@@@@@@@@@@@@@@@@@@@@@@@@@@@@@@@@@@@@@@@@@@@@@@@@@@@
@@@@@@@@@...........@.......@@@@@@@@@@@@@@@@@@@@@@@@@@@@@@@@@@@@@@@@@@@@@@@@@@@@@@@@@@@@@@@@
@@@@@@@@.............@@....@@@@@@@@@@@@@@@@@@@@@@@@@@@@@@@@@@@@@@@@@@@@@@@@@@@@@@@@@@@@@@@@@
@@@@@@@.....@....@@@@@.....@@@@@@@@@@@@@@@@@@@@@@@@@@@@@@@@@@@@@@@@@@@@@@@@@@@@@@@@@@@@@@@@@
@@@@@@........@....@@@.....@@@@@@@@@@@@@@@@@@@@@@@@@@@@@@@@@@@@@@@@@@@@@@@@@@@@@@@@@@@@@@@@@
@@@@@@...@.@......@@@@...@@@@@@@@@@@@@@@@@@@@@@@@@@@@@@@@@@@@@@@@@@@@@@@@@@@@@@@@@@@@@@@@@@@
@@@@@@@..@@@@.....@@@....@@@@@@@@@@@@@@@@@@@@@@@@@@@@@@@@@@@@@@@@@@@@@@@@@@@@@@@@@@@@@@@@@@@
@@@@@@@@@@@@@.....@@@@.@@@@@@@@@@@@@@@@@@@@@@@@@@@@@@@@@@@@@@@@@@@@@@@@@@@@@@@@@@@@@@@@@@@@@
8
36 7 0
53 40 0
86 28 0
35 3 0
47 26 0
48 5 0
25 31 0
0 62 0

7 81 0
55 52 0
76 52 0
56 16 0
40 22 0
90 33 0
78 13 0
23 59 0
