width 20
height 41
@@...@..........@@..
@..@......@...@.....
......@....@........
.......@............
..........@.....@...
..@...........@.....
....................
.....@....@.........
...@..........@...@.
.@...............@..
....@.@.@....@......
...........@........
....@...........@...
..........@.@..@....
.......@..........@.
....@...............
...@.@..............
.........@..........
...........@..@.@...
....................
............@......@
.......@...........@
....@.....@.........
......@......@......
.@.............@....
.......@.....@......
...@......@.........
....................
........@....@......
...........@.....@..
................@...
....................
...@.........@..@...
....................
....................
.....@.@............
..........@.@...@...
......@....@.....@..
.@............@.....
@.....@.............
@@..................
6
1 25 0
16 25 0
18 17 0
7 4 1
9 6 1
11 23 1

19 0 0
3 5 0
18 39 0
0 9 1
19 39 1
1 2 1
