width 20
height 41
.............@......
........@...........
.............@......
....@...........@...
.....@............@.
...@..@...@.........
..............@.....
....................
...@..@.............
....................
..........@.......@@
...@.........@......
.......@............
......@.@.........@.
@..@................
@............@....@@
@...@....@........@@
....................
...............@....
.............@......
......@.@...........
....................
.....@..............
.......@........@...
.@........@..@......
@...@..@............
@...................
....@...............
...........@........
....................
.....@.......@...@..
.@.......@..........
....................
............@.....@.
....................
......@....@......@.
....................
....................
@.......@......@....
@.............@.....
@@..................
6
11 26 0
19 29 0
19 31 0
3 40 1
2 34 1
1 36 1

5 0 0
18 26 0
19 3 0
0 7 1
3 39 1
4 6 1
