width 20
height 41
....................
....@...............
....................
...@........@.......
..........@.........
.@..................
...............@....
..@..@...........@..
......@.............
....................
......@....@.@......
...............@@...
......@.......@@@...
.......@............
.@.........@........
.........@......@...
...............@....
.@..@.@.........@...
.............@......
....................
...........@........
..@................@
.....@.@........@...
....@.@.....@.@.....
....................
..........@.........
....@@..@.....@.....
.@..................
.......@............
........@...........
.....@......@.......
.............@..@...
..........@.........
......@.........@...
@...................
....................
.....@..............
@...................
....................
.@......@......@....
....................
6
4 33 0
6 22 0
3 23 0
10 37 1
17 9 1
2 4 1

18 13 0
10 23 0
18 0 0
7 4 1
1 40 1
2 6 1
