width 20
height 41
.......@@...........
.......@@.....@.....
.......@............
..@.........@.......
........@...........
............@.......
..@.....@.......@...
...@................
............@..@....
.......@............
....................
........@...........
.................@..
....................
...........@..@@....
.@...........@...@..
@@..................
@@@.....@......@...@
..............@.....
.@..................
............@.@.....
....................
....................
......@...@.........
..@....@.....@.@...@
.................@.@
..@.........@.......
..........@......@..
....@...@...@.....@.
...@...@............
....@..............@
..........@.@......@
..@......@..........
....................
......@.......@.....
....@...............
.......@............
.....@.........@....
@.......@..@.....@..
..@.........@.......
@...@...............
6
7 7 0
16 15 0
18 34 0
19 36 1
10 34 1
8 30 1

9 15 0
15 22 0
13 22 0
3 30 1
11 23 1
10 35 1
