width 20
height 41
................@...
....................
..............@.@...
......@.............
..@......@.......@..
....@......@..@.....
....................
..@......@..........
...@...........@.@..
..........@.........
.....@..............
.....@........@.....
..@....@...@..@..@..
...@...@.@..........
.@@....@.........@.@
....................
..............@.@...
...@........@....@..
......@......@...@..
..................@@
..@.......@..@.@....
....................
.............@......
....@..@@..@.@......
...@...@....@.......
.......@............
........@...@.@.....
......@....@..@.@...
..@..............@..
.....@..............
...............@....
....@........@......
.....@...@..........
...................@
.......@...........@
..@............@...@
.@......@...@.......
....................
...@.@..@...........
..........@....@....
.............@...@@.
6
11 3 0
2 17 0
5 3 0
15 7 1
0 4 1
0 36 1

2 30 0
12 18 0
3 33 0
0 40 1
3 21 1
5 19 1
