width 20
height 41
....................
.......@............
.........@.....@.@..
..@.@...............
....................
....@..@.@...@.....@
.....@..........@...
.@............@.....
....@..@............
....@....@..@.@.....
...............@.@..
...@......@.........
.....@......@.......
@...................
@...@.......@...@...
@........@.@..@.....
@.......@...........
.............@......
.....@......@..@....
@......@.......@@.@.
@.............@.....
...@................
.....@..@.@......@..
..@.................
.................@..
.@..@.@.............
...@.....@.........@
...............@....
...@................
.......@............
......@.............
.....@..............
...........@........
.....@..............
........@.........@.
...@.....@.....@....
...........@......@@
....................
........@.........@.
............@.......
@..................@
6
2 9 0
12 4 0
15 31 0
16 38 1
14 5 1
11 22 1

2 27 0
16 33 0
18 3 0
15 16 1
0 33 1
0 1 1
