width 78
height 78
@@@@@@@@@@@@@@@@@@@@@@@@@@@@@@..@@....@@@............@@@@@@.....@@@@@@@@...@@@
@@@@@@@@@@@@@@...@@@@@@@@@@@@@........................@@@@@@....@@@@...@.@@@@@
@@@@@@@@@@@@@@........@@@@@@@@@......................@@@@@@@@....@@@......@@@@
@@@@@@@@@@@@@@........@@@@@@@@@@........@.......@@@@@@.@@@@@@...@@@@......@@@@
@@@@@@@@@@@@@..@.......@@@@..@@@...............@@@..@@..........@........@@@@@
@@@@@@@@@@@@.................@@....@@@.......@@@@.........................@@@@
@@@@@@@@@@@@@......@..@..............@................................@......@
@@@@@@@@@@@@@......@@......@.................@@....@@@.....@....@.....@.......
@@@@@@@@@@@@@@.............@........................@...........@@@...@.......
@@@@@@@@@@@@@........@@......@..........@.......@@...........@..@@@@@.@.......
@@@@@@@@@@@@@...........@....@@.................@@.......@..@...@@@@.........@
@@@@@@@@@@@@.....@@@....@.........@.............@@@............@@@@@@.........
@@@@@@@@@@@...........@.........@...............@@@@@@...........@@@.........@
@@@@@@@@@@@.......................................@@@@@..........@@...........
@@@@@@@@@@.........@.@..@@.................@.......@@@@@.........@@....@......
@@@@@@@@@@...@..................@.................@@@@...........@@@@@@......@
@@@@@@@@@@@@.@...@......@.........................@@@.....@.......@@@@@@@@....
@@@@@@@@@@@@@@.........@@@.......................@@@@.............@@@@@@@.....
@@@@@@@@@@@@@@@.....@@......@............@@@......................@@@@@@@@@...
@@@@@@@@@@@@@@@...@@@...........@........@@@............@.......@@@@@@@@@@....
@@@@@@@@@@@@@@@.@@@@.........@....@@.....@.....................@@@@@@@@@@@....
@@@@@@@@@@@@@@@..................@@@............................@@@@@@@@@.....
@@@@@@@@@@@@@@@@@@@.....................@.@.......@........@....@@@@@@.@......
@@@@@@@@@@@@@@@@@@@....@@....@..@.......@@@.......@......@.......@@@@.....@...
@@@@@@@@@@@@@@@@@@.....@@.........@@.@......@@..@.@.......@.......@.......@.@@
@@@@@@@@@@@@@@@@@@.....@@@..................@@@...@.......@.................@@
@@@@@@@@@@@@@@@@@....@.@....................@.............@@.@......@.......@.
@@@@@@@@@@@@@@@@@....@..............@...@.@......................@......@.....
@@@@@@@@@@@@@@@@@.........@....@...@@...@@@@.....................@............
@@@@@@@@@@@@@@@@.........@......@.@@@..@@@@....@..@.@.........................
@@@@@@@@@@@@@@@.....@...@@.........@@@@@@....@@...@@.......@@.....@......@@...
@@@@@@@@@@@...@........@..@.......@@@@@@@.........@@..........@......@....@...
@@@@@@@@@@@...@..............@@..@@.@@@@@@.........@....@@....................
@@@@@@@@@@@...@@@....................@@@@@@..............@............@..@@...
@@@@@@@@@@@....................@...@@@@@@@@..................@...@.......@....
@@@@@@@@@@@@......................@@@@@@@@@@@...............................@.
@@@@@@@@@@@@...@..................@@@@@@@@@@@@...@................@...........
@@@@@@@@@@@@@@..@@....@.@.@...@@@@@@@@@@@@@@@@..@.....@......................@
@@@@@@@@@@@@@@.......@@.@@.@@@@@@@@@@@@@@@@@@...@.........@@..................
@@@@@@@@@@@@@@........@@@...@@@@@@@@@@@@@@@@@@@@@.........@@............@.....
@@@@@@@@@@@@@@.@.......@@...@@@@@@@@@@@@@@@@@@@@@@.....@@@@@.@..@............@
@@@@@@@@@@@@@@@@@............@@@@@@@@@@@@@@@@@@@...@@.@@@@@@@@@.............@@
@@@@@@@@@@@@@@@@@@...........@@@@@@@@@@@@@@@@@@@@.....@@@@@@@@@..............@
@@@@@@@@@@@@@@@@@............@@@@@@@@@@@@@@@@@@@@.....@@@@@@@@............@...
@@@@@@@@@@@@@@@@........@..@@@@@@@@@..@@@...@@@@.......@.....................@
@@@@@@@@@@@@@@@@............@@@@@@@..........@@...........@.............@.....
@@@@@@@@@@@@@@@@@...........@@@@@@@....@......@@........@.......@............@
@@@@@@@@@@@@@@@@@...........@@@@@@..................@..@@@......@.............
@@@@@@@@@@@@@@@@@............@@@@...@@.@@.............@@@@............@.......
@@@@@@@@@@@@@@@@@@@........@...@...@@@................@@@@@.....@..@@@........
@@@@@@@@@@@@@@@@@@@................@@@................@@@............@........
@@@@@@@@@@@@@@@@@@@................@@....@....@..@....@@@@....................
@@@@@@@@@@@@@@@@.@@...............@@@@................@@@@....................
@@@@@@@@@@@@@@@..............@.......@..............@..@.@@@@@.......@...@....
@@@@@@@@@@@@@..................................@@..@@....@@@@@@..........@@...
@@@@@@@@@@@................................@@@@@@...@....@@@@@...........@....
@@@@@@@@@@@................@..............@@@@@@........@@@@@............@...@
@@@@@@@@@@@..@@...................@........@@.@.........@@@@@@...........@..@@
@@@@@@@@@@@@@@@...............................@...@.......@@@@.......@.......@
@@@@@@@@@@@@@@@@..@....................@......@...@.........@@@......@.......@
@@@@@@@@@@@@@@@...@@...........@.@@...............@.........@@@...............
@@@@@@@@@@@@@@@..................@@..@........................................
@@@@@@@@@@@@@@...................@@......@...........................@........
@@@@@@@@@@@@@@.....@@@@...........@......@..................@.................
@@@@@@@@@@@@@@@....@..............@@................@..@.......@....@.........
@@@@@@@@@@@@@@@.@...........@@.....@.................@........@...............
@@@@@@@@@@@@@@@@@........@@@.................@.......@........@@@@@........@..
@@@@@@@@@..@..@@...........@.@@................@@........@...@@@@@@@....@.....
@@@@@@@@....................................................@@@@@@@@@@...@@...
@@@@@@@........@@@.............................@@.....@.....@@@@@@@@@@@@@@@..@
@@@@@@................@@..@@@....@@@@@........@@@............@@@@@@@@@@@@@@@@@
@@@@@@....@@@.............@@@@....@@@@.@@..................@@@@@@@@@@@@@@@@@@@
@@@@@@@@.@..@.............@@@@@...@@@@..@....@@@.....@.....@@@@@@@@@@@@@@@@@@@
@@@@@@@@......................................@@...........@@@@@@@@@@@@@@@@@@@
@@@@@@@@.@@.................................@@@@..@.......@@@@@@@@@@@@@@@@@@@@
@@@@@@@@@@@.........@.................@@.....@@@..........@@@@@@@@@@@@@@@@@@@@
@@@@@@@@@@@....@@@...........@@....@@@@@@@....@@.........@@@@@@@@@@@@@@@@@@@@@
@@@@@@@@@@@..........@@.@....@@@@..@@@@@@@....@@@@......@@@@@@@@@@@@@@@@@@@@@@
8
36 12 0
75 30 0
35 46 0
28 63 0
61 46 0
21 6 0
60 70 0
46 67 0

76 67 0
77 33 0
30 11 0
73 0 0
63 61 0
20 6 0
49 32 0
16 5 0
