width 78
height 78
@@@@@@@@@@@@......@@@@@...........@.......@............@@@.........@.......@@@
@@@@@@@@@@.......@@@@@@...................@.@.@..................@@@.........@
@@@@@@@@......@@@@@@@@@.................................@.....................
@@@@@@@@......@@@@@@@@@......................................@.....@@....@....
@@@@@@@@@.....@@@@...................@....@..........@.......@....@@@@........
@@@@@@@@@@..@@........@.@@...........@............................@@@@........
@@@@@@@@@............@@.@.@@@@.......@........................................
@@@@@@@@@........@....@@@.@@@@@@.....@......................@...............@@
@@@@@@@@@@@....@............@@.......@......................................@@
@@@@@@@@@@@................@.......................@...@@...@.......@..@.....@
@@@@@@@@.........@..@....@@@@@@@..@...........@@.......@@..@.................@
@@@@@@@@.........@@@@....@@@@@@@@.............@@@..........@@@@@.@.......@..@@
@@@@@.....@@.....@@@@....@@@@@@@@.............@@@.......@@@@@...........@...@@
@@@@@............@@@..@.@@@@@@@@@@@..@@..@@....@@.......@@@@................@@
@@@@@@@..........@@@......@@@....@.......@@.....@@......@@......@@@.........@@
@@@@@@@......@............@@...............@....@@@.............@@@@@.@@......
@@@@@@@@.....@...................@@.@.........@..@@..@@.@......@@@@.@@........
@@@@@@@@@....@..................@@.............@@@@..@..@@...@....@..........@
@@@@@@@@@@....@@.................@@@............@@@...@..@............@@.....@
@@@@@@@@@@@.@@@@.................@@@............@@....@...@.........@@@@@@@..@
@@@@@@@@@@@@@@@@.............@....@..@@..........@........@...@@@..@@@@@@@@..@
@@@@@@@@@@@@@@@.........@@@..........@..............@..........@...@@@@@@@...@
@@@@@@@@@@@@@@@@@....@........@....@............@....@@..@@@@@@@@@@@@@@@@@@@@@
@@@@@@@@@@@@@@@@@......................@@.......@......@.@@@@@@@@@@@@@@@@@@@@@
@@@@@@@@@@@@@@@@@@@@...@@..@@..........@...................@@@@@@@@@@@@@@@@@@@
@@@@@@@@@@@@@@@@@@@.....@....@.............@.@.............@@@@@@@@@@@@@@@@@@@
@@@@@@@@@@@@@@@@@@.................@@@.....@.@@............@...@@@@@@@@@@@@@@@
@@@@@@@@@@@@@@@@@@.........@.....@@@@@@................@@........@@@@@@@@@@@@@
@@@@@@@@@@@@@@..@@...............@@@@.....@........@..@@@..........@@@@@@@@@@@
@@@@@@@@@@@@@@.................@...@.........@..........@@.........@@@@@@@@@@@
@@@@@@@@@@@@@@.................@............................@......@@@@@@@@@@@
@@@@@@@@@@@@@@@@@.@................@......@@.........@............@@@@@@@@@@@@
@@@@@@@@@@@@@@@.@@@@@@........@....@.................@..........@..@.....@@@@@
@@@@@@@@@@@@@@@....@@@@......@........@.....@........@.@.....@..........@@@@@@
@@@@@@@@@@@@@@...........................@...............@@@@@..@@......@@@@@@
@@@@@@@@@@@@@@@@@....................@..........@@.......@@@@@.@@@.......@@@@@
@@@@@@@@@@@@@@@@@@.........@.................................@@@@@@@@....@@@@@
@@@@@@@@@@@@@@@@@@..............@...........@......@.........@@@@...@....@@@@@
@@@@@@@@@@@@@@@@@@@....@.....@..@@....@............@@@@..@...@...........@@@@@
@@@@@@@@@@@@@@@@@@@@@...........@@.......@........@@@@...@..@@...........@@@@@
@@@@@@@@@@@@@@@@@@@@@.......@.....................@@@@......@@.....@@...@@@@@@
@@@@@@@@@@@@@@@@@@@@..@...@...........@...........@@@@.............@@@@@@@@@@@
@@@@@@@@@@@@@@@@@........@...........@@............@@@...............@@@@@@@@@
@@@@@@@@@@@@@@@@@........@@.@@.....@@@@.......@@@...................@@@@@@@@@@
@@@@@@@@@@@@@@@@@.@........@@@@@..@@@@@..@....@@@............@......@@@@@@@@@@
@@@@@@@@@@@@@@@@@@@@@......@@@@@@@@@@@@....@.@@@@.............@@@....@@@@@@@@@
@@@@@@@@@@@@@@@@@@@@@..@@.@@@@@.@@@@@@..@....@..@.@..@.....@..@@@....@@@@@@@@@
@@@@@@@@@@@@@@@@@@@@@..@@.@@@@...@@@@...........@..@..@..@@@..@@@@@@.@@@@@@@@@
@@@@@@@@@@@@@@@@@@@@@.............@@@..@@.....................@@@@@@.@@@@@@@@@
@@@@@@@@@@@@@@@@@@@@...................@@.................@@...@@@@@.@@@@@@@@@
@@@@@@@@@@@@@@@@@@@@..................@@@......@..........@....@@@@@@@@@@@@@@@
@@@@@@@@@@@@@@@@@@@@..........................@@..........@....@@.@@@@@@@@@@@@
@@@@@@@@@@@@@@@@@.@@............@.................................@@@@@@@@@@@@
@@@@@@@@@@@@@@@@@............@@@@.......................@.......@@@@@@@@@@@@@@
@@@@@@@@@@@@@@@@@............@@@......@@............@...........@@@@@@@@@@@@@@
@@@@@@@@@@@@@@@@@@@.........@@@................@......@........@@@@@@@@@@@@@@@
@@@@@@@@@@@@@@@@@@@@@.......@............................@@@@@@@@@@@@@@@@@@@@@
@@@@@@@@@@@@@@@@@@@@@@......@............@@@@............@@@@@@@@@@@@@@@@@@@@@
@@@@@@@@@@@@@@@@@@@@@@........@..@....@@@@@@@........@...@@@@@@@@@@@@@@@@@@@@@
@@@@@@@@@@@@@@@@@@@@@@@..@.............@@@@@@.....@@@...@@@@@@@@@@@@@@@@@@@@@@
@@@@@@@@@@@@@@@@@@@@@@@@....@@.@.......@@@@@@@@@@@@@@@..@@@@@@@@@@@@@@@@@@@@@@
@@@@@@@@@@@@@@@@@@@@@@@@....@@.....@...@@@@@@@@@@@@@...@@@@@@@@@@@@@@@@@@@@@@@
@@@@@@@@@@@@@@@@@@@@@@@@..@............@@@@@@@@@@@@@@.@@@@@@@@@@@@@@@@@@@@@@@@
@@@@@@@@@@@@@@@@@@@@@@@@@@...........@@@@@@@@@@@@@@@@....@@@@@@@@@@@@@@@@@@@@@
@@@@@@@@@@@@@@@@@@@@@@@@.............@@@@@@@@@@@@@@@@@...@@@@@@@@@@@@@@@@@@@@@
@@@@@@@@@@@@@@@@@@@@@@................@@@@@@@@@@@@@@@...@@@@@.@@@@@@@@@@@@@@@@
@@@@@@@@@@@@@@@@@@@@@@....@......@@.....@.@@@@@@@@@@@.....@@@.@@@@@@@@@@@@@@@@
@@@@@@@@@@@@@@@@@@@@@@....@......@........@@@@@@@@@@.....@@.@.@@@@@@@@@@..@@@@
@@@@@@@@@@@@@@@@@@@@@@....@.................@@@@..............@@@@@@@@@....@@@
@@@@@@@@@@@@@@@@.....@@@....@.................@@............@@@@@@@@@@....@@@@
@@@@@@@@@@@@@@@@@@....@.....@@.............................@@@@@@@@@...@...@@@
@@@@@@@@@@@@@@@@@@@.............@.......@....@...@@@.........@...@@...@@@@@@@@
@@@@@@@@@@@@@@@@@@@@............@..........@@@...@@@..................@@@@@@@@
@@@@@@@@@@@@@@@@@@@@..........@@@......@....@@...@@@....................@@@@@@
@@@@@@@@@@@@@@@@@@@@@.....@...@.@...........@@.@..@....@...............@@@@@@@
@@@@@@@@@@@@@@@@@@@@@@@..............@......@@@......................@@@@@@@@@
@@@@@@@@@@@@@@@@@@@@@@@.....@........@......@@@..............@....@.@@@@@@@@@@
@@@@@@@@@@@@@@@@@@@@@@@..@@.................@@@@@...@@.......@@@@@@@@@@@@@@@@@
8
52 56 0
35 36 0
26 20 0
60 3 0
49 25 0
40 53 0
70 36 0
25 24 0

63 13 0
74 0 0
71 73 0
48 71 0
52 27 0
17 0 0
12 6 0
57 75 0
