width 78
height 78
.@@@@@@@@@@@@@@@@@@@@@.....@....................@@@@@@.....@..@@@@............
.....@@@@@@@.@@@@@@@@@..................@..........@@@........@@@.............
@....@@....@...@@@@@@..@................@@..@@.....@@.........@@@.............
@@.........@.....@@@.......@@......@.........@................................
..........@@@....@@.................................@@..................@@....
.................@@.................................@@...........@......@@....
....@.........................@.....................@@....@........@....@@@...
@...@@@......@.....................@................@@....@........@......@...
@...@@@........................@@@@@.......................................@.@
....@....@@....................@@@@@.........................@@...............
...@.....@@............@.......@@@@@@@@@@@@@@.@.....@.........@......@........
...............................@@@@@@@@@@@@@@@@.....@.........@......@@.......
..........@....@....@......@@..@@@@@@@@@@@@@@@............@..............@@..@
..........@@@@@@...@@@....@@....@@@@@@@@@@@@@@@@...@.@@........@.@@......@@@..
..........@@@@@@...@@@@..........@@@@@@@@@@@@@@@..@@@@@@..........@......@@@..
@.........@@@@@@@..@..............@@@@@@@@@@@@@@@@@@@@@@@@.....@@..@..........
@@........@@@@@@@.....@@@@@.......@@@@@@@@@@@..@@@@@@@@@@.........@@..........
....@.....@@@@@@@.....@@@@@........@@@..@......@@@@@@@@@@.........@@@@@.@.....
....@....@@@@@@@@.......@@........@@@@.......@@@@@@@@@@.....@......@@@........
.......@.@@@@@@@@.......@@........@..@.......@@@@@@@....@@.........@@.......@@
.......@...@@@@@@......@@@.....@............@@@@@@@@@..........@@@@@@@@...@@@@
...........@@..@@......@@...........@.......@@@@@@@@.........@.@@@@@@@@@@@@@@@
.........@@@@...........@@@..................@@@@@@@@@@@.......@@@@@@@@@@@@@@@
.........@@@@................@..@...@@....@..@@@@@@@@@@@.@.....@@@@@@@@@@@@@@@
...............................@............@@@@@..@@@@.........@@@@@@@@@@@@@@
..........@@....@........................@..@.@@.....@@.........@@@@@@@@@@@@@@
...@......@@@@@@@@....@.....@......@..........@@.....@@.........@@@@@@@@@@@@@@
.....@@@...@@@@@@@.........@@@.....@........@@@.......@.........@@@@@@@@@@@@@@
@....@@....@@@@@@@@@@@.......@..@@@@.@.......@@............@@@@@@@@@@@@@@@@@@@
..@........@@..@@@@@@@@......@..@@@.......@...@...........@@@@@@@@@@@@@@@@@@@@
..@.@............@@@@@@@@.....................@...........@@@@@@@@@@@@@@@@@@@@
....@.@..........@@@@@@@..........@......@.........@....@@@@@@@@@@@@@@@@@@@@@@
............@...@@@@@@@@..........@..@@...........@@@@....@@@@@@@@@@@@@@@@@@@@
...............@@@..@..........@@@@@.......@......@@@@@@.@@@@@@@@@@@@@@@@@@@@@
..@............@@@..@@@@...@@..@@@@@...............@@@@@.@@@@@@@@@@@@@@@@@@@@@
..................@.........@@....@@...@.@@.......@@@@@@@@@@@@@@@@@@@@@@@@@@@@
.................@@..........@....@@.....@@@@.....@@@@@@@@@@@@@@@@@@@@@@@@@@@@
.......@@.........@........@.......@.....@@......@@@@@@@@@@@@@@@@@@@@@@@@@@@@@
@@.........................@.............@@......@@@@@@@@@@@@@@@@@@@@@@@@...@@
@@@@......@...............................@......@@@@@@@@@@@@@@@@@@@@..@......
@@@.........@@..@......@@..........................@@@@@@.@@@..@@@@@@@.@..@...
@@@@.@............................................@@@@@@@..@@..@@.@@@.........
@@............................@.......@...@.......@@@@@@@.....@@............@@
...................@@@...@..................@@.@..@@@@@@@.....@@@@.........@@@
@@...........@...@@@@@......................@.......@@@@@....@@@@@...@.....@@@
@@@.@@@@..@...............@.........................@@@@@.@..@@@@.......@..@@@
@@@.@@@@.....@..........@@@.........................@@@@.....@@@@..........@@@
@@@@@@@@@...@@.........@@@@...............@..................@@@@........@.@@@
@@@@@@@.........@@..................................@........@@@....@....@@@@@
@@.......@.....................@...................@@........@@...............
@...@....@............@.......................................@...............
@..@........................................@...@@.........................@.@
..............@......................@@@@.......@@.........................@..
......@..@@@@......@...........@@...............@@............................
@@@.....@@@@@@.................@@.@@......@...........................@.......
@@@......@@@.........@@........@@@@@@@...............@.......@................
@@@......@@........@........@.@@@@@@@@.....@.........@.......@.@..............
@@@....................@....@.@@@.@@@@.@@............@........................
@@@@@@..........@.@..@...@....@@..@@@@..........@....@.....@..................
@@@@@@...............@........@...@@@.........@.@.............................
@@@@@@@.@@....................@.................@.......................@.....
@@@@@@@@@@@@...........@................@................................@@@@@
@@@@@@@@@@@@@........@@@@...@................@....@....@.......@...@.....@@@@@
@@@@@@@@@@@@................@..@@@.......@.....................@...@@@....@@@@
@@@@@@@@@@@@...........@...@@@@@.........@.............@...........@@.@....@@@
@@@@@@@@@@@@@.................@............@.........@@@............@.........
@@@@@@@@@@..@..............................@..................@..............@
@@@@@@@@@@@............@@@............@@@@.....@.........................@@@@@
@@@@@@@@@@.......@.@...@@@..........@@@@@.........................@@.......@@@
@@@@@@@@@@.....@@@....@@@@........@@@@@@@...................@...............@@
@@@@@@@@@.....@@@@....@@@@@@............@.........@@....@................@@@@@
@@@@@@@@@@....@@@@.....@@@@@.....................@@@....@@@..............@@@@@
@@@@@@@@.......@@@....@@@@@@@..@.................@.......@..........@.....@@@@
@@@@@@@@@@@....@@@.....@@@@@............@..............@................@@@@@@
@@@@@@@@@@@@@@@@@@........@.........@...@...........@...................@@@@@@
@@@@@@@@@@@@@@@@@@..................@@....@..@......@.............@...@@@@@@@@
@@@@@@@@@@@@@@@@@@@@................@@.............@@@@.@.........@..@@@@@@@@@
@@@@@@@@@@@@@@@@@@@......@@@@@.....@........@@@@....@@@@@@@@@..@.@@...@@@@@@@@
8
49 62 0
47 56 0
36 43 0
29 60 0
48 4 0
63 8 0
58 1 0
50 60 0

7 2 0
55 50 0
74 52 0
18 45 0
49 59 0
69 3 0
8 72 0
29 19 0
