width 93
height 93
@@@@@@@@@@@@@@@@@@@@@@@@@@@@@@@@@@@@@@@@@@@@@@@@@@@@@@@@@@@@@@@@.@.....@@@@@@@@@@@@@@@@@@@@@@
@@@@@@@@@@@@@@@@@@@@@@@@@@@@@@@@@@@@@@@@@@@@@@@@@@@@@@@@@@@@@@@@.@....@@@@@@@@@@@@@@@@@@@@@@@
@@@@@@@@@@@@@@@@@@@@@@@@@@@@@@@@@@@@@@@@@@@@@@@@@@@@@@@@@@@@..@@........@@@@@@@@@@@@@@@@@@@@@
@@@@@@@@@@@@@@@@@@@@@@@@@@@@@@@@@@@@@@@@@@@@@@@@@@@@@@@@@@@...@...........@@@@@@@@@@@@@@@@@@@
@@@@@@@@@@@@@@@@@@@@@@@@@@@@@@@@@@@@@@@@@@@@@@@@..@@@@@@@@@................@@@@@@@@@@@@@@@@@@
@@@@@@@@@@@@@@@@@@@@@@@@@@@@@@@@@@@@@@@@@@@@@@@@..@@@.....@............@...@@@@@@@@@@@@@@@@@@
@@@@@@@@@@@@@@@@@@@@@@@@@@@@@@@@@@@@@@@@@@@@@@@@.............@.....@@..@...@@@@@@@@@@@@@@@@@@
@@@@@@@@@@@@@@@@@@@@@@@@@@@@@@@@@@@@@@@@@@@@@@@@@...................@.....@@@@@@@@@@@@@@@@@@@
@@@@@@@@@@@@@@@@@@@@@@@@@@@@@@@@@@@@@@@@@@@@@@@@@.@..@.....................@@@@@@@@@@@@@@@@@@
@@@@@@@@@@@@@@@@@@@@@@@@@@@@@@@@@@@@@@@@@@@@@@@@@..........................@@@@@@@@@@@@@@@@@@
@@@@@@@@@@@@@@@@@@@@@@@@@@@@@@@@@@@@@@@@@@@@@@@@@...@@.........................@@.@@@@@@@@@@@
@@@@@@@@@@@@@@@@@@@@@@@@@@@@@@@@@@@@@@@@@@@@@@@@@@@@@@.................@.............@@@@@@@@
@@@@@@@@@@@@@@@@@@@@@@@@@@@@@@@@@@@@@@@@@@@@@@@@@@@@@@...............................@@@@@@@@
@@@@@@@@@@@@.@@@@@@@@@@@@@@@@@@@@@@@@@@@@@@@@@@@@@@@@@...............................@@@@@@@@
@@@@@@@@@@@....@@@@....@@@@@@@@@@@@@@@@@@@@@@@@@@@@@.@@...@@......@...@.@.............@@@@@@@
@@@@@@@@@@@.....@@.......@@@@@@@@@@@@@@@@@@@@@@@@@....@@@@.....@..@....@........@@.....@@@@@@
@@@@@@@@@@@@.............@@@@@@@@@@@@@@@@@@@@@@@@@...@@....@@@@@.......@..@.............@@@@@
@@@@@@@@@@@@@@....@.....@@@@@@@@@@@@@@@@@@@@@@@@@@.......@.@@@@@.....@@@...@.@@........@@@@@@
@@@@@@@@@@@@@@@@@.@....@@@@@@@@@@@@@@@@@@@@@@@@@@@.......@@@@@......@@@@......@.......@@@@@@@
@@@@@@@@@@@@@@@...@@@.....@@@@@@@@@@@@@@..@@@@@..........@@@@@....@@@..................@@@@@@
@@@@@@@@@@@@@@@...@@......@@@@@@@@@@@@@@.....@........@.@@@@@@...@@@...................@@@@@@
@@@@@@@@@@@.................@@@@@@@@@@@@@@...@........@.@@@@....@@@...............@....@@@@@@
.@@....@@@.................@@@@@@@@@@@@@@......@......@.@....@..@@@........@@...........@@@@@
.@@.....@@..@........@.....@@@@@@@@@@@@@@.....@@......@.......@@@@@.......@...............@@@
.........@........@........@@@@@@@@@@@................@.......@@@@@@.........................
...@@............@@.......@@@@@@@@@@.......@@........@@..........@@@.......@.................
...@@@@@@@................@@@@@@@@@@..........@................@.@@@......@...@........@.....
@@@@@@@..............@....@@@@@@@@@@........@..........@..@@..@@.@@@......@.......@@@@@@....@
@@...@@.............@@....@@@@@@@@@@..............................................@@@@@@...@@
@@...@@.......@...........@@@@@@@@.....@@..@.......................@.............@@@@.@......
..........................@@@@@@@@.....@..................@......@@.@..........@.@@@.....@...
.................@.......@@@@@@@@@.....@.@.....@@..............@.@.............@@@@..........
.................@.........@.@@@@@@@...........@@@.............@......@@.......@@@@..........
...@..................@@...@.@..@................@.@..................@................@.....
.....................@@...............................@.....@@............@.......@...@@.....
......@..............@.....@.........@@.............@.....@..@.........@........@.@........@.
......@@..............................@............................@..@@....@@.........@..@@@
@.@@.@@.....@.........@@......................................@...@@@@@@....@@@@@@.......@@@@
@......................@..................@@.........@........@...@@@@@@@....@@....@@.@.@@@@@
@....@...........@......@.................@..........@........@@..@@@@@@@.@@.@@@@.@@@@@.@@@@@
................@@@.....@.........@.......@.@........@.......@...@@@@@..@@@@@@@@@@@@@@@@@@@@@
.....................@..@..............@.........................@.@@..@@@@@@@@@@@@@@@@@@@@@@
@....................@@..........@.@...................@....@.........@@@@@@@@@@@@@@@@@@@@@@@
@....@.......@@...................@@........@....@......................@@@@@@@@@@@@@@....@@@
..............@................@..@@@.......@.@@..............@.........@@@@@@@@@@@......@@@@
@@..........................@.................@@.......@@@....@......@..@@@@@@@@@@@@@.......@
@@@..@.....@.........@..@@......@.@@@.......@.@@.....@@@@@@..@@.......@.@@.@@@@@@@@.........@
@@@@@@..@........@..............@@@@@.........@@@.....@@@@@...@...@..@@.@..@@@@@@@..@@....@@@
@@@@@@@@@@....@...................@@@@@..@@...@@@.....@@@@@.........@@@...@.@@@@@@..@@@.....@
@@@@@@@@@@@.....................@..@@@@@@@@..@@@@.....@@@...........@@@........@@...@...@....
@@@@@@@@@@@@...@.......@.....@.....@.@@@@@@@.@@@@...........@@.....@@@....@..................
@@@@@@@@@@@@...........@..........@@...@@@@@@@@@@@..........@@@.@......................@.....
@@@@@@@@@@@...........@................@@@@@@@@@@@..........@@@...................@@.@@@.....
@@@@@@@@@@@..........@@@.........@......@@@@@@..@@..........@@............@...........@@...@@
@@@@@@@@....@............................@@@@@..............@@........@....................@@
@@@@@@@@..................@..............@@@@@@@....@@...@@.@@.................@............@
@@@@@@.....................................@.@@@.@......@@................@@................@
@@@@@@..............@..............@@........@@@............@.............@.@................
@@@@@@@...........@.@.....@........@..@@............@@@.....@@@...........@..................
@@@@@@@..........@@.@...@.......@..@.........@......@@...@..@@@..@@...........@..............
@@@@@@@......@..@@@.....@...........................@@...@@..@.......@.......................
@..@@@...........@......@.......@....@..@........@@@@@...............@.@@@.@................@
@....@.................@@...............@.......@@@@@.................@.....................@
@...........@...........@...............@.......@@@@@..............................@.....@.@@
...@@...@..@@.....@.....@@@................@.@.@@@@@@................@......................@
@@@.....@@@@............@@......@.......@..@@@@@@@@@..............@...................@......
@@@.......@@......@....@@@...........@@....@@@@@@@@..........................................
@@......@.@@............@@@.....................@.@@.........................................
@@.......................@@@......@..........@..@...............@@..............@@@..........
@@..@@....@.....................@.@...@@@......................@@@@..@@.........@@@@.........
@....@.................................@@.@........@...........@@@@@@@@.........@@@.....@....
@......................................@......@.........@@.......@@@@@@........@.............
@@.......@@@.........@............@.........@....................@@@...@.....................
@@.....@@@..........@.....@@@@.@............@.....@@@.........@@@..........................@@
@@...@@@@@..........@....@....@.........@@........@@......@...@@@.......................@@@@.
@@...@@@@@....................@................................@@@.....@..@@..............@@.
.....@@@@@@........................................@.......@...@@@........@@.................
.....@@@@@@..@............@@..@@......@@.....@...@.@..........@....@.......@.................
@......@@@@..............@.@@....@....@@......................@....@...@.........@...........
................................@.............@............................................@.
.........@.........@@@@..........@....@..@.................@@.........@@@@...@@..............
@@@@@@.@@@.....@.@@@@@.....@...@@@@......................@@@@@.......@@@@@...@@.......@......
@@@@@@.@@.........@@@@....@@....@@@.@@@@.@@..............@@@@@........@@@@@@.......@.......@@
@.................@@@@@.........@@@@@@@@@@@..............@@.@@.......@@..@@@@..@@..........@@
@......@@@..........@@@.......@..@@@@@@@@@....@.........................@@@@@@@@@@.........@@
@@@@@......@@........@@.......@..@@.@.@@@@.......@....@@...@.....@.......@@@@@@@@@......@@@@@
@@@@@@....@...........@@.....@...........................................@@@@@@@@@@@...@@@@@@
@@@@@@@@...@@............@........@@....@.........@........@@....@......@@@@@@@@@@@@.@@@@@@@@
@@@@@@@@..@@@...........@@....@@@..@...........@.@@@@......@...........@@@@@@@@@@@@@@@@@@@@@@
@@@@@@@@@@@@@.....@@..........@@@@@@.......@@@.....@@@...............@@@@@@@@@@@@@@@@@@@@@@@@
@@@@@@@@@@@@@.........@.......@@@@........@@@@.....@@@.......@.......@@@@@@@@@@@@@@@@@@@@@@@@
@@@@@@@@@@@..............@.....@@@........@@@@...@@@@@@@...@@@@@@.....@@@@@@@@@@@@@@@@@@@@@@@
@@@@@@@@@@@......@@............@@@.......@@@@@...@@@@@@@@.@@@@@@@@.....@@@@@@@@@@@@@@@@@@@@@@
8
55 70 0
71 20 0
5 72 0
21 91 0
57 84 0
73 63 0
14 17 0
5 64 0

2 34 0
58 66 0
28 68 0
89 55 0
37 64 0
50 86 0
16 47 0
16 70 0
