width 93
height 93
..............@@@@@@@@@@@@@@...........@@@@@@..@@@.@@@@@@@@@@@@@@............@......@.@@@@@@@
..............@@@@@@@@@@@@@@............@@@@@....@.@@@@@@@@@@@@@@...................@.@@@@@@@
........@@....@@@@@@@@@@@@......@@.................@@@@@@@@@@@@@........@......@......@@@@@@@
...............@@@.@@@@@@@@....@@@@@...............@@@@@@@@@@@@.....@@@.....@@.@.......@@@@@@
..........@..........@@@@@@....@@@@.......@@.........@@@@@@@@@.......@......@............@@@@
.........@@@@......@@@@@@@@.....@@....@....@@.......@@@@@@@@.........@................@@@@@@@
........@@@@@........@@.@@@@...@@..@........@..@@@@@@@@@@@@@.......@@@@@...........@@@@@@@@@@
........@@@@@.........@.@@@.....................@.@@@@@...@@@.........@.....@@@.......@@@@@@@
........@@@@.............@@@........................@@@....................@@@@......@@@@@@@@
.......@@@@..........@.........@.........@..........@.......................@@......@@@@@@@@@
.................@@............@.........@.@@@..........@.@................@@@.@....@@@@@@@@@
.@@...........@..@@...........@@@@..........@@..................@..........@@..@.....@@@@@@@@
.........@...@@@@@........@..............@@@@@............@@........................@@@@@@@@@
.........@@@..@@@@................@@@.....................@@..@..@.........@.........@@@@@@@@
@......@@@@@...@.........................................@@...@......................@@@@@@@@
@@@....@@@@@@@...@.@..........@.........................@........@@@.......@@...@.@@@@@@@@@@@
@@....@@@@@@@@...@@@.........@@.@..........@..................@@@@@@......@@@@@@@@@@@@@@@@@@@
@@....@..@@@....@@@...@..........@@....@@...............@.....@@@@@@......@@..@@@@@@@@@@@@@@@
@.......@@......@@....@@@........@@@........@........@...@@..@@@@@@@@......@..@@@@@@@@@@@@@@@
.........@@..............@.......@@@@@......@@@..........@@..@.@@@@@@..........@@@@@@@@@@@@@@
@....................@@@......@@@@@@.@.........@...............@@@@@@.......@@@@@@@@@@@@@@@@@
@@@@@....@.......@............@@@@.............@.............@@@@@@@@.......@@@@@@@@@@@@@@@@@
...@@...................@....@@@@@....................@@@@@.@@@@@@@@@....@@@@@@@@@@@@@@@@@@@@
....@......@..@@@....@..@....@@@@@......@.............@@@@@@@@@@@@@@@@@@@@@@@@@@@@@@@@@@@@@@@
................@.......@....@@@@@..@..............@@.@@@@@@@@@@@@@@@@@@@@@@@@@@@@@@@@@@@@@@@
......@....@....@@....@....@.@@@@@..@............@....@@@@@@@@@@@@@@@@@@@@@@@@@@@@@@@@@@@@@@@
@..........@@........@@......@@.@@@@..................@@@@@@@@@@@@@@@@@@@@@@@@@@@@@@@@@@@@@@@
@@.........@..........@..@.......@@@....@.....@.......@@@@@@@@@@@@@@@@@@@@@@@@@@@@@@@@@@@@@@@
@@......@...............@@.......@@..@.....@@..........@@@@@@@@@@@@@@@@@@@@@@@@@@@@@@@@@@@@@@
@@............@@.............@@@@@@....@.......@@......@@@@@@@@@@@@@@@@@@@@@@@@@@@@@@@@@@@@@@
@@@..............@@...........@.@@.....@.................@@.@@@@@@@@@@@@@@@@@@@@@@@@@@@@@@@@@
@@@.............@@@.........@@@............@................@@@@@@@@@@@@@@@@@@@@@@@@@@@@@@@@@
......@..........@@...........@...@@........@@@@@...........@@@@@@@@@@@@@@@@@@@@@@@@@@@@@@@@@
....@@@......@..@.............@@...............@@...........@@@@@@@@@@@@@@@@@@@@@@@@@@@@@@@@@
.............@@@@...............................@...@........@@@@@@@@@@@@@@@@@@@@@@@@@@@@@@@@
............@@@@@..@...@.....................@...............@@.@@@@@@@@@@@@@@@@@@@@@@@@@@@@@
............@@@@...@...@........................................@@@@@@@@@@@@@@@@@@@@@@@@@@@@@
..@...................@@................................@.......@@@@@@@@@@@@@@@@@@@@@@@@@@@@@
..@.................@...@.....@..@@.............................@@@@@@@@@@@@@@@@@@@@@@@@@@@@@
.....@..@@@@..@....@@@..................@.......................@....@@@@@@@@..@@..@@@@@@@@@@
@@@......@@@....@...@@@........................@................@.....@@@@@@@@.....@@@@@@@@@@
@@@@.....@@@@@.......@@......................................@........@@@.........@@@@@@@@@@@
@@@@....@@.@@..........@................@...............@....@...@....@...........@@@@@@@@@@@
.......@@@......................@....@@.@......................@.@....................@@@@@@@
.....@@@@@...............@......@.................@@@.@.........@........@@...........@@@@@@@
....@@@@@@@.....@..............@@................@....@...@..................@........@@@@@@@
...@@@@@@@@..@....@....@@@@@@.@@@.......................@.@......@..@..@@....@..@.....@@@@@@@
.@.@@@@@@@.......@@@@@@@@@@@@@@@@@....@...................@.............@@.....@@...@........
...........@@....@@@@@@@@@@@@@@@@@@@.@@.........................@@..................@@.....@.
.......@..@@@....@@@@@@@@@@@@@@@@@@@@@@@...@..........@@.@.......@..@...@........@.........@.
..........@@@@..@@@@@@@@@@@@@@@@@@@@@@@@@.......@..................@.............@....@......
..........@@@...@@@@@@@@@@@@@@@@@@@@@@@@@.......@@.........@.@..@....@.@@@.......@...........
@........@@@@...@@@@@@@@@@@@@@@@@@@@@@@@...@@.@@@@@....@...............@@..................@@
@@@@......@@@....@@@@@@@@@@@@@@@@@@@@@@@@@@@@.@@@@@.@..................@@.............@......
@@@.......@@@.....@@@@@@@@@@@@@@@@@@@@@@@@@@@@.@@@@......@......@.....@@@..............@@....
@@@@......@@@@...@@@@@@@@@@@@@@@@@@@@@@@@@@@@..@@@............@@@...........@@...............
@@@@.........@....@@@@@@@@@@@@@@@@@@@@@@@@@@@@........@.....@.......................@........
@@@................@@@@@@@@@@@@@@.....@@.@@@@.......@@...............@..@@......@.........@@@
@@@@@@@.....@.......@@@@@@@@@@@.@.......................@......@........@@...@@@@..........@@
@@@@@@@...@@@......@@@@@@@@@@.........@........................@@.............@@@..........@@
@@@@@@.............@@@@@@@@@.................@.........@....@.@..............@@@.........@@@@
@@@@..............@@@@@@@@@@...@.............@.........@......@..............@@@.............
@@@@@@@@..........@@@@@@@@...........@@................@......@@@.........@@@@@@.............
@@@@@@@@....@.....@@@@........@@.....@.......................@@@@...@@.@..@@@@.@@............
@@@@@@@@..@@@.......@@.........@@.................@...@@....@@@@@@@.......@@@@..............@
@@@@@@@...@@@@@@...............@@.................@........@@@@@@............................
@@@@@@.......@@@.....@..........@@....................@@...@@@@@@@............@.......@.....@
@@@@@@.......@@@.....................................@@@....@@@@@@@........@@@..............@
@@@@@@..@...........@...@...................................@@@@@@@.....@.............@.....@
@@@@@@..............@...@@@...@@..........@@@@@...........@..@@@@@@.........@................
@...@@.............@@....@@....@@@@@.......@@@@.....@.....@...@@@@@....@..@@@..............@.
@@@.@@.....@..............@...@@@@@@.........@.........@@.................@@@..............@.
@@@...........@......@@...@.....@@@.........@........@......@..............@@@............@@@
@@@.....@..........@..@..@@..........................@.....@@@.@............@@............@@@
@@@.........................@.............@@...@.@..........@@..............@@@...@.....@@@@@
.@......................@......@..........@@...........@.@@.@.....@.@.......@@@@........@@@@@
.................................@.......@.....@..........@.@......@@........@@@@.......@@@@@
..@@........@......................................@............@@...........@@@@........@@@@
..@@@@@@@@@......................@........................@@@................@@@@.......@@@@@
...@@@@@@@@@..@...............@..........@@...............................@..@@@.........@@@@
...@@@@@@@@....................@@.......@@@.........@...@......@....@@....@@@@@@..........@@@
@@@@@@@@@@@@@@@.....@@@.......@@..@@....@@@.............@...........@@......@@...............
@@@@@@@@@@@...@.......@@......@@@@@@@@..@@@.@.......@.@.............@@@@@...@@@..............
@@@@@@@..@@...@@......@@......@@@@@@@@..@@@@@.......@................@@....@@@@.......@......
@@@@@@@@..............@@@....@@@@@@@@@.@@@@@@..........@....................@........@.@@@.@.
@@@@@@@@...........@.........@@@@@@@@..@@@@@@@@@...........................@@..........@@@...
@@@@@@@@...................@@@@@@@@@@@@@@@@@@@@.................@...........@.....@.....@@...
@@@@@@@@..@.......@...@@.@@@@@@@@@@@@@@@@@@@@@@............@...........@@...............@@...
@@@@@@....@..@@@.........@@@@@@@@@@@@@@@@@@@@@@@@@.@......@...........@@.......@.@@@........@
@@@@@@......@@..@.......@@@@@@@@@@@@@@@@@@@@@@@@@@@@......@...@@.@..@@@@.........@@@@@@@@@@@@
@@@@@@..........@@.......@@@@@@@@@@@@@@@@@@@@@@@@@@@...@.....@........@@...@@...@@@@@@@@@@@@@
@@@@@@@@..@@.........@..@@@@@@@@@@@@@@@@@@@@@@@@@@@....@..............@@@......@@@@@@@@@@@@@@
@@@@@@@@@.@..@@@........@@@@@@@@@@@@@@@@@@@@@@@@@@@@...@@@@.@..@.....@@@@......@@@@@@@@@@@@@@
8
31 34 0
73 14 0
50 25 0
85 57 0
12 75 0
17 7 0
60 12 0
14 87 0

48 60 0
72 19 0
60 21 0
57 51 0
18 85 0
61 76 0
18 72 0
81 45 0
