width 93
height 93
@@@@@@@@@@@@.......@@@.@@@@@@@@@@@@@@@@@@..@....@...@@@@@@@@@@@@@@@@@@@@@@@@@.@@@@@@@@@@@@@@@
@@@@@@@@@@.............@@@@@@@@@@@@@@@@@@..........@@@@@@@@@@@@@@@@@@@.@..@@@......@@@@@@@@@@
@@@@.@@@@.............@@..@@@@@@@@@@@@@@@....@@....@@@@@@@@@@@@@@@.....@....@.........@@@@@@@
@..........@@............@@@@@@@.@@@.........@@.....@..@@..@@@.@@@@....@...@...@.......@@@@@@
@..........@@..@.........@@@@.......................@..@@..@@@.@.................@...@.@@@@@@
...........@@.............@@@..@........................@..@@.....@.........@....@...@@@@@@@@
........@.@@.............@@@@.........@.....................@.............@@........@@@@@@@@@
..................@......@@@@................@..........@@..@..........@............@@@@@@@@@
@.@.......@.....@.......@@@@@.................................@.....................@@@@@@@@@
@........................@@@@.........@.............@..@............@.................@@@@@@@
@...................@.......@.......................@........@........................@@@@@@@
...................@.....@....@...............@@@..@.........@.....@..@@@@@@.......@@@@@@@@@@
@...............@....@@..@..@@@..............@@@@..........@..........@@@@@@.........@.@@@@@@
......@.......@@....@@@@@.....................@.....@.................@@@@@@.@@@...@.....@@..
.....................................................................@@@@@@@@@@@............@
@.@....................@.........@@...................@......@@..@@@@@@@@@@@@@@@@...........@
@...........@...................@@@.................@........@@..@@@@@@@@@@@@@@@...........@@
................................@@........@...................@@..@@.@@@@.@@@@@@......@......
........@@.......@...@@..........@@@@@..........@@...................@@@....@..............@.
........@@.......@..............................@...@................@@@@..................@@
@@@@............................................@...@@..................................@@..@
@@@@@...................@.........@.@.......................................................@
@@@@@@@........@@.................@......................@..................@@@............@@
@@@@@@@@.......@@@..............@..............@@.......@@..@@@@.............@@....@.......@@
@@@@@@@..........@@....@..............@...@....@@@...@...@.................@...........@...@@
@@@@@@@@@@@.@.@..@...@@@....@.........@...@.......@........@@.@........@........@......@....@
@@@@@@@@@@@@@....@.@@@@@...@....@.........@................@@@...............@.@@@.....@@@...
@@@@@@@@@........@@@@@@...@@.....................@...@....@@@@...............................
@@@@@@@@@.........@@@@@..@@@..........@@@@@......@...@....@@@@@@@@..........@................
@@@@@@@@@.........@@@@@@..@@...@......@@@@................@@@@@@@@........@.@................
@@@@@@@@@@@@.....@@@@@@@..@@@.........@@@@......@..........@@@@@@@.................@@........
@@@@@@@@@@.........@@@@..@@@@.........@.@@@..............@@@@@@.....@.....@.........@...@.@@.
@@@@@@@@@@@@........@@@@................@@@@@@@....@.....@@@@@@........@@...............@.@@@
@@@@@@@@@@@@@...@....@.@.....@.........@@@@@@@..........@@@@@@@@..@..@.........@.....@.@@.@@@
@@@@@@@@@@@@....@.....................@@@@@@@...........@@@@@@.....@@@@......@.........@@@@@@
@@@@@@@@@@@@@.............@@.........@@@@@@@@...@......@@@@@@......@@@@@@......@.@@...@@@@...
@@@@@@@@@@@@@.......................@@@@@@@@@...........@@@@@......@@@@@....@@@.......@.@....
@@@@@@@@@@@@@@..........@.@@..........@@@@@@.@........@.....@...............@@........@......
@@@@@@@@@@@@@@@@@.........@@............@@@@.....@@@..@@....@@........@...........@@.........
@@@@@@@@@@@@@@@@.........@..............@.@@......@@..................@...........@.@........
@@@@@@@@@@@@@@@@@..............@@..@...@@..........@.....................................@...
@@@@@@@@@@@@@@@@@.........................@.@....@@@......@..............................@@..
@@@@@@@@@@@@@@@@@...............................@@.......@.......@@....@@.@.....@............
@@.@@@@@@@@@@@@@@@.@@...@....................................@....@...@@@.......@@...........
....@@@@@@@@@@@@@@@@@@.....@@.........................@..............@.@@.....@..........@@@@
@...@@@@@@@@@@@@@@@@@@...@@..@........@.........@@.............@........@................@@@@
@...@@...@..@@@@@@@@@@...@@..............@......@@@@........@.............................@@@
.....@......@@@@@@@@......................@........@@.......@......@@@...................@.@@
.....@.....@@@@@.....................@......................@....@@.@....................@.@@
.....@.....@@@@@....@@@@.........@...............................@@.......@@.......@@......@@
.....@.....@@@@.....@@@@....@................................@............@@@.....@@.......@@
@@@........@.@@......@@@......@......@.............@@.@.........@@@@.......@.................
.......@..............@@...................@........@@@...........@@.......................@@
..............@.......@...............@.....@.......@@.........@................@@.@........@
....................@@@........................@.....@....@.....@...............@..........@@
.....@...@................................................@@.......@............@@....@....@@
@@@..@.....@..........@........@@....@..................@.....@....@............@@...........
@@@.................@@@@@@@@.........@@..............@...........@@@@..@@@..........@........
@@@@...........@..@.@@..@@@@.@......@....@.@.....................@@@@@@@@@................@..
@@@@...........@.....@..@@..............@.........................@@@@@@@@....@...........@@.
@@@@........@...@..........................@@.....................@@@@@@@........@........@@@
@@@@@@@...........@.......................@@@.@@@.................@@@@@@@...........@......@@
@@@@@@@...........@.......................@@@@@@.....@..............@...@........@..@..@@@@@@
@@@@@@@@@@@..@.@....................@@...@@@@@@@.@..@@@.............................@@@@@@@@@
@@@.....@@.....@.@...................@@@@@@@@@@@@@.@@@@..........@@...@@............@@@@@@@@@
@@@...........@@@@@..............@.......@...@@@@@@@@@@@@@....@@@.@.@@@@@@@........@@@@@@@@@@
@@@.........@@@@@@@@......@@...@.......@@@....@@@@@@@@@@@@@...@@....@@@@@@@@.....@..@@@@@@@@@
@@@.........@@@@@@@@.....@@@@....@.....@......@@@@@@@@@@@@@...@@...@@@@@@@@.........@@@@@@@@@
@@@.......@@@@@@......@.....@..........@......@@@@@@@@@@@@@....@..@@@@@@@@@@.........@@@@@@@@
@..........@@@@@............@.............@....@@@@@@@@@@@@....@@.@@@@@@@@@@........@@@@@@@@@
@..........@@@@@@@@.........@....@.......@.......@@@@@@@@@@@@@..@@@@@@@@@@@@@.......@@@@@@@@@
............@@@@@@@.......@..............@.....@.@@@@@@@@@@@@@..@@@@@@@@@@@@@@@@@..@@@@@@@@@@
....@.......@@@@@@..................@@...@...@...@@@@@@@@@@@@@@@@@@@@@@@@@@@@@@@@@@@@@@@@@@@@
....@@..............................@......@@@@@@@@@@@@@@@@@@@@@@@@@@@@@@@@@@@@@@@@@@@@@@@@@@
............................................@@@@@@@@@@@@@@@@@@@@@@@@@@@@@@@@@@@@@@@@@@@@@@@@@
.......@@@...............................@...@@@@@@@@@@@@@@@@@@@@@@@@@@@@@@@@@@@@@@@@@@@@@@@@
.@.....@@@@............@@.....@.@........@..@@@@@@@@@@@@@@@@@@@@@@@@@@@@@@@@@@@@@@@@@@@@@@@@@
..........@@@......@..@@......@@.......@.@@@@@@@@@@@@@@@@@@@@@@@@@@@@@@@@@@@@@@@@@@@@@@@@@@@@
..........@@@.........@..........@.....@@@@@@@@@@@@@@@@@@@@@@@@@@@@@@@@@@@@@@@@@@@@@@@@@@@@@@
...........@@........@..@@......@@@@....@@@@@@@@@@@@@@@@@@@@@@@@@@@@@@@@@@@@@@@@@@@@@@@@@@@@@
...@............................@@@@...@@@@@@@@@@@@@@@@@@@@@@@@@@@@@@@@@@@@@@@@@@@@@@@@@@@@@@
...................@.............@@.....@@@@@@@@@@@@@@@@@@@@@@@@@@@@@@@@@@@@@@@@@@@@@@@@@@@@@
@...@................@...@..........@...@@@@@@@@@@@@@@@@@@@@@@@@@@@@@@@@@@@@@@@@@@@@@@@@@@@@@
@.......@@...@@@@@@@@@.........@.......@@@@@@@@@@@@@@@@@@@@@@@@@@@@@@@@@@@@@@@@@@@@@@@@@@@@@@
@....@@@@@@@@@@@@@@@@@.................@@@@@@@@@@@@@@@@@@@@@@@@@@@@@@@@@@@@@@@@@@@@@@@@@@@@@@
@@@..@@@@@@@@@@@@@.....................@@@@@@@@@@@@@@@@@@@@@@@@@@@@@@@@@@@@@@@@@@@@@@@@@@@@@@
......@@@@@@@@@@@......................@@@@@@@@@@@@@@@@@@@@@@@@@@@@@@@@@@@@@@@@@@@@@@@@@@@@@@
......@@@@@@@@@@@....................@.@@@@@@@@@@@@@@@@@@@@@@@@@@@@@@@@@@@@@@@@@@@@@@@@@@@@@@
.....@@@@@@@@@@@@@....................@@@@@@@@@@@@@@@@@@@@@@@@@@@@@@@@@@@@@@@@@@@@@@@@@@@@@@@
...@@@@@@@@@@@@@@.....................@@@@@@@@@@@@@@@@@@@@@@@@@@@@@@@@@@@@@@@@@@@@@@@@@@@@@@@
...@@@@@@@@@@@@@@......................@@@@@@@@@@@@@@@@@@@@@@@@@@@@@@@@@@@@@@@@@@@@@@@@@@@@@@
...@@@@@@@@@@@@@@........@.............@@@@@@@@@@@@@@@@@@@@@@@@@@@@@@@@@@@@@@@@@@@@@@@@@@@@@@
...@@@@@@@@@@@@@@........@@.@..@.......@@@@@@@@@@@@@@@@@@@@@@@@@@@@@@@@@@@@@@@@@@@@@@@@@@@@@@
8
41 45 0
85 61 0
50 4 0
1 45 0
2 14 0
30 81 0
69 22 0
50 3 0

30 25 0
69 29 0
26 63 0
85 3 0
42 40 0
84 3 0
32 58 0
2 79 0
