width 93
height 93
@@@....@@@@@@@@.....@@@@@@@@@@@@@@@@@@@@@@@@@@@@@@@@@@@@@@@@@@@@@@@@@@@@@@@@@@@@@@@@@@@@@@@@@
@@......@@@@@@@.......@@@@@@@@@@@@@@@@@@@@@@@@@@@@@@@@@@@@@@@@@@@@@@@@@@@@@@@@@@@@@@@@@@@@@@@
@@........@@@@@........@@@@@@@@@@@@@@@@@@@@@@@@@@@@@@@@@@@@@@@@@@@@@@@@@@@@@@@@@@@@@@@@@@@@@@
@@.....@..@@@@@.........@@@@@@@@@@@@@@@@@@@@@@@@@@@@@@@@@@@@@@@@@@@@@@@@@@@@@@@@@@@@@@@@@@@@@
@@........@@@@@..........@@@@@@@@@@@@@@@@@@@@@@@@@@@@@@@@@@@@@@@@@@@@@@@@@@@@@@@@@@@@@@@@@@@@
@.........@@@@............@@@@@@@@@@@@@@@@@@@@@@@@@@@@@@@@@@@@@@@@@@@@@@@@@@@@@@@@@@@@@@@@@@@
@.........@@@@@...........@@@@@@@@@@@@@@@@@@@@@@@@@@@@@@@@@@@@@@@@@@@@@@@@@@@@@@@@@@@@@@@@@@@
@..@@.....@@@@@...........@@@@@@@@@@@@@@@@@@@@@@@@@@@@@@@@@@@@@@@@@@@@@@@@@@@@@@@@@@@@@@@@@@@
@@@@@.....@@..........@...@@@@@@@@@@@@@@@@@@@@@@@@@@@@@@@@@@@@@@@@@@@@@@@@@@@@@@@@@@@@@@@@@@@
@@@@@@....@@.......@@@@...@..@@@@@@@@@@@@@@@@@@@@@@@@@@@@@@@@@@@@@@@@@@@@@@@@@@@@@@@@@@@@@@@@
@@@@@@@...@.........@@@......@@@@@@@@@@@@@@@@@@@@@@@@@@@@@@@@@@@@@@@@@@@@@@@@@@@@@@@@@@@@@@@@
@@@......@..........@@@..@@..@@@@@@@@@@@@@@@@@@@@@@@@@@@@@@@@@@@@@@@@@@@@@@@@@@@@@@@@@@@@@@@@
@@.........@.......@.@@.......@@@@@@@@@@@@@@@@@@@@@@@@@@@@@@@@@@@@@@@@@@@@@@@@@@@@@@@@@@@@@@@
@@....................@@@@@........@@@@@@@@@@@@@@@@@@@@@@@@@@@@@@@@@@@@@@@@@@@@@@@@@@@@@@@@@@
@@...........@@...................@@@@@@@@@@@@@@@@@@@@@@@@@@@@@@@@@@@@@@@@@@@@@@@@@@@@@@@@@@@
@@@..........@@...@@....@.........@@@@@@@@@@@@@@@@@@@@@@@@@@@@@@@@@@@@@@@@@@@@@@@@@@@@@@@@@@@
@@@@@@....@.......@@@............@@@@@@@@@@@@@@@@@@@@@@@@@@@@@@@@@@@@@@@@@@@@@@@@@@@@@@@@@@@@
@@@@@@.............@@............@@@@@@@@@@@@@@@@@@@@@@@@@@@@@@@@@@@@@@@@@@@@@@@@@@@@@@@@@@@@
@@@@@............................@@@@@@@@@@@@@@@@@@@@@@@@@@@@@@@@@@@@@@@@@@@@@@@@@@@@@@@@@@@@
@@@@@..@......@..................@@@@@@@@@@@@@@@@@@@@@@@@@@@@@@@@@@@@@@@@@@@@@@@@@@@@@@@@@@@@
@@@@.@@......................@....@@@@@@@@@@@@@@@@@@@@@@@@@@@@@@@@@@@@@@@@@@@@@@@@@@@@@@@@@@@
..@..................@.......@..@@@@@@@@@@@@@@@@@@@@@@@@@@@@@@@@@@@@@@@@@@@@@@@@@@@@@@@@@@@@@
........@@..@.....@@@@@@.......@@@@@@@@@@@@@@@@@@@@@@@@@@@@@@@@@@@@@@@@@@@@@@@@@@@@@@@@@@@@@@
..................@..@@@@......@@@@@@@@@@@@@@@@@@@@@@@@@@@@@@@@@@@@@@@@@@@@@@@@@@@@@@@@@@@@@@
.....@@@@......................@@@@@@@@@@@@@@@@@@@@@@@@@@@@@@@@@@@@@@@@@@@@@@@@@@@@@@@@@@@@@@
............................@@...@@@@@@@@@@@@@@@@@@@@@@@@@@@@@@@@@@@@@@@@@@@@@@@@@@@@@@@@@@@@
..@@...........@...@........@@....@@@@@@@@@@@@@@@@@@@@@@@@@@@@@@@@@@@@@@@@@@@@@@@@@@@@@@@@@@@
.....................@....@@@@@...@@@@@@..@@@@@@@@@@@@@@@@@@@@@@@@@@@@@@@@@@@@@@@@@@@@@@@@@@@
@@..................@@@@@@@@@@@....@@@@@....@..@@@@@@@@@@@@@@@@@@@@@@@@@@@@@@@@@@@@@@@@@@@@@@
@@....@@............@@@@@@@@@@@@@@..@@@@..........@@@@@@@@@@@@@@@@@@@@@@@@@@@@@@@@@@@@@@@@@@@
@@@@@@@@@...@....@@.@@@@@@@@@@@@@...@@@@...........@@@@@@@@@@@@@@@@@@@@@@@@@@@@@@@@@@@@@@@@@@
@@@@@@@@@.....@..@@..@@@.@@@@@@@.....@@@...........@@@@@@@@@@@@@@@@@@@@@@@@@@@@@@@@@@@@@@@@@@
..@@..@@@@.......@@..@@@.@.@@@@@......@..........@@@@@@@@@@@@@@@@@@@@@@@@@@@@@@@@@@@@@@@@@@@@
......@@@@.@.....@.........@@@@.......@..........@@@@@@@@@@@@@@@@@@@@@@@@@@@@@@@@@@@@@@@@@@@@
......@@@...................@@.....................@@@@@@@@@@@@@@@@@@@@@@@@@@@@@@@@@@@@@@@@@@
@.....@@@@....@@..................@................@@@@@@@@@@@@@@@@@@@@@@@@@@@@@@@@@@@@@@@@@@
@...@@@@@............................@.............@@@@@@@@@@@@@@@@@@@@@@@@@@@@@@@@@@@@@@@@@@
...................@................@@@@@..........@.@@@@@@@@@@@@@@@@@@@@@@@@@@@@@@@@@@@@@@@@
............@@.....@.....@@@.....@....@@@@...........@@@@@@@@@@@@@@@@@@@@@@@@@@@@@@@@@@@@@@@@
......@....@@@............@@@..........@@......@@.....@@@@@@@@@@@@@@@@@@@@@@@@@@@@@@@@@@@@@@@
.@...@@....@@@......@.....@@@@@.@.@............@@@@.....@@@@@@@@@@@@@@@@@@@@@@@@@@@@@@@@@@@@@
@.....@....@@@......@....@@@.@..@..............@@@.......@@@@@@@@@@@@@@@@@@@@@@@@@@@@@@@@@@@@
...@.......@@@.........@......@.@..............@@...@....@@@@@@@@@@@@@@@@@@@@@@@@@@@@@@@@@@@@
..@@@......@@@..@...........................@..........@.@@@@@@@@@@@@@@@@@@@@@@@@@@@@@@@@@@@@
..@@@@@..@@@@@@..........@................@@.............@@@@@@@@@@@@@@@@@@@@@@@@@@@@@@@@@@@@
@@@@@@@...@@.............@@...............@@@.......@@@@@@@@@@@@@@...@@@@@@@@@@@@@@@@@@@@@@@@
@@@@@@.....@..@@.......@.@............@.....@.......@@..@@@@@@@@@@........@@@@@@@@@@@@..@@@@@
@@@@@@@@.....@@@....................@......@@....@...@..@@@@@@@@@@.........@@@@@@@.@@@....@@@
@@@@@@@@.@..@@@@.............@.........@....@...@@........@@.@.....@.....@@@@@......@@....@@@
@@@@@@@.......@@......................@@....@.............@@.......@.....@.@@.....@..@....@@@
@@@@@@@@.......@......................@@.....@@..@@@@@.....@.....@...@...@................@@@
@@@@@@@...........@@...................@@@@@...........@..............................@...@@@
@@@@@.@.....................@......@.@.@@@@@...........@..............@@..............@...@@@
@@@@@..............@@.................@@@@@@..........................@@..................@@@
@@@@@.....................@......@@@..@@@@@@....@@@@@....@@@........@@@@.................@@@@
@@@@..........@..@.@......@......@@@@.@.@@@@@@.@@@@@@..@.@@.........@@@@.@.....@.........@@@.
@@@......@....@....@@........@.....@@....@@@@@.@@@@@@....@@.....@....@@@@@@@...........@.....
@@@..@.......@@@.@.@@.......@.@.....@@.@@@@@@@....@@@....@@..........@@@@@@@@...............@
@@@..@...@.....@@....................@@@@@@@@@.......................@@@@@@@@................
@......@@@.....@........@.......@@@@@@@@@@@@@@...@@@..............@@@@@..@........@..........
......@@@@..............@.....@@@@.@@@@@@@@@@@....@@.....@@@......@@@@@...........@.@@.......
.......@@@@................@..@.....@@@@@@@@@@@.........@@@@.........@@.....................@
@...@@@@@.....................@......@@@@@@.....@@.......@.@........@@@..@..............@...@
......@@@..........@....................@@@.....@......@............@@.....................@@
.......@@...@@@.@@.@........@@.@...@..............@@@...........@............@.............@@
@...........................@@.@..@.................................................@........
@...................@@.@..@@@..@..........@.........................@.................@......
@...............@@..@...................@@......@..@@....@.......................@...........
@....@..@...........@@@@....@@@.....@...@@@........@@@@..@.....@.................@@.........@
@.........@@.......@@@@@@...@@@@@.......@@@..........@@..@@......................@@..@......@
@.........@@.........@@@....@@@@@.......@@@...........@.......@@..........@.@...@@@....@...@@
@.........@@@@.......@@@.....@@.........@@@....@@@......@......@@@........@@@@...@@@@@.@.....
@......@....@@..@......@.....@@@................@@.........@.@...@@.......@@@@....@@.........
.@.....@................@@.@@@.............@@..@........@..@@........@.@.@@@@...@..@.........
..................@........@@@..@.@...................@.....@................................
...........................@@@@@......................@@...@..................@@.............
.....@@..........@.........@@@@...........................................@...@@@............
........@...@@...........@..........@@...@............@.........@@.......@..................@
.......@@..............@.............@..@@.........@............@...................@@@@....@
.......................@.@@.........@..@.@@....@......................................@.....@
............@.....@.......@@.......@.....@@@@@@@@.........@..@@............@....@@@@@........
.......@....@.....@@..@@....@.@@@@@@......@@@@@@@@......@@@@@@@@@........@@@..@@@@@@@........
...............@..@@..@@.....@@@@@@@@.....@@@@@@@@.@..@@@...@@@@@.............@@@@@@@........
...@@....@@.......@@@........@@@@@@@@....@@@@@@@@@.@..@@....@@@@..........@@.@@@@@@@.........
.........@........@...........@@@@@@@.@@@@@@@@@@@@.......@.....@@.........@@@.@@@@@@@@@..@...
.........@....@...@.....@......@@@@@@@@@@@@@@@@@@@@..@@@.......@@.............@@@@@@@........
.................................@@@@@@@@@@@@@@@@@.....@......@@@@@............@@@@@....@..@.
.............@...@...............@@@@@@@@@@@@@@@@@...........@@...@@@..........@@@@@@.@.@..@@
.........@.@.@@.....@....@.....@@@@@@@@@@@@@@@@@@@...........@............@....@@@@@@@@@@.@@@
...............@.@@............@@@@@@@@@@@@@@@@@@@............................@@@@@@@@@@@@@@@
@...........@..................@@@@@@@@@@@@@@@@@@@..............................@@@@@@@@@@@@@
@..@................@@@...@@@.@@@@@@@@@@@@@@@@@@@@@...@..@.....@.@.............@@@@@@@@@@@@@@
@@@@@....@..........@@@...@@@@@@@@@@@@@@@@@@@@@@@@@...@.@@....................@@@@@@@@@@@@@@@
8
73 76 0
90 71 0
20 62 0
20 72 0
16 60 0
24 19 0
14 71 0
59 87 0

5 15 0
10 25 0
84 76 0
18 21 0
25 33 0
49 74 0
37 50 0
64 87 0
