width 93
height 93
@@@@@@@@@@@@@@@@@@@...........@@@@....@........@@@@@@@@@@@@@@@@@@@@@@@@@@@@@@@@@@@@@@@@@@@@@@
@@@@@@@@@@@@@@@@@@@...........@@@@@..............@..@@@@@@@@@@@@@@@@@@@@@@@@@@@@@@@@@@@@@@@@@
@@@@@@@@@@@@@@@@@@@@..........@@@@@.................@@@@@@@@@@@@@@@@@@@@@@@@@@@@@@@@@@@@@@@@@
@@@@@@@@@@@@@@@@@@@@.............@@..........@@....@@@@@@@@..@@@@@@@@@@@@@@@@@@@@@@@@@@@@@@@@
@@@@@@@@@@@@@@@@@@@@.................@........@..@..@@@@@@@....@@..@@@@@@@@@@@@@@@@@@@@@@@@@@
@@@@@@@@@@@@@@@@@@@@@...........................@...@@@@@@@...........@@@@@@@@@@@@@@@@@@@@@@@
@@@@@@@@@@@@@@@@@@@@....................@.......@@..@@@@@@@...........@@@@@@@@@@@@@@@@@@@@@@@
@@@@@@@@@@@@@@@@@@.@........@..@...@............@....@@@@@@...........@@@@@@@@@@@@@@@@@@@@@@@
......@@@@@@@@@@@.........@@@..@@....@..........@.....@@@@@...........@@@@@@@@@@@@@@@@@@@@@@@
........@@@@@@@@........@@@.....................@....@@@@.@.........@@@@@@@@@@@@@@@@@@@@@@@@@
.@@.....@@@@@@@..@......@@@.......@.@.......@..@@@...@@@.......@....@@@@@@@@@@@@@@@@@@@@@@@@@
.@......@@@@@@......@@@.@@@@......@.@..........@@@....@@............@@@@@@@@@@@@@@@@@@@@@@@@@
.........@@@@@.....@@@@...@@......@............@@@....@..........@@@@@@@@@@@@@@@@@@@@@@@@@@@@
........@@@@@@@...@@@............@@...........@@@@................@@@@@@@@@@@@@@@@@@@@@@@@@@@
.......@@@@@@@@....@@@....@......@@...@@.....@@@@@..............@@@@@@@@@@@@@@@@@@@@@@@@@@@@@
........@@@@@@@.............@@...@..@@@@.....@@@@@........@@@@@@@@@@@@@@@@@@@@@@@@@@@@@@@@@@@
........@@@@@@@@@................@...........@@@@@........@@@@@@@@@@@@@@@@@@@@@@@@@@@@@@@@@@@
......@@@@@@@@@@@.......@.....@@...........@@@@@@.........@@@@@@@@@@@@@@@@@@@@@@@@@@@@@@@@@@@
........@@@@@@@@.......@@............@.....@@@@@@@........@@@@@@@@@@@@@@@@@@@@@@@@@@@@@@@@@@@
........@@@@@@@@@.......@..................@@@@@@@@@@@....@@.@@@.@@@@@@@@@@@@@@@@@@@@@@@@@@@@
......@.@@@@@@@@@..........................@@@@@@@@@@@@.......@..@@@@@@@@@@@@@@@@@@@@@@@@@@@@
..@@@....@@@@@@@@@.........................@@@@@@@@@@@@.........@@@@@@@@@@@@@@@@@@@@@@@@@@@@@
..@@@.....@@@@@@@@.........@...............@@@@@@@@@@@@@@.......@@@@@@@@@@@@@@@@@@@@@@@@@@@@@
...@@.@.....@@@.@@.........@.......@.......@@@@@@@@@@@@@@.@....@@@@@@@@@@@@@@@@@@@@@@@@@@@@@@
...@@.......@@@............................@@@@@@@@@@@@@@......@@@@@@@@@@@@@@@@@@@@@@@@@@@@@@
......@.....@@........@..............@@.@@@@@@@@@@@...@.........@@@@@@@@@@@@@@@@@@@@@@@@@@@@@
@.........@...@.......@.................@@@@@@@@@@@....@........@@@@@..@@@@.@@@@@@@@@@@@@@@@@
@@@...............@....@@.....@@....@...@@@@@@@@@..................@@@...@..@@@@@@@@@@@@@@@@@
@@@...................@@@.@...@....@@@....@.@@@@....................@@.....@@@@@@@@@@@@@@@@@@
@@@.......@...@...........@...@.@..@@@......@@...............@.@@...@@...@.@..@@@@@@@@@@@@@@@
@@@.......@.......@@@........@@...@@@@...@......@..............@@@..@.........@@@@@@@@@@@@@@@
@@@...............@@@........@@..@@@...........@.........@...........@........@@@@@@@@@@@@...
@@@.........@@@...........@........................@.@@....@..@@..@...........@@@@@@@.@@@@@@.
@@@..@.............@..........@..@.................@@@@.......@..........@@.@.@@@@@@..@@@@@@.
@@...@.............@............@@.................@@@@.....@.@......@...........@@@.........
.........................@.......@@@........@@@..................................@@..........
...........@.........@...@.@........@................................@...........@@..........
....@@@....@@.....@@.............................@@...........@..................@@@..@......
.@.@@@@...........@@...@@.....................@@..@........@..@@.................@@@.........
@@@@@@.............................@@.@.....................@..@..........@..............@...
@@@@..................................@............@....@@...................................
@@@........@.................@...........@@.@................@@@@@@.@@@@.....................
@@@@@@@....@@.......@................@......................@@@@@@@.@@@@...........@@@.......
@@@........@@............@...@.....@.@......................@@@@@@@@@@@@............@@@......
@@.....@..............@..@........@@@@................@.......@@@@@@@@@@............@@......@
..................@........@.@@@@@@@@@............@@......@...@@@@@@@@@.............@@......@
...............................@@@@@@............@@@.............@.....@........@..@@@..@....
....@..........@@@...............@@@@@............@@@@..........................@@@@@@..@....
................@@........@......@@@@@............@@..........@@...@@........@@@@@@@@...@@@..
....@....@......@@.........@....@@@@@@.........................@..........@@@@@@@@@@....@....
..@.@@@@..@................@....@@@@@@@@....@...........................@@@@@@@@@@@@........@
...@@@@........................@@@@@@@.....@@@@.....................@@@.@@@@@@@@.@@......@@.@
......@......@..............@..@@@@@@.......@@@......................@@@.@@@@@@@..@@........@
...............@................@@........@@@@...@............@.@@@@@@...@@@@@@@....@......@@
................................@@........@@@.@.....@@..........@@@@@@.......@@@@.@......@..@
..@.@...........................@.........@@@.............@....@@@@@..........@@.............
........@...@................@@@@.........@@@.................@@@@@@@..@.......@..........@..
.......@@............@@@.@@..............@@.@@................@@@@@@@@.@.......@@@.......@@@.
....................@@@..@@@.........................@@....@...@@@@@@@.@.@.....@@.......@@@@@
.@...................@.@..@@@@@.......@@..............@.@...@..@@@@@@@@@@........@.......@@@@
.....@...@.........@.@.@..@@@@........@...............@@@......@@@@@@@@@@............@..@@@@@
...........................@@@.@......@@...........@..@@@@.....@@@@@@@@@................@@@@@
......@.@..................@@@@@...@..@....@.....@.....@....@..@@@@@@@@@.............@.@@....
..@..@@.@@...................@.........................@.......@@@@@@.@@@...............@....
@@@@.@@@@@...............................@......................@@@@..@@.........@......@....
@@@@@@@@@@......@.........................@.....................@.@..@@@........@@@.....@.@..
@@@@@@@@@@.......@@@..@@.............................@...@@.......@...........@@@@@@.........
@@@@@@@@@@.......@@@..........@......................@.......@@...@...........@@@@@@..@......
@@@@@@@@@@@........@.......@...@@@...................@@......@@...@.....@........@@.....@...@
@@@@@@@@@@@@@@..@.........@@...@@@@.......................@...@..................@..........@
@@@@@@@@@@@@@@@@@........@@@...@@@@..@..................@........@..........................@
@@@@@@@@@@@@@@@@@@.....@@@@@@@.@@@@@.........@@@@..............@@@..........................@
@@@@@@@@@@@@@@@@@......@@@@@@@..@@.............@@....@..........@@@......................@..@
@@@@@@@@@@@@@@@@@.......@@@@@@........@@..@@...@@............................................
@@@@@@@@@@@@@@@@........@@@@@........@@@@@@@...@@..@..@@............@..............@...@@...@
@@@@@@@@@@@@@@@@@@..........@@.@@......@@@@@@...@.....@.....@....@.....................@@@@.@
@@@@@@@@@@@@@@@@@@.@........@@@@@........@@@..........@@@.......@@@......@......@...@..@@@@@@
@@@@@@@@@@@@@@@@@.............@..................@@...@@@@.@@@.@@@@......@@..@......@@.@@@@@@
@@@@@@@@@@@@@@.....@.@................................@@@@@@..............@.........@@@@@@@@@
@@@@@@@@@@@@@@@....@................................@@@@@@@@..............@...........@@@@@@@
@@@@@@@@@@@...@...............................@@..@@@@@@@@@@..............@........@@.@@@@@@@
@@@......@@...@.............................@@@@@@@@@@@@@.@....................@...@..@@@@@@@
@@@.........@@@......@............@.....@@..@@@@@@@@@@@@@...............................@@@@@
@@@@@......................................@@@@@@@@@@@@@@..............................@@@@@@
@@.@@....@@@....@..........................@@@@@@@@@@@@@@...@..................@.........@@@@
@...@...........@@....@.....................@@@@@@@@@@@@@................@.................@@
@@@.....@......@@@@@@@@.....@..............@@@@@@@@@@@@@@@.................................@@
@@@.....@.@....@@@@@@@@@@...@...@@@@@....@@@@@@@@@@@@@@@@@................@@....@..........@@
................@@@@@@@@@@@@@@..@@@@@@@@.@@@@@@@@@@@@@@@@@.........@....@.@@@@@@@...........@
...@...........@@@@@@@@@@@@@@@@.@@@@@@@@@@@@@@@@@@@@@@@@@@..@.............@.@@@@@@@@..@.....@
..@...........@@@@@@@@@@@@@@@@@@@@@@@@@@@@@@@@@@@@@@@@@@@@..@..........@..@...@@@@@@.......@@
@@@.......@....@.@@@@@@@@@@@@@@@@@@@@@@@@@@@@@@@@@@@@@@@@@@@@...@@@..........@@@@@....@@@...@
@@@@.....@@......@@@@@@@@@@@@@@@@@@@@@@@@@@@@@@@@@@@@@@@@@@@@@.@@@@.....@.@@@@@@@@@...@@@@@@@
8
73 63 0
13 62 0
45 10 0
60 14 0
28 10 0
29 74 0
23 44 0
25 41 0

46 39 0
40 2 0
72 53 0
62 65 0
20 6 0
9 28 0
30 88 0
39 60 0
