width 58
height 58
@@@@@@@@@@@@@@@@@@@@..........@@@@@..............@@@..@@@@
@@@@@@@@@@@@@@@@@@@@..........@@@@@.......@......@@...@@@@
@@@@@@@@@@@@@@@@@@@@......@...@@@@@..........@...@....@@@@
@@@@@@@@@@@@@@@@@@@@..........@@@@@@@@.......@........@@@@
@@@@@@@@@..@@@@@@@.@@@............@@@@.......@..@.....@@@@
@@@@@@@@@...@@@@@...@@@...........@@@@..........@..@@@@@@@
@@@@@@@@@..@@@@@@.............@...@@@@..............@@@@@@
@@@@@@@@@...@@@.@.................@@@..@.............@@@@@
@@@@@@@@@...@@.....................@@................@@@@@
@@@@@@@@..................................................
@@@@@@@@.................@@................@@@@.........@.
@@@@@@@.........@@@@.....@@..............@@@@@@...........
@@@@@@@@........@@@@@.......@@...@.......@@@@@@@..@@@@@...
@@@@@@@...@@...........@....@@...@.....@.@@@@@@@@@@@@@@.@.
@@@@@@@....@...@@@....@@...@@@@@@@.......@@@@@@@@@@@@@@@@@
@@@@@@.........@@@.@.....@..@@@@@@....@..@@@....@@@@@@@@@@
@@@@@@.........@@@...........@@..................@@@@@@@@@
@@@...........@@@@@........@@......................@@@@@@@
@......@@.....@...@..@.........@...@@@.............@@@@@@@
.......@@@....@.@.@.................@@..@.........@@@@@@@@
@@.....@@@.........................@@@@@@.....@...@@@@@@@@
@@.....@@@...@@......@...@..............@@..@@@@@@@@@@@@@@
@@.....@@@@@@@@@.@..........................@@@@@@@@@@@@@@
....@@..@@@@@@@@....................@.....@@@@@@@@@@@@@@@@
...@@@..@@@@@@@.........@.................@@@@@@@@@@@@@@@@
....@@....@@@@@@..............@@..........@@@@@@@@@@@@@@@@
..........@@@@@@.........@..@............@@@@@@@@@@@@@@@@@
..........@@@@@@.......@@@...........@....@@@@@@@@@@@@@@@@
..........@@@@.........@@..................@@@@@@@@@@@@@@@
........@@@@@........@........@...........@@@@@@@@@@@@@@@@
....@.....@@@........@........@..........@@@@@@@@@@@@@@@@@
..........@@@.........@.......@.@........@@@@@@@@@@@@@@@@@
...........@@.........@..................@@@@@@@@@@@@@@@@@
..........@@@@.......................@....@@@@..@..@@@@@@@
......@......@@@...............@...........@@@.....@@@@@@@
.@@@......@@@@@@............@..@@.....@.............@@@@@@
.@@.........@@@..............@@@......@@@..............@@@
@@@................@@....@@@@@@@......@@@..............@@@
@@@.......@@.............@@@@@@@@@@.......@............@@@
@@@........@.............@@@@@@@@@@..................@@@@@
@.@......@...@...@.....@@@@@@@@@@..........@@...@....@@@@.
........@..............@..@@.@@@@..........@@.............
...............................@.......@@.................
.......@...........@.........@@@.......@......@@..........
.......................@.....@@@...........@.........@....
........................@....@@@....................@...@.
.....................@@.@@...@@@@@.....@...........@......
.........@....@..............@@@@@@.....................@.
@........@@..@@............@@@@@@@........@@......@@......
@......................@.@.@@...@@........@@@............@
@@..@@@@.@.........@.......@@@..@.....@@.............@@..@
@@@.@@@@@.......@@@@@.@....@@..........@......@...........
@@@@@@@@@.......@@@@@@@...............@...................
@@@@@@@@....@@.@@@@@@.......@@..@....@..........@........@
@@@@@@@@.....@@@@@@@........@@@@@@@..@@@.......@.......@.@
@@@@@@@@.....@@@@@@@........@@@@@@....@@@@@....@.......@.@
@@@@@@@@......@@@@@@.......@@@@@@@.....@@@@.@.@@.........@
@@@@@@@@.@@@@@@@@@@@@..@...@@@@@@@......@@@@@@@@...@.....@
8
30 35 0
45 19 0
21 1 0
43 51 0
38 28 0
29 0 0
51 10 0
35 36 0

17 44 0
31 31 0
21 12 0
34 57 0
34 18 0
29 3 0
12 9 0
37 37 0
