width 58
height 58
@@@@@@@@@@@@@@@@@@@....@@@.............@@@@@@@@@@@@@@@@@@@
@@@@@@@@@@@@@@@@@@@.....................@@@@@@@@@@@@@@@@@@
@@@@@@@@@@@@@@@@@@@.......@..............@@@@@@@@......@..
@@@@@@@@@@@@@@@@@@.............@....@..@@@@@@@@@@.........
@@@@@@@@@@@@@@@@@.......@......@.....@@@@@@@@@@@@...@.....
@@@@@@@@@@@@@@@@@.................@...@@@@@@@@............
@@@@@@@@@@@@@@@@@@@....................@@@@@.....@...@....
@@@@@@@@@@@@@@@@@@....@@..............@@@@@@.......@...@..
@@@@@@@@@@@@@@@@@@...@.........@......@@@@..@..@...@....@@
@@@@@@@....@@@@.@@@..@@............@@@@@@..........@@.....
@@@@@@@@...@@@@........@......@....@@@@............@@..@@.
@@@@@@@.....@.................@....@@@@........@....@..@@@
@@@@@@@..................@@.........@.....................
@@@@@@...............@.@@@@............@..@@.......@@.....
@@@@@@@@@......@....@@..@.........@........@.@............
@@@@@@@@@@.....................@...@......................
@@@@@@@@@@.........................@...........@..........
@@@@@@@@.@@................................@...@....@.....
@@@@@@@@.........@........................@@..............
@@@@@@@@........@..............@.......@..@...........@...
@@@@@@@@..........@..............@@............@@.........
@@@@@@@@@.........@.....@....@....@...........@@@.........
@@@@@@@@@@..@.....@@....@.........@@@.........@...@@......
@@@@@@@@...............@@...............@@.@..@.@@@@..@...
@@@@@@@@@@.........@@...................@@@@@...@@@@.@@@..
@@@@@..............@@...................@@@@@....@@@@@@@@@
@@@@@@....................@................@@...@@@@@@@@@@
@@@@@....@..@.....@@.@..@@@@@@..................@@@@@@@@@@
@@@@@@...............@@@@@@@@@@..........@@@...@@@@@@@@@@@
@@@@@@@@@.............@@@@@@@@@................@..@@@@@@@@
@@@@@@@@@@............@@@@@@@@@@@@@@@.............@@@@@@@@
@@@@@@@@...............@@@@@@@@@@@@@@@............@@@@@@@@
@@@@@.@.....@..........@@@@@@@@@@@@@@@..@@........@@@@@@@@
@@@.@.......@...@@@@@@@@@@@@@@@@@@@@@.............@@@@@@@@
@.........@@@@@@@@@@@@@@@@@@@@@@@@@@@............@@@@@@@@@
...........@@@@@@@@@@@@@@@@@@@@@@...@.@.@.@.......@@@..@..
...@@@@...@@@@@@@@@@@@@@@@@@@@@@@@........@............@..
@.@@@@@@@@@@@@@@@@@@@@@@@@@.@@@@@....@@...@.@.............
@.@@@@@@@@@@@@@@@@@@@@@@@@@..@@@@....@@.....@.......@.....
..@@@@@@@@@@@@@@@@@@@@@@@@@...@@....................@.....
..@@@@@@@@@@@@@@@@@@@@@@@@................................
@@@@@@@@@@@@@@@@@@@@@@@@@@@..............@................
@@@@@@@@@@@@@@@@@@@@@@@@@@@....................@..........
@@@@@@@@@@@@@@@@@@@@@@@@@......@.................@....@...
@@@@@@@@@@@@@@@@@@@@@@@@@......@...................@@.....
@@@@@@@@@@@@@@@@@@@@@@@@@@.........@@@.@........@...@..@..
@@@@@@@@@@@@@@@@@@@@@@@@@@........@@@..@...@....@@...@@..@
@@@@@@@@@@@@@@@@@@@@@@@@@@@........@.................@@@@@
@@@@@@@@@@@@@@@@@@@@@@@@@@@.......@@.................@@@@@
@@@@@@@@@@@@@@@@@@@@@@@@@@@@@.....@@..@............@.@@@@@
@@@@@@@@@@@@@@@@@@@@@@@@@@@@@..................@.....@@@@@
@@@@@@@@@@@@@@@@@@@@@@@@@@@.@..................@........@@
@@@@@@@@@@@@@@@@@@@@@@@@@@....@.@..@@@.................@@@
@@@@@@@@@@@@@@@@@@@@@@@@@.....@@...@...................@@@
@@@@@@@@@@@@@@@@@@@@@@....@@@@@@................@......@@@
@@@@@@@@@@@@@@@@@@@@@@....@@@@@.......@@............@..@@@
@@@@@@@@@@@@@@@@@@@@@....@@@@@@.@......@...............@@@
@@@@@@@@@@@@@@@@@@@@@.@@@@@@@@@@@...@...........@@@@@@@@@@
8
52 8 0
29 48 0
46 56 0
44 32 0
39 49 0
41 46 0
56 2 0
25 1 0

32 17 0
9 18 0
23 24 0
39 10 0
43 35 0
1 39 0
45 9 0
25 53 0
