width 58
height 58
@@@@@@@@@@@@@@@@@@@@@.....@@@@@@...@@.......@@..@@@.@@@@@@
@@@@@@@@.@@@@@@@@@..@............................@@....@@@
@@@@@@@@....@........................@.................@@.
@@@@@@@@........................@......@........@@........
@@@@@@@@........@...........@@@.................@@........
@@@@@@@@.....................................@...@........
@@@@@@@........@........@..........@...@....@@.........@..
@@@@@..............................@.@.@.....@...........@
@@@@@.............@@...........@.............@......@..@@@
@@......@........@@@@@@..................@......@@.@@@@@@@
@.....@...........@@@@@.....@..@@......@..@.........@@@@@@
.....@@...@.......@@@@@@.............................@@@@@
..........@@......@@@@@..............................@@@@@
.......@@@@@@@@@....@@@............................@@@@@@@
@........@@@@@@@..@.@@.....@@...@....@@............@@@@@@@
@@@.......@@@@@@@@@@@@@@@@@@.......@@@.............@@@@@@@
@........@@@@@@@@@@@@@@@@@@@.........@.....@@...@..@@@@@@@
.........@@@@@@@@@@@@@@@@@@@.....@@.....@.@........@@@@@@@
.@@.....@@..@@@@@@@@@@@@@@@@@@.....@.....@@........@@@@@@@
............@@@@@@@@@@@@@@@@@@@@@.....@..@@........@@@@@@@
...........@@@@@@@@@@@@@@@@@@@@@@........@@..@@...@@@@@@@@
.......@...@@@@@@@@@@@@@@@@@@@@@..............@..@@@@@@@@@
.........@.@@@@@@@@@@@@@@@@@@@@@................@@@@@@@@@@
...........@@@@@@@@@@@@@@@@@@@@@......@.........@@@@@@@@@@
......@....@@@@@@@@@@@@@@@@@@@........@.........@@@@@@@@@@
..........@@.@@@@..@@@@@@@@@@@.@...............@@@@@@@@@@@
@@............@@@..@@@@@@@@@....@......@.........@@@@@@@@@
...................@@@@@@@@@........@@@@.........@@@@@@@@@
.........@..........@@@@@@@@@......@@@@@.........@@@@@@@@@
.........@.............@@@@@@@.....@.................@..@@
.........@...@.........@@@..@@.....@...................@@@
.........@@@.........@......@@@.........@..............@@@
....@@..............@.......@@@@......................@@@@
....@@...@@.......@..........@@@...@......@...........@@@@
.@@@@@@@..........@@..........@@@......@................@@
@@@@@@@@..........@@..........@@....@@....................
@@@@@@@@@.........@@@@.......@@@..........................
@@@@@@..........@@@@@@....................................
@@@@@@.............@@@.........................@.........@
@@@@...........@....@@..@..@......@@@..@@......@......@..@
@@@@@..........@.....@..@@.........@@@@@@@@@@.............
@@@@@..@............................@@@@@@@@@.............
@@@@...@..............................@@@@@@@......@......
@@@@@..........@....@.......@@@@......@@@@@@@............@
@@@@@..........@.@.@@.....@.@@@@......@@@@@@@.....@@@@..@@
@@@@@..............@@....@@.@@@@.............@....@@@@..@@
@@@@..@...@.........@.......@@.........@.........@@@@@@@@@
@@@.......@.........@..............@........@....@@@@@@@@@
@......................@@@..........@@@....@@@..@@@.@@@@@.
@..........@....@.....@@@@...@@...@@@@@..........@..@@@...
.....................@@@@@....@@..@@@@@@@.................
..@.@................@@@@.....@@.....@@@@@........@.......
....@.........................@@@...@@@@@@........@.......
..@.@.@........@..........@@@...@.@@@@@@@@................
...................@.......@@@@@@..@@@@@@@........@.......
.@.................@@@......@@@@@@@@@@@@@@@@..............
@...............@..@@@@.....@@@@@@@@@@@@@@@...............
@@..................@@@..@@@@@@@@@@@@@@@@@@...........@@@@
8
41 32 0
26 5 0
10 41 0
2 31 0
21 4 0
32 41 0
23 53 0
25 41 0

18 54 0
5 9 0
50 19 0
11 29 0
18 57 0
33 44 0
18 51 0
33 48 0
