width 58
height 58
.......@@@@@..........@...@..@@@@@@@@@@@@@@@@@@@@@@@@@@@@@
.......@.@@.........@..@......@@@@@@@@@@@@@@@@@@@@@@@@@@@@
................................@@@@@@@@@@@@@@@@@@@@@@@@@@
..@.@@................@@@..........@@@@@@@@@@@@@@@@@@@@@@@
....@@......@...........@.@......@.@@@@@@@@@@@@@@@@@@@@@@@
............@...@..@................@@@@@@@@@@@@@@..@@@@@@
.....................@@@@@..@.......@@@@@@@@@@@@@...@@@...
......................@@@@.........@@@@@@@@@@@@....@@@....
.....................@@@.......@@@@@@@@@@@@@@@............
@@..............................@@@@@@@@@@@@@@..........@.
@@............................@@@@@@@@@@@@@@@@.....@......
@@....@.............@...........@@@..@@@@@@@@@........@@..
@@@@@...@.............................@@@@@@..............
@@@@@.........@@...@@......@...........@@................@
@@@@@@..@.........@................@....@..........@....@@
@@@@@@@@@...............@..............................@@@
@@@@@@@@@...@.............................@..........@@@@@
@@@@@@@@@...@@........@..........@....................@@@@
@@@@@@@@@@@@@......@..@.@........@........@@.@.......@@@@@
@@@@@@@@@@@@............@..@...............@@@.....@@@@@@@
@@@@@@@@@@.................@@...................@@@@@@@@@@
@@@@@@@@@@@...............................@.....@@@@@@@@@@
@@@@@@@@@@@@@....@@@@...............@@.........@@@@@@@@@@@
@@@@@@@@@@@@.............@..@@......@@@...@..@@@@@@@@@@@@@
@@@@@@@@@@@@.......................@@........@@@@@@@@@@@@@
@@@@@@@@@@@....@.@....@..@.....@...@@....@.@@@@@@@@@@@@@@@
@@@@@@@@@@@......@....@@@................@@@@@@@@@@@@@@@@@
@@@@@@@@@@@.......@..@@@@@@@@..........@.@@@@@@@@@@@@@@@@@
@@@@@@@@@@@@....................@........@@@@@@@@@@@@@@@@@
@@@@@@@@@@@.....@.............@@@@.......@@@@@@@@@@@@@@@@@
@@@@@@@@@@@@@@@@@@...........@@@@@@@.....@@@@@@@@@@@@@@@@@
@@@@@@@@@@@@@@@@@@@@.........@@@@@@@.....@@@@@@@@@@@@@@@@@
@@@@@@@@@@@@@@@@@@@@.........@@@@@@@@.@@..@@@@@@@@@@@@@@@@
@@@@@@@@@@@@@@...@@@.........@@@@@@@@.......@@@@@@@@@@@@@@
@@@@@@@@@@@@.....@@@@..........@@@@@.........@@@@@@@@@@@@@
@.@@@@@@@@@@.....@@@@@@........@@.....@.....@@@@@@@@@@@@@@
....@@@@@@@.....@@@@@@@.......................@@@@@@@@@@@@
.@..@@@@@@@.......@@@@@@.........@.......@...@@@@@@@@@@@@@
....@@@@@@@.......@@@@@@.......@.............@@@@@@@@@@@@@
....@@@@@@@........@@......@@..@...@....@@...@@@@@@@@@@@@@
@@@.@@@@@@........@@........@..........@@@....@@@@@@@@@@@@
@@@..@@@@@.........@..........@........@...@@@@@@@@@@@@@@@
@@@...@@@..........@@........@@@.......@..@@@@@@@@@@@@@@@@
@@@......@......@............@@@..........@@@@@@@@@@@@@@@@
@@@@...............@..........@...........@@@@@@@@@@@@@@@@
@@@@....@............@@.................@@@@@@@@@@@@@@@@@@
@@@............@@........@@...@....@.....@@@@@@@@@@@@@@@@@
@@@...................@..@@@@.@..........@@@@@@@@@@@@@@@@@
..........................@@@@@.....@...@@@@@@@@@@@@@@@@@@
...........................@@@@@..@@@@@@@@@@@@@@@@@@@@@@@@
...........................@@@@@@.@@@@@@@@@@@@@@@@@@@@@@@@
........@..........@...@@@@@@@@@@@@@@@@@@@@@@@@@@@@@@@@@@@
@.....@@@.....@.@.....@@@@@@@@@@@@@@@@@@@@@@@@@@@@@@@@@@@@
@@......@...............@@@@@@@@@@@@@@@@@@@@@@@@@@@@@@@@@@
@..............@@.......@@@@@@@@@@@@@@@@@@@@@@@@@@@@@@@@@@
@@..@....@@..@@@@@@@@....@@@@@@@@@@@@@@@@@@@@@@@@@@@@@@@@@
@@...........@@@@@@@@...@@@@@@@@@@@@@@@@@@@@@@@@@@@@@@@@@@
@...@......@@@@@@@@@@...@@@@@@@@@@@@@@@@@@@@@@@@@@@@@@@@@@
8
31 23 0
22 14 0
18 13 0
20 51 0
45 36 0
21 53 0
41 42 0
22 21 0

4 11 0
35 45 0
56 11 0
2 37 0
19 52 0
5 9 0
27 45 0
1 51 0
