width 58
height 58
@.@@@@@@@@@@.@......@@@@@....@@@...@........@@...@.@@@@@@@
...@@..@@@@@.........@@@@......@.........@............@@@@
@..@....@@@...........@@..@..............@............@..@
@.......@@@........................................@.....@
.......@@@@..........@......@......@........@@...@.@@.....
........@@@..........@.@....@......@...............@..@@..
.........@@............@....@@@@..@@@...@@................
.................@..................@@@.@.................
..........................@@.......@@@@@..................
.@..@........@......@.@@...........@@@@@@.................
....@.......@@......@@@@@..@@@..@..@@@@@@@................
.........@..@@@@....@@@@.......@@.@@@@@@@@@@..............
........@@@@@@@.....@@@........@@@@@@@@@@..@....@@.......@
...@.................@@..........@@@@@...................@
..................................@@@@............@@.@....
............@......................@@@.....@.........@@@..
..............................@@.@@@@@....................
.........@@..@.@.............@@@@@@@@@....................
@..@....@@@@@@@@......@.....@@@@@@@@@@......@.....@@......
.@@......@@@@@@@@@@@@@@......@@@@@@@@@@@.........@@.......
...........@@@@@@@@@@@.....@@@@@@@@@@@@...................
...........@@@@@@@@@@@@@@@.@@@@@@@@@.@@................@..
..........@@@@@@@@@@@@@@@@.@@@@@@@@@.@......@@@........@..
.......@.@@@@@@@@@@@@@@@@@@@@@@@@@@@.@......@@..........@.
.......@.@@@@@@@@@@@@@@@@@@@@@@@@@@@...@.@..@@............
.........@@..@@@@@@@@@@@@@@@@@@@@@@@@.........@......@..@@
......@.....@@@@@@@@@@@@@@@@@@@@@@@@@.....................
............@@@@@@@@@@@@@@@@@@@@@@@@@...@@..............@@
..........@@@@@@@@@@@@@@@@@@@@@@@@@@@..@.@@..........@..@@
@@........@@@@.@.@@@@@@@@@@@@@@@@@@@..................@@@@
@@@...@.....@@...@@@@@@@@@@@@@@@@@@@@@.......@.@.....@@@@@
............@@...@@@@@@@@@@@@@@@@@@@.................@@@@@
.........@.......@@@@@@@@@@@@@@@@@@.....@.....@@...@@@@@@@
.........@@......@@@@@@@@@@@@@@@@@@...........@...@@@@@@@@
..@.......@...@@@@@@@@@@@@@@@@@@@@@...............@@@@@@@@
...............@@@@@@@@@@@@@@@@@@@.....@...@...@@@@@@@@@@@
...@.....@@....@@@@@@@@@@@@@@@@@@@.............@@@@@@@@@@@
.................@@@@@@@@@@@@@@@@@@@........@..@@@@@@@@@@@
.................@@@@@@@@@@@@@@@@@@@........@@@@@@@@@@@@@@
........@.@......@@@@@@@@@@@@@@@@@..........@@@@@@@@@@@@@@
.@@...@@.....@@@.@@@@@@@@@@@@@@@@@..........@@@@@@@@@@@@@@
@@@@@............@@@@@@@@@@@@@@@@@@.@...@@@@@@@@@@@@@@@@@@
@@@@@@...........@@@@@@@@@@@@@@@@@@.....@@@@@@@@@@@@@@@@@@
@@@@@.@.@.......@@@@@@@@@@@@@@@@@@@....@@@@@@@@@@@@@@@@@@@
@@@@......@.....@...@@@@@@@@@@.............@@@@@@@@@@@@@@@
@@@@......@.........@@@@@@@@@..............@@@@@@@@@@@@@@@
@@@@......@@..@....@@@@@@@@@@..........@@@@@@@@@@@@@@@@@@@
@@@@.....@...@....@@@@@@@@@@@@.@...@@@@@@@@@@@@@@@@@@@@@@@
@@.@@...@@........@@@@@@@@@@...@...@@@@@@@@@@@@@@@@@@@@@@@
...@....@........@@@@@..@@@@......@@@@@@@@@@@@@@@@@@@@@@@@
..@@.................@..@@.@..@.@@@@@@@@@@@@@@@@@@@@@@@@@@
.@@@.@...............@@......@@..@@@@@@@@@@@@@@@@@@@@@@@@@
..@@........@........@.......@@..@@@@@@@@@@@@@@@@@@@@@@@@@
..@...@.....@@.@...........@.@@@@@@@@@@@@@@@@@@@@@@@@@@@@@
...@.....@@@@@@@..............@@@@@@@@@@@@@@@@@@@@@@@@@@@@
........@@@@@@@@...................@@@@@@@@@@@@@@@@@@@@@@@
....@@...@@@@@@......@@@..........@@@@@@@@@@@@@@@@@@@@@@@@
.@.......@@@@@@......@@@...........@@@@@@@@@@@@@@@@@@@@@@@
8
36 34 0
18 6 0
48 7 0
39 22 0
2 23 0
40 19 0
49 33 0
14 3 0

42 21 0
52 2 0
0 28 0
8 47 0
5 4 0
16 11 0
48 29 0
49 1 0
