width 44
height 44
@@@@@@@@@@@@@@@@@@@@@..@........@@@@@@@@@@@@
@@@@@@@@@@@@@@@@@@@@@..........@@@@@@@@@@@@@
@@@@@@@@@@@@@@@@...@............@@@@@@@@@@@@
@@@@@@@@@@@@@@@@................@.@@@@@@@@@@
@@@@@@@@@@@@@@@@@@......@.........@@@@@@@@@@
@@@@@@@@@@@@@@@@@@@.@...........@..@@@@@@@@@
@@@@@@@@@@@@@@@@@@..............@...@@@@@@@@
@@@@@@@@@@@@@@@@@..............@........@@@@
@@@@@@@@@@@@....@........@..............@@@@
@@@@@@@@@@@@.......................@@@@.@@@@
@@@@.@@..@@@.........................@@@@@@@
@@@......@@@...@......................@@@@@@
@@@......@@@......................@...@@@@@@
@.@......@@..@......@...@@@...@.......@@@@@@
.............@..........@@@............@@@@@
.@....................@.................@@@@
......................@....@...........@@@@@
..............@@@..................@@@@@...@
..........@...@@@...@.....@.......@@@.......
..............@@....@@@.......@....@........
..............@@......@....@@..@@@..........
..........@....@.....@@........@@@..........
@..............@@@@..@@@....................
@@@............@@@@...@@@@.........@........
@@.@............@@......@@........@@@....@..
@@.....@@@@....@@@................@@@.......
@@.....@..@...................@...........@.
@@..................@....................@@@
..........@...........@@........@....@@@.@@@
.......................@....@@..@@....@@....
@......@@.@.....@..@@.......@@@@@@...@@@...@
.......@@..........@@........@@@@@.......@.@
...........@....@...@..........@@@@...@....@
..........@..@@.....@@@@@..@@@@@@@@........@
.@...........@@@.....@@@@@.@@@@@@@@@.@@@@...
.................@...@@@@@@@@@@@@@@@..@@@...
...@........@...@....@@@@@@@@@@@.@@@..@@@...
.@@@........@........@@@@@@@@@@@.....@@@@@@.
.@@@......@@@.@......@@@@@@@@@@@@@....@@@@@@
@@@.......@@@@@........@@@@@@@@@@@@@@.@@@@@@
@@@@......@@@@@@@@.....@@@@@@@@@@@@@@.@@@@@@
@@@@...@..@@@@@@@@@.@@.@@@@@@@@@@@@@@@@@@@@@
@@@@...@...@@@@@@@@@@@.....@@@@@@@@@@@@@@@@@
@@@@@@@@...@@@@@@@@@@@.....@@@@@@@@@@@@@@@@@
8
20 17 0
13 35 0
25 6 0
15 37 0
24 18 0
36 32 0
35 6 0
7 39 0

22 26 0
39 7 0
14 8 0
22 39 0
3 35 0
34 29 0
35 6 0
17 9 0
