width 44
height 44
@@@@@...@@@@@@@@@@@@@@@@@@@@@@@@@@@@@@@....@
@@@@..@@@@@@@@@@@@@@@@@@@@@@@@@@@@@@@@@.@...
@......@@@@@@@@@@@@@@@@@@@@@@@@@@@@@@.@.....
@......@@@@@@@@@@@@@@.@@@@@@@@@@@@@@........
@.....@@@@@@@@@@@@@@@...@@@@@@...........@..
@....@@@@@@@@@@@@@@@@@...@...............@@@
@@...@@@@@@@@@@@@@@@@@..@@..........@...@@@@
@....@@@@@@@@@@@@@@@@@@....................@
@@...@@@@@@@@@@....@@@....@........@...@....
@@...@@@@@@@@@......@.......................
@@...@@@@@@@@@@....................@@...@@@.
@@...@@@@@@@@@...........................@@.
@.........@@@...............................
@@..........@...@.....@.....................
@@................@@@...@@@....@............
@@....................@@@@..@.............@@
@.........@@@.....@...@@@@.......@........@@
...@...................@@@...........@@@@@@@
.......................@....................
..@@@..@......................@@@.@@@@.@@...
...@@...........@@...........@@....@@@@@....
...@...........@@@.....@..........@@@@@@...@
............@@....................@@@@@@....
.............@@....................@@@....@@
......@....@..@.....................@@....@@
....@@@..@.@........@@......................
@@..@@@..............@.....@................
@@@@@@@..@..............@@..................
@@@@@@@@@..@.......................@........
@@@@@@@@@.....@.............................
@@@@@@@@@............@.............@........
@@@@@@@@@...@............@@.................
@@@@@@@@......@@......@.....................
@.@@@@@@..@.@@@@............@@....@......@.@
......@@................@.......@........@@.
..........@.@...............................
......................................@....@
..@@@........@@.@@.........@..............@@
@............@@@@.............@@@@....@...@@
.............@@...............@@@.........@@
@@@.......................@@@@@@@..........@
@@@....@..@.@@....@@.....@@@@@@@............
......@@....@@..@.@..@.@@@@@@@@@@......@...@
@@....@@@............@@@@@@@@@@@.......@..@@
8
31 21 0
8 15 0
30 33 0
2 36 0
21 10 0
22 30 0
23 6 0
0 39 0

11 41 0
39 14 0
4 9 0
34 7 0
3 43 0
4 2 0
34 18 0
39 2 0
