width 44
height 44
@@@@@@@@@@..@@...................@@@@@@@@@@@
@@@@@@.................@.........@@@@@@@@@@@
@@@............@......@@.........@@@@@@@@@@@
@@............@.................@@@@@@@@@@@@
.................................@@@@@@@@@@@
..........................@@....@@@@@@@@@@@@
........@@.........@......@@....@@@@@@@@@@@@
......@@@@@@@@@..................@@@@@@@@@@@
......@@@@@@@@@@.................@@@@@@@@@@@
@@...@.@@@@@@@@@.....@@..........@@@@@@@@@@@
@@.........@@.......@@...........@@@.....@@@
@..@@@....@@.....................@@........@
@...@...@...................@.....@@........
...........@@.....@..@@.....................
.........@@@@........@...................@@@
@..@......@...@@.......@.@@.................
..........@...@@...@....@@@@@...........@...
.@@.................@.@..@@@@..............@
...................@.....@@@@..........@....
........................@@@@@....@..........
...........................@................
........@@....@.........@................@..
.....@.....@.........@......@...............
.......................@@.@.................
....@.................@@....................
....@..............@..@@......@@............
..@@@..............@..........@@...@........
@......@@.....................@@@@@@..@.....
@......@@...@...@..@..@.@.....@@@@@.........
@@@.......@@@@..@@@@@@@@@.....@@@........@@@
@@@@.......@@..@@@@@@@@@@.....@@@.@.....@@@@
@@@@...........@@@@@@@@@....@@@@@@@...@.@@@@
@@@......@.....@@@@@@@@.....@@@@@@@..@@@@@@@
@@@............@@@@@@@@@....@@@@@@@..@@@@@@@
@@@............@@@@@@@@@.@@.@@@@@@@@.@@@@@@@
@@.............@@@@@@@@@@@@@@@@@@@@@.@@@@@@@
@@...........@@@@@@@@@@@@@@@@@@@@@@..@@@@@@@
@@............@@@@@@@@@@@@@@@@@@@@@...@@@@@@
.@......@@....@@@@@@@@@@@@@@@@@@@@@..@@@@@@@
........@@@..@@@@@@@@@@@@@@@@@@@@@@@@@@@@@@@
@@@.@...@@@.@@@@@@@@@@@@@@@@@@@@@@@@@@@@@@@@
@@@.@@@@@@@.@@@@@@@@@@@@@@@@@@@@@@@@@@@@@@@@
@@@@@@@@@@@@@@@@@@@@@@@@@@@@@@@@@@@@@@@@@@@@
@@@@@@@@@@@@@@@@@@@@@@@@@@@@@@@@@@@@@@@@@@@@
8
31 7 0
43 27 0
9 28 0
4 33 0
15 20 0
23 20 0
32 13 0
3 17 0

36 18 0
13 19 0
13 25 0
7 26 0
15 23 0
3 41 0
42 24 0
19 10 0
