width 44
height 44
@@@@@@@@@@@@@@@@@@@@@@@@@@@@...............@
@@@@@@@@@@@@@@@@@@@@@@@@@...@...............
@..@@@@@@@@@@@@@@@@...@@@.........@......@..
@..@..@@@@@@@@@@@@@..............@@.........
......@@@@@@@@@@@@@..............@@......@..
.......@@@@@@@@@@@.....@.................@..
@.......@@@@@@@@@..@.....@.....@@@......@@@@
......@...@@@@@@@..@@.........@@@@@....@@@@@
....@@@....@@@@@......@.......@@@@.....@@@@@
......@...@@@@@................@@@@@@@@@@@@@
@.........@@@...................@@@@@@@@@@@@
@@....@@..@....@.....@.@@.@@.....@@@@@@@@@@@
@@....@........@@@@.......@.....@@@@@@@@@@@@
@@.......@.....@@@@.............@@@@@@@@@@@@
.......@........@@@.@........@.@@@@@@@@@@@@@
..........@.....@@@.......@..@@@@@@@@@@@@@@@
.......@........@@...........@@@@@@@@@@@@@@@
........@@@@..........@......@@@@@@@@@@@@@@@
@.@.....@@@@@@..........@...@@@@@@@@@@@@@@@@
@............@@.@............@...@@@@@@@@@@@
............@@......@@...........@@@@@@@@@@@
....................@@.@......@@@@@@@@@@@@@@
@..@...........................@@@@@@@@@@@@@
..............@........@.............@@@@@@@
..@................@............@@.....@@@@@
..@@............................@@....@@@@@@
@.@...@.......@....@.......@....@@....@@@@@@
@...............................@.....@@@@@@
..@.............@..@................@..@@@@@
...@...................................@@@@@
@.......................@..............@...@
@......@......@.........@@@.......@.........
@@@....@.....@........@@@@.......@........@.
@@........@....@@...@@@@@@..@...............
@@..................@@@.............@....@..
@.......@@@.........@@@@...@................
@...................@@@@@.@@@...............
@@....@@.......@@.@@@@@@..@@@@..@@........@@
@......@@@...@.@@@@@@@@@@@@@@...@@@...@@@@..
@@@.....@@....@@@@@@@@@@@@@@@@@@@@@...@@@@@.
..............@@@@@@@@@@@@@@@@@@@@@.....@@@.
@@...@........@@@@@@@@@@@@@@@@@@@@@.........
@@@..........@@@@@@@@@@@@@@@@@@@@@@@........
@@@..@@....@@@@@@@@@@@@@@@@@@@@@@@@@......@@
8
7 12 0
19 18 0
6 27 0
28 32 0
7 19 0
4 36 0
18 25 0
2 5 0

1 23 0
5 10 0
18 25 0
39 0 0
0 17 0
9 32 0
15 14 0
17 18 0
