width 44
height 44
@@@@@@@@@@@@@@@@@@@@..@@@@@@@@..........@@@@
@@@@@@@@@.@..@@@..@@.@@@@@@@@@...........@@@
@@@@@@@......@@@.....@@@@@@@@@.........@.@@@
@@@..@.......@.......@@@@@@@@@.....@@..@.@@@
@....@@........@.....@@@@@@@@@@............@
@....................@@@@@@@@@@@...........@
@..@...@......@..@...@@@@@@@@@@............@
@...............@....@@......@@.............
@........................................@..
@...........................................
@.........@...............@@...............@
@.........@...................@......@.....@
@.@........................................@
@@..@@..............................@......@
@@@@@@.........................@@@.........@
@@@@@@...............@@........@@@.........@
@@@@@@@........@@@..........................
@@@@@@......@@@@@@.......@.....@.....@......
@@@@@@@@@...@@@@@@.@.................@......
@@@@@@@@@...@@@@@@......@............@@.....
@@@@@@@@@..@@@@@@@...@....@....@...@..@...@@
@@@@@@@@@@@@@@@@@@@@.@....@...............@@
@@@@@@@@@@@@@@@..@@@..@@..@........@......@.
@@@@@@@@@@@@@@@.......@@.@@...........@.....
@@@@@@@@@@@@@@@..........................@.@
@@@@@@@@@@@@@@@............................@
@@@@@@@@@@@@@@@............@.@@@..........@@
@@@@@@@@@@@@@@....@........@@@@@...........@
@@@@@@@@@@@@@@.............@...@.@.........@
@@@@@@@@@@@@@@@..@@@@.@.@......@@@..........
@@@@@@@@@@@@@@@..@@@@.....@.................
@@@@@@@@@@@@@@@@@@@@@.......@...@.....@..@.@
@@@@@@@@@@@@@@@@@@@@@........@.....@........
@@@@@@@@@@@@@@@@@@@...@@....................
@@@@@@@@@@@@@@@@@@@@..@@@@.........@..@.....
@@@@@@@@@@@@@@@@@@.....@.@....@.............
@@@@@@@@@@@@@@@@@......@...................@
@@@@@@@@@@@@@@@@....@..@...........@@@@@@@@@
@@@@@@@@@@@@@@@@@....@.@@...........@@@@@@@@
@@@@@@@@@@@@@@@@@.@@@@@@@...........@@@@@@@@
@@@@@@@@@@@@@@@@@.@@@@@.........@...@@@@@@@@
@@@@@@@@@@@@@@@@@@@@@.......@...@@...@@@@@@@
@@@@@@@@@@@@@@@@@@@@@......@@@@@@@..@@@@@@@@
@@@@@@@@@@@@@@@@@@@@@.....@@@@@@@@@.@@@@@@@@
8
33 37 0
29 22 0
32 8 0
26 15 0
24 8 0
40 36 0
31 12 0
28 35 0

5 6 0
28 19 0
31 7 0
36 16 0
42 12 0
39 36 0
24 31 0
39 24 0
