width 44
height 44
..@.@@@@..@....@..@@.@@@@@...@@@@@....@@@..@
..@..@@............@.@.@.....@@@@....@@@@..@
...........................................@
...@@.....@..@...........................@@@
....@.............................@@..@..@@@
..................................@@.....@@@
@..........................@................
................@....@@...@@.@....@.....@...
................@@..@@.....@.......@........
.....@......................................
..............@@........@@.@.........@......
..............@@..................@@.@@@....
...............@...............@..@@..@@....
...............@.@.@@.............@@........
@........@.@@@@@...@@@......................
...@.......@..@@@..@@......................@
...........@...............@..........@....@
.....@..........@@@.................@......@
@@........@.....@@@........@................
@@..............@@@........@................
@....@..........@@@@..............@@.......@
.....@@@.......@@@@@............@.@@@.......
@....@@@........@@@@.....@.......@@@@.......
.....@@@.....@@.@@@@@............@@@.......@
.....@@@@@@@@@@@@@@@@@@@......@...@@......@.
.......@@@@@@@@@@@@@@@@.......@@..@@........
....@@.@@@@@@@@@@@@@@@@@......@@..@@........
.....@@@@@@@@@@@@@@@@@@@@@@..@............@.
.....@@@@@@@@@@@@@@@@@@@@@@..@..............
....@@@@@@@@@@@@@@@@@@@@@...................
...@@@@@@@@@@@@@@@@@@@@@@........@..@......@
..@@@@@@@@@@@@@@@@@@@@@@@...........@@...@@@
.@@@@@@@@@@@@@@@@@@@@@@@@....@@..........@@@
@@@@@@@@@@@@@@@@@@@@@@@@@....@@@.........@@@
@@@@@@@@@@@@@@@@@@@@@@@@@@@@@@@@.........@@@
@@@@@@@@@@@@@@@@@@@@@@@@@@@@@@@...........@@
@@@@@@@@@@@@@@@@@@@@@@@@@@@@............@@@@
@@@@@@@@@@@@@@@@@@@@@@@@@@@@@@......@.@@@@@@
@@@@@@@@@@@@@@@@@@@@@@@@@@@@@@@.@@....@@@@@@
@@@@@@@@@@@@@@@@@@@@@@@@@@@@@@.......@@@@@@@
@@@@@@@@@@@@@@@@@@@@@@@@@@@@@@@......@@@@@@@
@@@@@@@@@@@@@@@@@@@@@@@@@@@@@@@@@@@@@@@@@@@@
@@@@@@@@@@@@@@@@@@@@@@@@@@@@@@@@@@@@@@@@@@@@
@@@@@@@@@@@@@@@@@@@@@@@@@@@@@@@@@@@@@@@@@@@@
8
6 17 0
37 20 0
25 1 0
25 31 0
24 4 0
39 20 0
25 18 0
0 0 0

19 2 0
7 1 0
25 3 0
36 3 0
19 17 0
9 7 0
1 30 0
26 31 0
