width 43
height 43
@@@@@@@@@@@@@@@@@@@@@@@@@@@@@@@@@@@...@@@..
@@@@@@@@@@@@@@@@@@@@@@@@@@@@@@@@@@@...@....
@@@@@@@@@@@@@@@@@@@@@@@@@@@@@@@@@@@@.......
@@@@@@@@@@@@@@@@@@@@@@@@@@@@@@@@@@@@.......
@@@@@@@@@@@@@@@@@@@@@@@@@@@@@@@@@@@........
@@@@@@@@@@@@@@@@@@@@@@@@@@@@@@@@@@@........
@@@@@@@@@@@@@@@@.@@@@@@@@@@@@@@@@@@@.......
@@@@@@...@@@@@@@..@@@@@@@@@@@@@@@.@@@@.....
@@@@@@@@..@@..@@....@@@@@.@@@@@....@.......
@@@@@@@@...@..@@......@@@.@@@@@@@@.@......@
@@@@@@@@...@............@.@@@@@@@@........@
@@@@@@@@...@..@...@.....@.....@...........@
@@................@@....@........@.........
@...............@.@@...@@........@@@.......
@..............@@.................@@.....@@
@.@...@.......@@@........@........@@....@@@
@.@@....................@@........@@......@
@...@....................@@@.....@@@...@..@
....@....@......@.......@@.@...............
.........................@.................
@@...........@.....................@@.@.@.@
@@@....................@@...@@............@
@@....@@.............@......@@..........@.@
@@..........@.............@.@@@.........@@@
@@..........@...........@@..@@@....@....@@@
@@@@@.@...............@.....@@........@@@@@
@@@@@@......@@.................@...@.@@@@@@
@@@@@@@@@@..@......@...........@.......@@@@
@@@@@@@@@....@.....@@...................@@@
@@@@@@@@@..........@@..................@@@@
@@@@@@@@@......@...@@...@@...@@........@@@@
@@@@@@@@@....................@@..........@@
@@@@@@@@@..................................
.@@@@@@@@..@............@..................
..@@@@@@@@@@..........................@....
...@@@@@@@@.........@.................@@...
...@....@@@@...............@@.........@....
........@@@@@@.....@@@@....@@.......@......
@.......@@@@@@.....@@....@@@@.......@......
........@@@@@@......@...@@..........@......
........@@@@@@...........@...............@.
....@@......@@@@.............@.........@@..
@...@@............@@@@................@@@..
8
0 34 0
17 17 0
26 42 0
39 3 0
38 24 0
40 17 0
17 40 0
25 10 0

23 29 0
30 41 0
26 41 0
37 34 0
39 4 0
36 2 0
30 12 0
37 41 0
