width 43
height 43
@@@@@@@@@@@@@@@@@........@@@@@@@@@@@@@@@@@@
@@@@@@@@@@@@@@@@@...............@@@@@@@@@@@
@@@@@@@@@@@@@@@@@@@...@...........@@@@@@@@@
@@@@@@@.@@@@@@@@@@.@...@..........@@@@@@@@@
@@@@@@@.....@@@....@.......@.......@@@@@@@@
@@@@.......@@..............@.....@...@@@@@@
@@@@@.......@..............@@........@@@@@@
@@@@@...................@@.........@.@@@@@@
@@.@@@............................@@.@@@@@@
...................................@@@@@@@@
...................@...................@@@@
......@@@@..@........@...................@@
...........@@........@@...................@
.....................@....................@
.......................................@..@
.....@.........@.....@@@@..............@..@
..................@.@@@@@.......@@@.......@
.....................................@@@@@@
............@@....@@@.................@@@@@
...@..@.....@@@.@.......@.......@@@...@@@@@
.@........@.@@@@@@.......................@.
.....@......@@@@@@..............@..........
@.............@@@@.............@@.........@
..............@...................@...@@..@
@......@@......@..@@.@.................@...
@...................@@..@@.................
....................@@@....................
.....................................@.....
@@............................@@.....@.....
@@.....................@@.....@@..@@@@.....
.............@......@..@@......@....@......
....................@..@@@.....@......@....
..........@........@@..@@@@@..........@....
..........@.....@@......@@@@...............
................@..@.....................@@
................@@.@......................@
@@......@.............@.........@.........@
@@@..............@@@......................@
@@@..........@@..@@.......................@
@@@@.@@......@@........@@.............@....
@@@@@@@@...@@@@@@......@@@.................
@@@@@@@@@@@@@@@@@.............@@@.......@@@
@@@@@@@@@@@@@@@@@..@@.........@@@.......@@@
8
8 33 0
24 37 0
7 37 0
17 4 0
27 40 0
10 15 0
41 35 0
25 38 0

38 11 0
28 39 0
10 18 0
27 7 0
19 40 0
37 37 0
21 1 0
0 9 0
