width 43
height 43
@@@@@@@@@@@@@@@@@@@@@@@@@@@@@@@@@@@@@@@@@@@
@@@@@@@@@@@@@@@..@@@@@@@@@@@@@@@@@@@@@@@@@@
@@@@@@@@.........@@@@@@@@@@@@@@...@@@@@@.@@
@@@@@@@@@.@...@...@@@@@@@@@@@@.....@@@@@..@
@@@@@@@@@@@...@..@@@@@@@@@@@@@......@@@....
@@@@@@@@..@..@@...@@@@@@@@@@@@......@@...@@
@@@@@@@...........@@@@@@@@@@@@......@@....@
@@@@@@....@......@@@@@@@@@@@@@@..........@@
@@@@@@...........@@@@@@@@@@@@@............@
@@@@@@........@....@@@@@@@@@@@..........@..
@@@@@@........@....@@@@@....@@..........@..
@@@@@@@@.....@.....@@@@@@....@.............
..@@@@..............@..@............@.....@
@..@@..................@.....@@@@.......@..
.............................@@@@@@...@....
.........@@.....@............@@@@@.......@@
..............@......@@................@@@@
............................@@.............
....@.@@........@................@.........
....@@@@......@........@@@.............@@..
..............@.........@...@..............
...@.........@.........@@..@..........@..@@
.@...............@.@@......@...@@...@..@@@@
.....@@............@@@@...@@@.......@..@@.@
.....@@@@........@.@@@...@@@.....@..@...@.@
@@....@@@................@@@@..@....@.....@
@@@....@@@............@@@@@@@@.@@.........@
@@@.....@@............@@@@@......@.........
@@@@...@@.............@@@@@@.@@@...........
@@@@..............@..@@@@@@@@@@@...........
@@@@@.............@...@@@@@@@@@@..........@
@@@@..............@@..@@@.@................
@@@..................@@@..@................
@@@..@@@....@........@@@...@.......@.......
@@@@@@@@........@.....@@@..................
@@@@@@@@.@....................@@...........
@@@@@@@@@@....@..@...........@@@@..@......@
@@@@@@@@@@..................@@@@@..@@@@@..@
@@@@@@@@@@......@..........@@@@@@..@@@@@@@@
@@@@@@@@..................@@@@@@@@@@@@@@@@@
@@@@@@@..........@@@@.@@@@@@@@@@@@@@@@@@@@@
@@@@@@@@..@......@@@@.@@@@@@@@@@@@@@@@@@@@@
@@@@@@@@....@....@@@@@@@@@@@@@@@@@@@@@@@@@@
8
11 11 0
12 3 0
34 11 0
22 15 0
8 40 0
41 36 0
17 23 0
20 33 0

21 14 0
32 31 0
38 7 0
27 16 0
38 24 0
14 13 0
16 25 0
32 5 0
