width 43
height 43
@@@@@@@@@@@@@@@@@@@@@@@@@.............@@...
@@@@@@@@@@@@@@@@@@@@@@@@@.@...........@@...
@@@@@@@@@@@@@@@@@@@@@@@@@.@..@@............
@@@@@@@@@@@@@@@@@@@...@@@@@..@@@@@@........
@@@@@@@@@@@@@@@@@@@.@..@@@@@@@@@@@.........
@@@@@@@@@@@@@@@@@@@@...@@@@@@@@@@@@.......@
@@@@@@@@@@@@@@@@@@.....@@@@@@@@@...........
@@@@@@@@@@@@@@@@@.@.....@@@....@...........
@@@@@@@@@@@@@@@@..@....@@@@@...............
@@@@@@@@@@@@@@@@.@@......@@@@@.............
@@@@@@@@@@@@@@@@.......@....@@.............
@@@@@@@@@@@..@@..................@.........
@@@@@@@@@..........................@@@.....
@@@@@@@@@@.............@...................
@@@@@@@@@@...@@........@...@@....@.........
@@@@@@@@@@...................@@..@.........
@@@@@@@@@@................@..@@..@.........
@@@@@@@@@@.............................@...
@@@@@@@@@@...................@......@.@....
.@@@@@.............................@@....@.
....@................................@...@.
.........................................@.
...@......................@@............@@.
....................@......@...@@......@@..
.................@.........................
@..........@....@@.....@............@@@@..@
@@@...@@...@@@@@@.....@...........@...@@..@
....@.@@..@@@@@@...@....@@@...........@...@
....@@@@..@@@@@...........................@
..@..@@@@@@@@@@@....@@@......@@@....@@....@
.....@@@@@@@@@@@.....@@......@@@...@.......
.....@@@@@@@@@@@@....@@......@.....@@@@@...
@...@@@@@@@@@@@@@@@@@@@@@@.........@.......
@...@@@@@@@@@@@@@@@@@@@@@@.................
....@@@@@@@@@@@@@@@@@@@@@@......@......@@@@
@@@@@@@@@@@@@@@@@@@@@@@@@@@.....@......@@@@
@@@@@@@@@@@@@@@@@@@@@@@@@@@@...........@@@@
@@@@@@@@@@@@@@@@@@@@@@@@@@@@@.........@@@@@
@@@@@@@@@@@@@@@@@@@@@@@@@@@@@..........@@@@
@@@@@@@@@@@@@@@@@@@@@@@@@@@@............@@@
@@@@@@@@@@@@@@@@@@@@@@@@@@@@@...@....@@@@@@
@@@@@@@@@@@@@@@@@@@@@@@@@@@@@.....@@@@@@@@@
@@@@@@@@@@@@@@@@@@@@@@@@@@@@......@@@@@@@@@
8
9 20 0
20 19 0
37 7 0
39 12 0
32 42 0
33 25 0
0 27 0
41 25 0

29 37 0
32 19 0
21 11 0
35 3 0
1 27 0
33 24 0
8 28 0
26 11 0
