width 43
height 43
.......@@@@......@@@......@@@@@@@@.@@@.....
..@..@..@@@...........@.....@@@@@..........
....@.........................@@...........
@............................@.............
.................@.................@.......
.........@@................................
@...............@............@@..@.........
................@....@.......@@......@....@
........................@....@@@...........
.@@@@.@................@@@@@@@@@...........
...........@@...@@@....@@@..@.@@...........
......@@...............................@@..
......@@..................@............@@..
......@@...@@...@@@@@@@.@..................
@@....@@........@@@@@@@@@..................
@@@@@@@.........@@@@@@@@.........@@.......@
@@@@@@@....@....@@@@@@@@...................
@@@@@@.....@@..@@@@@@@@@............@......
@@@@@@........@@@@@@@@@@.....@@@.........@.
@@@@@@........@@@@@@@@@@...................
@@@@@@........@@@@@@@@.....................
@@@@@@...@.....@@@@@@@@....................
@@@@@@..........@@@@@@@..@@......@.........
@@@@@@.@...@......@@@@@..@@@......@..@.....
@@@@@@.@...@.........................@.....
@@@@..........@.........@............@@@@@@
........@.....@......................@@@@@@
........@@....@...@....@............@@@@@@@
@.......@@@@........................@@@@@@@
@...@..@@@@@.......@........@..@...@@@@@@@@
@@.........@......@.@.......@......@@@@@@@@
@@................................@@@@@@@@@
@..@..@@...................@......@@@@@@@@@
@.....@.....@.@@.............@@....@@@@@@@@
@.....@@....@......................@@@@@@@@
......@@@..@..@.....@@..@....@@@@..@@@@@@@@
.......@.....@......@@...@...@.@@@@@@@@@@@@
.............@@..................@@@@@@@@@@
@.....@............@.............@@@@@@@@@@
.@.@..@......@....@..@.........@..@@@@@@@@@
.@.................@.@@@..@@@..@..@@@@@@@@@
............@........@@@..@@.....@@@@@@@@@@
..........@@@@....@@.@...@@@....@@@@@@@@@@@
8
19 1 0
26 2 0
39 23 0
10 36 0
39 22 0
27 4 0
31 34 0
19 34 0

13 35 0
32 18 0
34 12 0
29 12 0
33 10 0
0 9 0
22 37 0
30 31 0
