width 90
height 90
@@@@..@@@@@@@@@@@@@@@@@@@.....@@@@@....@@@@@@@@@@@@@.@@@@@@@@@@@@@@@@@@@@@@@@@@@@@@@@@@@@@
@@@@..@@@@@@@@@@@@@@@@@...........@....@@@@@@@@@@@@..@@@@@@@@@@@@@@@@@@@@@@@@@@@@@@@@@@@@@
@@.....@@@@@@@@@@@@@@@@.....@@........@@@@@@@@@@@@......@@@@@@@@@@@@@@@@@@@@@@@..@@@@@@@@@
@.......@@@@@@@@@@@@@.............@@@.@@@@@@@@@@@@.@....@@@@@@@@@@@@@@@@@@@@@@...@@@@@@@@@
@.........@@@@@@@@@@@............@@@@@@@@@@@@@@@@......@@@@@@@@@@@@@@@@@@@@@@@...@@@@@@@@@
.@........@@@@@@@@@..........@..@@@@@@@@@@@@@@@@@@@@....@@@@@@@@@@@@@@@@@@@@.@...@@@@@@@@@
.....@....@@@@@@@@@.....@........@@@@@@@@@@@@@@@@@@@....@@@@@@@@@@@@@@@@@@@@.....@@@@@@@@@
...........@@@@@@@@.........@....@@@@@@@@@@@@@@@@@@.......@@@@@@@@@@@@@@...@.....@@@@@@@@@
........@..@@@.@@@@.@......@.....@@@@@.@@@@@@@@@@@@.......@@@@@@@@@@@@@@...@.@...@@@@@@@@@
........@..@...@@@@.@@.............@.@...@@@@@@@@@@....@..@@@@@@@@@@@@@@.........@@@@@@@@@
........@........@@@@@.......@.@.........@@@@@@@@@@.....@@@@.@@@@@@@@@@@........@@@@@@@@@@
..@...............@@@.@..................@@@@@@@@@@@@...@@@@...@@@@@@@@@@.......@@@@@@@...
@@@......@.......@@...@..................@@@@@@@@@....@.........@@@@@@@@@...@..@@@@@@@@...
@@@@....................@...............@@@...@@@@..............@@@@@@@........@@@@@@.....
@@@@....@..............@@@@.........@.....@...@@@.@...@@@@@@.....@.@.@@@.@.....@@@@.......
...@.....................@@@@.......@.....@@..........@...............@@@@...@..@@....@...
....................@.....@@@...@........@@.......@@................@....@@.....@@........
....@.................@@@.@@..@.@@.......@@.......@@......@..............@@.............@@
..@@@....@.@@.....@....@....@............@........@@..@..........@.....................@@@
.@@@@.....@@.......................@.@...................@...@@@.@........................
..@@@.....@@...........@..........@@...@............@@..@@.......@........................
..@@@@@..@..@.....@@.......................@@.......@.......@.@...............@.....@.....
...@@@............@.........................@......@@....................@................
...@@@@@.......................@...................@@...................@@.@............@@
...@@@@@.....................@@@@.....@...........@@..........@.......@@@@@@..@.@.........
...@@@@@@@@........@........@@@@@@........@@.@@....@.....@............@@@@@...............
....@@@@@@.................................@.@@@@.........................................
...@@@@@.@.........@..........@............@@@@@@..@.....................@.............@..
...@@@@@.@......@...................@.@....@@@@@@@@@....@@@.......@@@@.......@.......@....
...@@@@@.@@.........@.................@....@@@@@@@@@@@...@@.......@@@........@............
....@@@@....@..............@.............@......@@@@@.............@@....@@................
....@@@@.......@..........@.............@@......@@@@@.............@@.............@........
...@@@@........@.......................@@.....@.@@@@@@@...........@.@@.@.....@...@..@@....
...@@@@........@...@....@@@.@...@.@@@...@.....@@...@@...............@@@@............@.....
.....@@............@@@@@@@@...@@@........@.....@@..................@@@@@..@@..............
...................@@@@@@......@@@@............@@....@........@....@@.........@.........@@
@...@..............@@@@@@...@@.................@@..@@..@.@.@..@@@....................@..@@
@@..@@...............@.....@@@........@....@.......@@..@......@@@@@.@@@.........@......@@@
@...@@...................@.@@@@@......@@@@@@@@..@..@@.........@@@@@@@@@.................@@
@........@.................@@@.@..@@@@@@@@@@@..................@@@@@@@@................@@@
@......@.@.......@..................@@@@@@@@@......@..@@@@@..@@@@@@@@@@..........@.....@@@
......@..@...@...@..................@@@@@@@@@......@.........@@.@@@@@@@@@@@....@.@.....@@@
@................@@@@.@@............@@@@@@@@@....................@@@@@@@@@@....@@@....@@.@
@........@@.......@@@@@@@..........@@@@@@@@@@.....@..............@@@@@@@@@......@.....@@..
..............@...@@@@.@............@.@@@@@@@...........@.........@@@@@@@@....@.......@@..
....@.............@@@@.................@@.@@@@@@@@......@.........@@@@@@@@@@..........@@..
@@.................@@..@.............@@@...........@@.............@@@@@@@@@@..............
@@@@..@@@@@@@......@@............@@..........@@....@@.............@@@@@@@@@@@.............
@@@@...@@@@@@@........@.....@....@@@.........@.....@@.............@@@@@@@@@...............
@@@@@@@@@@@@@..@@@...@............@@................@.............@@.@@@@@...........@....
@@@@@@@@@@@......................@@@@..............@.....@@.......@...@@..................
@@@@@@@@@@@.@@..........@.@@@@@..@@@@..............@.....@@@.............................@
@@@@@@@@@@@.@@...................@..@.......@@................@..................@@@...@.@
@@@@@@@@@@.......@.....................@...@@@@@@........@@..................@...@@@@@...@
@@@@@@@@@@.......@@......@@................@@@....@.@@.@....@.........@.........@@@@@@@...
@@@@@@@@@@..............@..@@..@........@....@..............@..............@.@@@@@@@@@..@.
@@@@@@@@@@.........@@@....@@@@@@@........................@.......@@..........@@.@@@@@@..@@
@@@@@@@@@@................@@@@@@..............@@..................@.............@..@@@@@@@
@@@@@@@@@......@..........@@@@@@......................@@@@..........@.......@.....@@@@@@@@
@@@@@@@@@..@.............@@@@@@.......................@@@@..................@@.......@@..@
@@@@@@@@@@.............@@@@@@@........@@@@@@..........@@@@.....@.........@@@@@.....@......
@@@@@@@@@@@@@@....@....@@@@@@@........@@@@.............@@@.@@.............@..@............
@@@@@@@@@@@@@@.........@@@@@@@@........@@...............@@.@@@...@........@.........@.....
@@@@@@@@@@@@@@............@@..@...............@.........@@................@@@@.....@@.....
@@@@@@@@@@@@@@............@@........@@........@..........@.......@..........@@@....@@@....
@@@@@@@@@@@@@@........@..........................@.@.@..................@..@@@@...........
@@@@@@@@@@@@@@.......@@.............@................@.......................@@....@......
@@@@@@@@@@@@@@@....................@.........@...............................@@....@......
@@@@@@@@@@@@@@....................@@@@@...........................@...@...@@..@...........
@@@@@@@@@@@@@@@..@..................@@@...........@.@.........@@@@............@...........
@@@@@@@@@@@@@@@.................@...@@@@..........@..@@@...@@.@..@.....@.@...@........@...
@@@@@@@@@@@@@@@@.......@...@..@@@@@@@@@@@..@@.....@.@@@...@@..@.................@.........
@@@@@@@@@@@@@@@@...@....@....@@@@@@@@@@@@@@@@@@@....@......@..@.....@.....................
@@@@@@@@@@@@@@@@..@....@@@....@@.@@@@@@@@@@@@@@@...@@.@@............@@........@...........
@@@@@@@@@@@@@@@@..@...........@@..@.@@@@@@@@@@@@@@.@@..@@............@..@.....@@..........
@@@@@@@@@@@@@@@@@@@...........@...@.....@@@@@@@@@.........@.............@@................
@@@@@@@@@@@@@@@@@@@...@@@@........@.....@@@@@@@@@...........@@................@@...@...@.@
@@@@@@@@@@@@@@@@@@@@@@@@@@.....@@........@@@@@@@@............@.............@@@@@@@.......@
@@@@@@@@@@@@@@@@@@@@@@@@@@@@.........@.@@@@@@@@@..@............@.............@@...........
@@@@@@@@@@@@@@@@@@@@@@@@@@@@...........@@@@@@@....@............@.........@..@@@.....@..@.@
@@@@@@@@@@@@@@@@@@@@@@@@@@@.....@......@@@@@@@....@@...................@@@@...............
@@@@@@@@@@@@@@@@@@@@@@@@@@@@@...@...@@@@@@@@@@..@.@@...........@....@..@@@@............@@.
@@@@@@@@@@@@@@@@@@@@@@@@@@......@@..@@@@@@@@@@@...@@..................@@@@@@...@...@@@@@@.
@@@@@@@@@@@@@@@@@@@@@@@@@..............@@@@@@@@...@@@@.................@..@@.......@@.@@@@
@@@@@@@@@@@@@@@@@@@@@@@@................@@@@@@................@.......................@@@@
@@@@@@@@@@@@@@@@@@@@@@@@.....@.............@@.................@@@@.........@@@@.......@@@@
@@@@@@@@@@@@@@@@@@@.......................@@@...........@@....@@@@@@@@@@@..@@@@@@@@@@@@@@@
@@@@@@@@@@@@@@@@@@@................@@....@.............@@@@@@@@@@@@@@@@@@@@@@@@@@@@@@@@@@@
@@@@@@@@@@@@@@@@....@.......................@....@@...@@@@@@@@@@@@@@@@@@@@@@@@@@@@@@@@@@@@
@@@@@@@@@@@@@@@@....@@@.....@...........@..@...@@@@..@@@@@@@@@@@@@@@@@@@@@@@@@@@@@@@@@@@@@
8
70 77 0
85 48 0
58 20 0
79 22 0
70 75 0
60 68 0
79 30 0
56 7 0

25 28 0
52 5 0
81 68 0
74 22 0
18 57 0
24 11 0
67 61 0
48 71 0
