width 90
height 90
@@@@@@@@@@@@@@@@@@@@@@@@@@@@@@@@@@@@@@@@@@@@@......................@@@@.....@@.....@..@@@@
@@@@@@@@@@@@@@@@@@@@@@@@@@@@@@@@@@@@@@@@@@@@@@...@..@..............@@@@..@@........@..@@@@
@@@@@@@@@@@@@@@@@@@@@@@@@@@@@@@@@@@@@@@@@@@@.......@...............@.@....@@......@@......
@@@@@@@@@@@@@@@@@@@@@@@@@@@@@@@@@@@@@@@@@@@@@@...............@..............@.....@.......
@@@@@@@@@@@@@@@@@@@@@@...@@@@@@@@@@@@@@@@@@@@@........@.....................@@@...........
@@@@@@@@@@@@@@@@@@@@....@@@@@@@@@@@@@@@@@@@@@...............@...............@@@...........
@@@@@@@@@@@@@@@@@@@@....@@@@@@@@@@@@@@@@@@@@@..@................@@..@.........@@..........
@@@@@@@@@@@@@@@@@@.@...@@@..@@@@@@@@@@@@@@................@@....@@@...@...@...@...........
@@@@@@@@@@@@@@@@@@.@.........@@@@@@@@@@@@@.................@@@...@@.@@...@................
@@@@@@@@@@@@@...............@@@@@@@@@@@@@@......@@@@...@.....@...@@@@@@..@@....@..........
@@@@@@@@@@@@@......@@.......@@..@@@@@@@@@@...@@@@@@........@.@...@@@@@@..@@...............
@@@@@@@@@@@@.....................@@@@@@@@@@@@@@@@@@@...@...@...@..@@@.@..@@....@..........
@@@@@@@@@@@@@................@...@@@@@@@@@@@@@@@@@......@..@.......@......................
@@@@@@@@@@@@.................@...@@@@.@@@@@@@@..@@.....@@@................@..............@
@@@@@@..@........@...........@@@.@@@@...@@@@@@..@@...@@...................@..............@
@@...@.....@.....@............@@.........@@@@@.................@...........@...........@.@
@...............@@@.@.@..........@@.......@@@@........@..............@.....@......@@......
@................@@.@.............@................................................@......
@.........@....@.@@@@.....................................@...@....@@..........@...@......
...............@..@.@.........@......@..................@@@..@@....@@......@...@@....@....
...............@..@.@@...............@....@@@...........@@..........@........@.@.....@....
...........@................@.............@@@..........@@@.....@..@.............@.........
.............@.............................@.......@@...@@..@@@@@.....................@...
............@@........@....@.......@.......@@...........@..@@@@@@.....@...................
..........................................@@............@@@@@@@@@.....@...........@.......
.@....................................@@@.@@@..........@@@@@@@@@...@@....@.....@@.........
....@@....................................@@.....@@@.....@@@@@@............@........@...@.
.....@@......@.........@.......@@@..@@@...@@.......@.....@@@@@@.......@@@@@@@...........@.
....@@@@@..............@............@.....@@.......@.....@@@@@@......@@@@@@@@..........@..
.......@@.......@......@.............@....@@@@........@@@@@@@@@......@@@@@@@@@.......@@@@@
@....@..@@..........@..@@.................@@@@.............@@@@@....@@@@@@@@@@.@.....@@@@@
..@@.@@.............@@@@@.......@.........@@@...............@@@@......@@@@@@@@....@...@@@@
.......................@@@.......@@.......@@.....@...................@@@@@@@@..@.@@....@@@
..@.................@..@@@.......@@.............@@...................@@@@@@@@....@.....@@@
.........@@@.....@......@....................@...@.....@@@...........@@@@@@@@........@@@@@
......@@.@@@..............@....@@.....@....@@@@...@............@......@@@@@@@.@@....@@@@@@
......@..@@.......@@..@...............@@......................@.....@@@@@@@@@@@@@@@@@@@@@@
.........................................................@@@.............@@@@@@@@@@@@@@@@@
...@..............@@....@.....@.@..........@.@......@.@..@@@.......@@@...@@@@@@@@@@@@@@@@@
........@.........@@..........@@@...@@..@@@@@@@..........@@........@@...@@@@@@@@@@@@@@@@@@
@@..........@......@..........@@@@@..@@@@@@.@.......@@@@..@........@@....@@@@@@@@@@@@@@@@@
@@...@.................@@......@@@@@@@@@@@.......@@.@@@@..................@@@@@@@@@@@@@@@@
.....@.@@.....@...............@@@@@@@@................@@@......@@........@@@@@@@@@@@@@@@@@
.......@@...@.@..@...@@.......@@..@@@@..@...@......@..@@......@........@.@@@@@@@@@@@@@@@@@
.......@....@................@@@...@@.......@........@@.............@@@@@@@@@@@@@@@@@@@@@@
@@.....@..................@.........@@@......@.......@@.....@........@@@@@@@@@@@@@@@@@@@@@
@@.....@...........................@@@@@..............@@@............@@@@@@@@@@@@@@@@@@@@@
@@.........................@.@......@@@@@@@@..........@@.....@.....@@@@@@@@@@@@@@@@@@@@@@@
@@@........@.@@@...........@........@@@@@@@@................@@....@@@@@@@@@@@@@@@@@@@@@@@@
@...@......@@.@@@....................@@@@@@@@...@...............@@@@@@@@@@@@@@@@@@@@@@@@@@
@...@@...............@.@@@@......@..@@@@@@@@@...@.....@.........@@@@@@@@@@@@@@@@@@@@@@@@@@
...@@@@...........@....@@@@@.........@@@@@@@@@..................@@@@@@@@@@@@@@@@@@@@@@@@@@
@..@@@..@@..........@..@...@...@......@@@@@@@...................@@@@@@@@@@@@@@@@@@@@@@@@@@
........@@..........@..................@@@@@@....................@@@@.@@@@@@@@@@@@@@@@@@@@
........@@............@..........@.......@@@@......@@......@....@.@@@..@@@@@@@@@@@@@@@@@@@
@@.@.....@............@..................@@@.......@...................@.@@@@@@@@@@@@@@@@@
@@...................................@...@@@.@.....@@.......@..@.........@@@@@@@@@@@@@@@@@
@@@............................@..........@@.@..........@@@@@............@@@@@@@@@@@@@@@@@
@@@.............@..........................@...@@@.....@@@@@@........@....@@@@@@@@@@@@@@@@
@@@....@...........@@@.@...@@@.....@.@...............@..@@@@.............@@@@@@@@@@@@@@@@@
...................@@@@@....@@...@........@........@@@..@@@@@...........@@@@@@@@@@@@@@@@@@
...@@.......@.....@@@@@@@...@@...@..................@@@@@@@.......@....@@@@@@@@@@@@@@@@@@@
.................@@@@@@@@@..@..@@@@@....................@@@@@..........@@@@@@@@@@@@@@@@@@@
......@....@@@@......@@....@@....@@@.............@@......@@@@....@..@@@@@@@@@@@@@@@@@@@@@@
@@@@@.......@@@......@@...@@@....................@.@@..@@@@@@.......@@@@@@@@@@@@@@@@@@@@@@
@@@@@.......@@@@@@@..@@.......@...@@......@...@@.........@@.....@@@@@@@@@@@@@@@@@@@@@@@@@@
@@@@@@@.....@@@@@@......@.....................@@..........@........@@@@@@@@@@@@@@@@@@@@@@@
@@@@..@......@@@@@................@@.........@............@@......@@@@@@@@@@@@@@@@@@@@@@@@
@@@...@..........@@.@.....@..................@@...........@.....@@@@@@@@@@@@@@@@@@@@@@@@@@
@@@.........@@@@.@..@.....@@..@@..........@@.@@..........@@@@@.@@@@@@@@@@@@@@@@@@@@@@@@@@@
..........................@@..@....@.................@...@@@@@.@@@@@@@@@@@@@@@@@@@@@@@@@@@
.@.@.....@@.@.............@..............@..........@@@.@@@@@@@@@@@@@@@@@@@@@@@@@@@@@@@@@@
.......@.@..@............@@@.........................@@@@@@@@@@@@@@@@@@@@@@@@@@@@@@@@@@@@@
.@@.@.................@....@@.................@...........@@@@@@@@@@@@@@@@@@@@@@@@@@@@@@@@
.@@.......@.....@@@...........@......@.....................@@@@@@@@@@@@@@@@@@@@@@@@@@@@@@@
.@@...............@@........@@@@@....@@...............@..@@@@@@@@@@@@@@@@@@@@@@@@@@@@@@@@@
@@@..............@@@....@......@@....@................@@.@@@@.@@@@@@@@@@@@@@@@@@@.@@@@@@@@
@@@..............@@@...........@@..........@...@......@..@@.@..@@@.@@@@@@@@@@@@@..@@@@@@@@
@@@..............@@@.............@@.......@@...@....@..........@@..@@@@@@@@.@@@@..@@@@@@@@
@@@...............@@..@@.........@.........@..@@....................@@......@@@..@@@@@@@@@
@@@@...........................@@@.........@....................@.......@........@@@@@@@@@
@@@@@..................@................................................@...@......@@@@@@@
@@@@@@@@.....@@......@................@.........@@....................@.....@@.....@@@@@@@
@@@@@@@@@....@@................................@@........@@................@@@@.@@@@@@@@@@
@@@@@@@@@.@...@..................@..............@@....@@..@@...............@@@@@@@@@@@@@@@
@@@@@@@@@.............................@...@........@.......@..@........@@@@@@@@@@@@@@@@@@@
@@@@@@@@.....................@................@...@.......@@..........@@@@@@@@@@@@@@@@@@@@
@@@@@@@@.......@@............@@@@@@@@.........@.................@.....@@@@@@@@@@@@@@@@@@@@
@@@@@@@.....@..@@......@@@@@@@@@@@@@@@@..........@....................@@@@@@@@@@@@@@@@@@@@
@@@@@@@........@@@@....@@@@@@@@@@@@@@..............@@.@...............@@@@@@@@@@@@@@@@@@@@
8
12 67 0
34 44 0
35 53 0
7 48 0
1 38 0
84 33 0
39 65 0
25 40 0

18 55 0
35 28 0
89 3 0
53 57 0
10 73 0
63 37 0
62 50 0
2 47 0
