width 90
height 90
@@@@@@@@@@@@@@@@@@@@@@@@@@@@@@@@@@@@@@@@@@@@@@@@@@@@@@@@@@@@@@@@.....@..@@@@@@@....@@@@@@@
@@@@@@@@@@@@@...@@@@@@@@@@@@@@@@@@@@@@@@@@@@@@@@@@@@@@@@@@...@...@...@....@@@@.....@@@@@@@
@@@@@@@@@@@@@@....@@@@@@@@@@@@@@@@@@@@@@@@@@@@@@@@@@@@@@@@.....@..........@@@@....@..@.@@@
@@@@@@@@@@@@@@......@@@@@@@@@@@@@@@@@@.....@@@@@..@@@@@@@...@.............@@@@@@.........@
@@@@@@@@@@@@@@@@.....@@@@@@@@@@@@@@@@@@........@...@@@@@@....@.............@@@@@.........@
@@@@@@@@@@@@@@@@.......@@@@@@@@@@@@@@@@@.@@..........@@@@..@.................@....@..@....
@@@@@@@@@@@@@@@@.........@@@@@@@@@@@@@@@.............@@@@@.......@...@@..@.......@@@.....@
@@@.@@@.@@.@@@@..........@@@@@@@@@@@@@@@.@@..........@@@@@@..@..@@...@@..........@@..@....
@@..@@@....@@@....@@....@@...@@@@@@@@@.@@@@.@..........@@@@.....@@@..@@@.....@............
@@.........@@..................@@@@@@@..@@....................@@@@.....@........@.........
@@@@............................@@@@@@@....................@..@@@.......@.......@@.....@.@
@@@@@...........................@@@@@@@................@...@@@@@......................@@@@
@@@@@............................@..................@........@@@......................@..@
@@@@@@@........@...................................@......@...@...........@.......@...@...
@@...............@@.....................@..........@...@......@.....@@................@...
@@..............@@@.............@.........@..@...@@@...........@..@.......................
@@.....@@...@@@@@@@..........@@.@............@...............@@@@........@.......@........
@@@.......@..@@@@@@...@.............@@.......@..............@@......@...@@@......@@@....@@
@@@.........@@@@@@@@..@@@...........@@.........@............@@......@@@@@..@.....@@......@
.@@.........@@@@@@@@....@.@..................@@......@..@...@@@...@@@...@@.......@@...@..@
.....@@@@.@@@@@@@.......@@.........@....................@@..@@@..................@....@@@@
@...@@@.@.@@@@@@@.........@.........................@......@@@@........................@@@
@..@......@@@@@@...............................@@..........@@@@..............@@.@.....@@@@
...@.....@@@@@@@@...@@..........@.............@@@...@.@....@@@@......@@..............@@@.@
...@.....@@@@@@@................@........@@...@@...........@@@..@.....@...........@......@
.....@...@@....@....@.....@.@.............@@...@....@.......@@..@@@@..............@.......
.........@@.............................@@@@...@...........@.........@....................
.........@@..........@..@...........@...@@@@...........@...@@..................@@.....@...
........................@...............@@@@..........@@..@.@..................@...@......
.....@............................@.....@@....@@.......@....@@..........@......@@..@......
...@@............@...........@@...@@...............@@..@@..................@....@..@@.....
........@@@@..@.@@@@@........@....@.....@@@............@@.................@@@..@@..@@.....
@....@....@@@@@@@@@@@@...@@@@@...@@.....@.........@...@@.@.................@@@.@@.........
@.....@......@@@@@@@@@..@@@@@@@..@@.....@.@@..@...@@@@@@.......@.......@@@.@@@@@@@@@......
@............@@@@..@@@...@@@@@@...@.......@@..@.....@@@@.@..............@...@@@@@@@@......
@..@..........@.@..@@@@..@@@@@....@.....@@@@........@@@@.@...................@@@@@@@@@@@@@
@@@@......@...@.........@@@@......@.....@..@@......@@@@......................@@@@@@@@@@@@@
@@@@.....................@@@...............@......@@@.......@@....@...........@@@@@@@@@@@@
...@............................@...@.............@@@.....@@@@@............@..@@@@@@@@@@@@
....@...............................@@.............@....@..@@@@@@..........@.@@@@@@@@@@@@@
....@........@........@@...@........@@.............@.......@@@....@...@......@@@@@@@@@@@@@
....................@@.@@@@............................@...@@@@@@@...........@@@@@@@@@@@@@
.......................@@@...@@@...@...................@...@@@@@............@@@@@@@@@@@@@@
.............................@@@@....@@...@@@@.@@@@@..@....@@@@@......@@@@@@@@@@@@@@@@@@@@
....@........................@@......@@....@@@.@..@@.......@@@@@......@@@@@@@@@@@@@@@.@@@@
....@.@..................@...@@.......@..................@...@.......@@@@@@@@@@@@@@@..@@@@
@.....@@@@@.@......@@@@....@@@@................@.....................@@@@@@@@@@@@@@....@@@
@...@..@@@@@@......@@@@@@.....@...........@.@...................@....@@@@@@@@@@@........@@
@@.....@@@@...@@@.@@@@@@@.............................@..............@@@@@..@@@@.........@
@....@.@@@....@...@@@@@@@...........................@....@............@@@@...@@..........@
@....@@@@@@.......@@@@@....@.....@.................................@..@@@.....@...........
@....@@@@............@@@...........................................@.@@@@................@
@@...@@@@@.............@@..........................................@.@...................@
@@@..@@@.......................@@.......@@....@@....@......@................@............@
@@@..@@@@@@.............................@@................................@..............@
@@@..@@@@@@.....@@@......................@.................@.................@........@...
@@@@@@@@@@@@...@@@@...@@@.........................@@........................@@@@..........
@@@@@@@@@@@@@@@...@...@@...............@..........@......@.....@........@@@@@@@@..........
@@@@@@@@@@@@@@@.......@@@..............@.@@.....@@@.....@@@.......................@@......
@@@@@@@@@@@@@@@.@@@@@...@@@..............@@......@@..............@....@.........@@@@......
@@@@@@@@@@@@@@@@@@@@@@..............@....@@......@..@......@@..............@.............@
@@@@@@@@@@@@@@@@@@@@@@@...@.........@........@@..........................................@
@@@@@@@@@@@@@@@@@@@@@@........................@...........@..@..........@.......@@.....@@@
@@@@@@@@@@@@@@@@@@@@@@@.....................@.@...........@...@........................@@@
@@@@@@@@@@@@@@@@@@@@@@@@@@..@....@...............@@...........@...........@.....@.....@@@@
@@@@@@@@@@@@@@@@@@@@@@@@@@@@@@@.................@@@@@.......@...................@........@
@@@@@@@@@@@@@@@@@@@@@@@@@@@@@@@....@.................@@..@@@@.@.......................@...
@@@@@@@@@@@@@@@@@@@@@@@@@@@@@@...@...........@@...........@@.................@........@...
@@@@@@@@@@@@@@@@@@@@@@@@@@@@@@...@....@@@.....@@.............................@@..........@
@@@@@@@@@@@@@@@@@@@@@@@@@@@@...@..@....@@......@@......................................@..
@@@@@@@@@@@@@@@@@@@@@@...@@@...@......@......@@@..@.....@.....@.......@@@@..............@@
@@@@@@@@@@@@@@@@@@@.@.....@.........@@@@...@...................................@........@@
@@@@@@@@@@@@@@@@@@@.................@@@@...@................................@...........@@
@@@@@@@@@@@@@@@@@@@@..@@...@.....@@..@@@...@................................@............@
@@@@@@@@@@@@@@@@@@@@@@@@..............@@.......................................@.........@
@@@@@@@@@@@@@@@@@@@@@@@@.......@......@...@......@.....................@....@@.@@.....@...
@@@@@@@@@@@@@@@@@@@@@@@@.....@................@@@@..............@@@..@....@.@@@.@.....@...
@@@@@@@@@@@@@@@@@@@@@@@@...@..............@...@@@........@......@@...........@@.@.........
@@@@@@@@@@@@@@@@@@@@@@@@.@@@@................@@@..@@.....................@.@@@@.........@.
@@@@@@@@@@@@@@@@@@@@@@@.............@..@@....@.@@@@....@................@@..@@@...........
@@@@@@@@@@@@@@@@@@@@@@.............@@...@................@.......@.....@@...@@@@....@@.@@.
@@@@@@@@@@@@@@@@@@@@@@.......................@....@.......................@.........@@....
@@@@@@@@@@@@@@@@@@@@@@............................@.............................@........@
@@@@@@@@@@@@@@@@@@@@@..........@@@...........@.............@...................@@........@
@@@@@@@@@@@@@@@@@@@@@.......@@@@@@@..........@....@.......................@..@@@@@@@@....@
@@@@@@@@@@@@@@@@@@@@@@@......@@.@@...............................@@@.........@@@@@@@@.@@@@
@@@@@@@@@@@@@@@@@@@@@@.......@@..........................@@....@@@@...........@@@@@@@@@@@@
@@@@@@@@@@@@@@@@@@@@.............@@@@@@....................@.@@@@@@...........@@@@@@@@@@@@
@@@@@@@@@@@@@@@@@..@.............@@@@@.................@...@@@@@@@@@.............@@@@@@@@@
@@@@@@@@@@@@@@@@@@...........@@@@@@@@@.........@..@@@@.@.@.@@@@@@@@@.............@@@@@@@@@
8
25 58 0
58 46 0
39 65 0
35 35 0
62 79 0
11 29 0
23 71 0
21 25 0

20 6 0
49 48 0
16 41 0
8 10 0
30 68 0
72 23 0
68 45 0
64 0 0
