width 90
height 90
..@@@....@.@@@@@...@@@@@@@@@@@@@@@@@@@@.............@@@@@@...@@@@@..@@@@@@@@@..@@@@@@@@@@@
..@...........@@...@@@@@@@@@@@@@@@@@@@@...........@@@@@@@@...@@......@@@@@@@@........@@@@@
..............@......@@@@@@@@@@@@@@@@.....@..@....@@@@@@@@............@@@@@@@........@@@@@
..............@..............@@@@@@@@........@..@@@@@@@@@@............................@@@@
...............@.......@@........@@@.............@@@@@@@@@............................@@@@
....@@.@@@..@....@....@.......................@..@@@@@@@@......@.........@...........@@@@@
.....@@@@@........@@....@@...@....................@@@@@.........@@.........@.........@.@@@
....@@@@@@@.............@.........................@@@@.....@....@......................@@@
....@@.............@@........................@.@@@@@@@.@....@.@@@@@.@................@.@@@
.....@......................@...........@.......@@@@@@......@.......@@..@..............@@@
....@@..........@....@............................@@@@@@.........@...@................@@@@
..@.@@............................................@@@@@@............@.....................
....@@..............@@.....@............@........@@@@@@@@@...@.............@.....@.@@.....
@@..@@@.............@........................@...@@@@@@@@@..............@@@@.@@..........@
.....@@@....................@.....................@@@@@@@@..............@@@....@@.......@@
.@...@@....@@..............@@...................@@@@@@@@@@....................@@@..@....@@
......@....................@@@...................@@@@@@@@@@.@@..@@............@@@@@.....@@
.....@@@@........................................@@.....@@@@@@..@@.............@@@......@@
......@@@..............@........@@.........@@..@@@......@@@@@@@.............@...@@.......@
.....@......@..........@.......@@@@..@@........@@............@..........@.@@@.........@.@@
@@.....................@...@...@@@@@..@@............................@@.@@.@@@@@@@@@.......
@@@......@..........@..@..@...@..@...@@..........................@.........@@@@@@@@.......
@@@......@.....@.@....@@.............@@@@@.............@..................@@@@@@..........
@@@@...........@@......@...@@.........@.@@...........@..............@...@@@@@@@@.......@.@
@@@@@@.......@@@@@@.............@.......@@@........@...........@.......@@@@@...@.........@
@@@@@@.......@@@@@@.......@@@............@.......@@...........@..........@@@...@@........@
@@@@@......@.@@@@@@......@@@@............@......@@@..@...............@.....@..........@..@
@@@@@.........@@@@@@................@.....@.....@@@@..................................@...
@@@@@...@......@@..................@@......@......@...............@................@......
@@@@@..........@........@...@.........................@@.@@...............................
@@@@@..........................@.@......@.........................@.......................
@@@@@..................@@@.......@................@.............@................@........
.......................................@@...@.....@@.@@...............@...@...@@.@........
....@@.........................@.......@@...@..@@.@@.@@...............@..@@..@@@..........
...@@@...........@@@..........................@@@@@@@@@..................@@...@.....@....@
...@@.............@@.........................@@..@@@................@@....@............@.@
...@.........@..........................................@..@...........................@@@
.@@@@................@.........@@@@.....................@.......@@......................@@
@@@@@....@..........@@...........@..........@@.........@.........@......................@@
@@@@@@...@...@.....@@@@@...@@........@@..@@..@..@...@..@.....@@..........................@
@@@@@@@@.@.....@.@.@@@@@.............@@.........@...@.........@.........................@@
@@@@@@@.............@@@..............@...........@...........................@@@.........@
@@@@@@@.............@.....@..................................@...............@@...........
@@@@@@....................@.....@........................@...@...........@..@@@@@@...@...@
@@@@@@@.......@..........@@...@@@...@@.............@@....................@.@@@@@@@@..@....
@@@@@@@@.....@...........@@...@@@....@..@...................................@@@@@@@...@@@.
@@@@@@@@.............@....@...@@@@..............@@.........................@@.............
@@@@@@@@.@@...@@......................@.......@...........@@.........@.....@@....@.....@@@
@@@@@@@..@@@.......@...@...@.......@@.........@............@........@@.....@..........@@@@
@@@@@@@@@@@@...........@............@.........@.@@.........@@......@@@..@.......@.......@@
@@@@@@@@@@@@@@.................@....@............................@@@@@@.@@...............@
@@@@@@@@@@@@@@..@.....@@@.@....@@.....@...........................@@@@.................@@@
@@@@@@@@@@@@....@@...@........................@@.@.................@@@@@..@..@........@@@@
@@@@@@@@@@@@@@@.@@...............@.................................@@@@@...............@@@
@@@@@@@@@@@@@@@@@@@.....@@@.@..@...........@.................@.........................@@@
@@@@@@@@@@@@@@@@@@@@............................................@.................@.....@@
@@@@@@@@@@@@@@@@@@.....@@........@@.................@....@.........................@...@@@
@@@@@@@@@@@@@@@@@@.....@@....@...@..............@@@@@...........@................@...@@@@@
@@@@@@@@@@@@@@@@@......@@@@........@...........@@@@@@.....................@@..@.@@@....@@@
@@@@@@@@@@@@@@@@@......@@@@@...................@@@@@@.......@.............@@.@@.@@@@..@@@@
@@@@@@@@@@@@@@@@@@@@@...@@@@...........@.......@@@@@@............@...@..@..@@@@@@@@...@@@@
@@@@@@@@@@@@@@@@@@@@@.@@@@@@@................@@@@@@@.................@@.@..@@@@@@@@@@@@@@@
@@@@@@@@@@@@@@@@@@@@@@@@@@@@@@...............@@@@@@@.................@@@@@@@@@@@@@@@@@@@@@
@@@@@@@@@@@@@@@@@@@@@@@@@@@@@................@@@@.........@@......@@@@@@@@@@@@@@@@@@@@@@@@
@@@@@@@@@@@@@@@@@@@@@@@@@@@@@.....@..........@@....................@@@@@@@@@@@@@@@@@@@@@@@
@@@@@@@@@@@@@@@@@@@@@@@@@@@@@...............@@@@@@.................@@@@@@@@@@@@@@@@@@@@@@@
@@@@@@@@@@@@@@@@@@@@@@@@@@@@@......@@.......@@@@@@.................@@@@@....@@@@@@@@@@@@@@
@@@@@@@@@@@@@@@@@@@@@@@@@@@@@@....@..........@@@@@@.@...............@.....@.@@@@@@@@@@@@@@
@@@@@@@@@@@@@@@@@@@@@@@@@@@@@@@@..............@@@@@......@@....@..........@@@@@@@@@@@@@@@@
@@@@@@@@@@@@@@@@@@@@@@@@@@@@@@@@...............@@@@............@..@.......@@@@@@@@@@@@@@@@
@@@@@@@@@@@@@@@@@@@@@@@@@@@@@@@@...@......@@@@@@@@@...........@.....@......@@@@@@@@@@@@@@@
@@@@@@@@@@@@@@@@@@@@@@@@@@@@@@@@..@@@.@@@@@@@@@@@@.....@......@@@...@@......@@@@@@@@@@@@@@
@@@@@@@@@@@@@@@@@@@@@@@@@@@@@@@@@@@@@@@@@@@@@@@@@@..............@..............@@@@@@@@@@@
@@@@@@@@@@@@@@@@@@@@@@@@@@@@@@@@@@@@@@@@@@@@@@@@@@...@.....................@.@@@@@@@@@@@@@
@@@@@@@@@@@@@@@@@@@@@@@@@@@@@@@@@@@@@@@@@@@@@@@@@.......@................@....@@@@@@@@@@@@
@@@@@@@@@@@@@@@@@@@@@@@@@@@@@@@@@@@@@@@@@@@@@@@@@@...@....@.....................@@@@@@@@@@
@@@@@@@@@@@@@@@@@@@@@@@@@@@@@@@@@@@@@@@@@@@@@@@@@@@@.@....@...........@@@.....@@@@@@@@@@@@
@@@@@@@@@@@@@@@@@@@@@@@@@@@@@@@@@@@@@@@@@@@@@@@@@@@@@@@...@...@.......@@@@...@@@@@@@@@@@@@
@@@@@@@@@@@@@@@@@@@@@@@@@@@@@@@@@@@@@@@@@@@@@@@@@@@@@@@@@@@@..@.......@@@@@@@@@@@@@@@@@@@@
@@@@@@@@@@@@@@@@@@@@@@@@@@@@@@@@@@@@@@@@@@@@@@@@@@@@@@@@@@@@@@@......@@@@@@@@@@@@@@@@@@@@@
@@@@@@@@@@@@@@@@@@@@@@@@@@@@@@@@@@@@@@@@@@@@@@@@@@@@@@@@@@@@@@@.....@@@@@@@@@@@@@@@@@@@@@@
@@@@@@@@@@@@@@@@@@@@@@@@@@@@@@@@@@@@@@@@@@@@@@@@@@@@@@@@@@@@@@@@@@.@@@@@@@@@@@@@@@@@@@@@@@
@@@@@@@@@@@@@@@@@@@@@@@@@@@@@@@@@@@@@@@@@@@@@@@@@@@@@@@@@@@@@@@@@@@@@@@@@@@@@@@@@@@@@@@@@@
@@@@@@@@@@@@@@@@@@@@@@@@@@@@@@@@@@@@@@@@@@@@@@@@@@@@@@@@@@@@@@@@@@@@@@@@@@@@@@@@@@@@@@@@@@
@@@@@@@@@@@@@@@@@@@@@@@@@@@@@@@@@@@@@@@@@@@@@@@@@@@@@@@@@@@@@@@@@@@@@@@@@@@@@@@@@@@@@@@@@@
@@@@@@@@@@@@@@@@@@@@@@@@@@@@@@@@@@@@@@@@@@@@@@@@@@@@@@@@@@@@@@@@@@@@@@@@@@@@@@@@@@@@@@@@@@
@@@@@@@@@@@@@@@@@@@@@@@@@@@@@@@@@@@@@@@@@@@@@@@@@@@@@@@@@@@@@@@@@@@@@@@@@@@@@@@@@@@@@@@@@@
@@@@@@@@@@@@@@@@@@@@@@@@@@@@@@@@@@@@@@@@@@@@@@@@@@@@@@@@@@@@@@@@@@@@@@@@@@@@@@@@@@@@@@@@@@
@@@@@@@@@@@@@@@@@@@@@@@@@@@@@@@@@@@@@@@@@@@@@@@@@@@@@@@@@@@@@@@@@@@@@@@@@@@@@@@@@@@@@@@@@@
@@@@@@@@@@@@@@@@@@@@@@@@@@@@@@@@@@@@@@@@@@@@@@@@@@@@@@@@@@@@@@@@@@@@@@@@@@@@@@@@@@@@@@@@@@
8
33 26 0
78 3 0
43 1 0
44 2 0
75 10 0
66 75 0
65 27 0
42 12 0

74 66 0
5 0 0
19 15 0
35 7 0
38 12 0
0 0 0
44 4 0
27 9 0
