width 90
height 90
@@@@@@@@@@@@@@@@@@@@@@@@@@@@@@@@@@@@@@@@@@@@@@@@@@@@@@@@@@@@@@@@@@@@@@@@@@@@@@..@@@@..@..@
@@@@@@@@@@@@@@@@@@@@@@@@@@@@@@@@@@@@@@@@@@@@@@@@@@@@@@@@@@@@@@@@@@@.....@@................
@@@@@@@@@@@@@@@@@@@@@@@@@@@@@@@@@@@@@@@@@@@@@@@@@@@@@@@...@.@@@@..@................@@@...@
@@@@@@@@@@@@@@@@@@@@@@@@@@@@@@@@@@@@@@@@@@@@@@@@@@@@@@@.....@......................@@@@@..
@@@@@@@@@@@@@@@@@@@@@@@@@@@@@@@@@@@@@@@@@@@@@@@@@@@@@@@...........................@@@@@@..
@@@@@@@@@@@@@@@@@@@@@@@@@@@@@@@@@@@@@@@@@@@@@@@@@@@@@@....@............@@.........@@@@@@@.
@@@@@@@@@@@@@@@@@@@@@@@@@@@@@@@@@@@@@@@@@@@@@@@@@@@@@@....@...........@@@.........@@@...@@
@@@@@@@@@@@@@@@@@@@@@@@@@@@@@@@@@@@@@@@@@@@@@@@@@@@@@.................@@...@@.........@@@@
@@@@@@@@@@@@@@@@@@@@@@@@@@@@@@@@@@@@@@@@@@@@@@@@@..@@@.................@...@@.@......@@@@@
@@@@@@@@@@@@@@@@@@@@@@@@@@@@@@@@@@@@@@@@@@@@@@@@@.........@@...............@@............@
@@@@@@@@@@@@@@@@@@@@@@@@@@@@@@@@@@@@@@@@@@@@@@@@@@........@..............................@
@@@@@@@@@@@@@@@@@@@@@@@@@@@@@@@@@@@@@@@@@@@@@@@@@.....@@@............@..@.....@.......@@@@
@@@@@@@@@@@@@@@@@@@@@@@@@@@@@@@@@@@@@@@@@@@@@@@@......@@@.................................
@@@@@@@@@@@@@@@@@@@@@@@@@@@@@@@@@@@@@@@@@@@@@@@....@.....................................@
@@@@@@@@@@@@@@@@@@@@@@@@@@@@@@@@@@@@@@@@@@@@@@@@.....@.................................@@@
@@@@@@@@@@@@@@@@@@@@@@@@@@@@@@@@@@@@@@@@@@@@@@@@@..............................@.........@
@@@@@@@@@@@@@@@@@@@@@@@@@@@@@@@@@@@@@@@@@@@@@@@@@....@....................@.....@...@@...@
@@@@@@@@@@@@@@@@@@@@@@@@@@@@@@@@@@@@@@@@@@@@@@@@..@........@@@@...........@.....@........@
@@@@@@@@@@@@@@@@@@..@@@@@@@@@@@@@@@@@@@@@@@@@@....@@@.......@@@@@....@@.....@..@..........
@@@@@@@@@@@@@@@@@@@...@@...@@@@@@@@@@@@@@@@@..........@....@@@@@@...@@....@.............@.
@@@@@@@@@@@@@@.@@@.........@@@@@@@@@@@@@@@@@@@...@@@.......@@@@@.@..@@..@...............@.
@@@@@@@@@@@@@@.@@..........@@@@@@@@@@@@@@@@@@@@..@@@..@@@@@@@...............@.............
@@@@@@@@@@@@@@..@.........@@@@@@@@@@@@@@@@@@@@@@@@@@..@@@@@@@@.@..@.......................
@@@@@@@@@@@@@@.............@@@@@@@@@@@@@@@@@@@@@@@@@@@@@@@@@@@......@..................@@@
@@@@@@@@@@@@@@..............@@@@@@@@@@@@@@@@@@@@@@@@@@@@@@@@@@@........@........@.....@@@@
@@.@@@@@@@@@@@.............@@@@@@@@@@@@@@@@@@@@@@@@@@@@@@@@@@@..@..........@............@@
@..@..@@@@@@@@..@@.......@@@@@@@@@@@@@@@@@@@@@@@@@@@@@@@@@@@@@.......@@.......@..@.......@
.......@@@.@@.............@@@@@@@@@@@@@@@@@@@@@@@@@@@@@@@@@@@@..............@....@.....@@@
..@..@@@@@.......@.......@@@@@@@@@@@@@@@@@@@@@@@@@@@@@@@@@@@@@.@............@........@@...
@....@@@@....@............@@@@@@@@@@@@@@@@@@@@@@@@@@@@@@@@@@@@....@...........@@@....@@...
.....@@@@....@@@........@@@@@@@@@@@@@@@@@@@@@@@@@@@@@@@@@@@@@@...............@@...........
........@....@@@........@@@@@@@@@@@@@@@@@@@@@@@@@@@@@@@@@@@@@.................@....@@....@
..@..........@............@@@@@@@@@@@@@@@@@@@@@@@@@@@@@@@@@@@@@@@............@@....@.....@
.............@..............@@@@@@@@@@@@@@@@@@@@@@@@@@@@@@@@@@@@@........................@
..............@@........@...@@@@@@@@@@@@@@@@@@@@@@@@@@@@@@@@@@@@@@@@.....@.....@..........
@@...........................@@@@@@@@@@@@@@@@@@@@@@@@@@@@@@@@@@@..@@@@...@................
@@........................@@@@@@@@@@@@@@@@@@@@@@@@@@@@@@@@@@@@@@....@@......@@@@.....@@@@.
.......@@@@....@@.....@@...@@@@@@..@@@@@@@@@@@@@@@@@@@@@@@@@@@@@.....@@@@......@@@...@@@@.
........@@@...........@....@.@@@@..@..@@@@@@@@@@@@@@@@.@@@@@...................@@@@@.@@@@@
..@.....@@@@...@......@....@..........@@@@@@@@@@@@@@@@.........@................@....@@@@@
@@@@...@@@@@......@.......@........@.@@@@@@@@@@@@@@@@@.......@@@.......@@@..........@@@@@@
@@@@.....@.@......@@@..@............@@@@@@@@@@@@@@@@.@@@@....@@@@........@..........@@@@@@
@@@@...............@.......@@..........@@@@@@@@@@@@@.@@@.....@.@@...........@@....@@@@@@@@
@@@@...............@@...@@@..............@@@@@@@@@@...@......@.@@@.........@....@@@@@@@@@@
@@.@@@..................@.................@@@@@@@@@...@...............@.......@@@@@@@@@@@@
...@..........@@.................@........@@@@@@@.........@..................@@@@@@@@@@@@@
...@..............@.................@....@@@@@@@@@.......@@..................@...@@@@@@@@@
............@@@@...@@..@.................@@@@@@@@@.......@@...............@.........@@@@@@
.............@@@...@@..@........@....@...@@@@@@@@@@.....@@@@@.....@.................@@@@@@
@............@@@@@@@@..@@..@.............@@@@@@@@@@@....@@..@@....@...@...........@..@@@@@
............@..@@@@@......@@.............@@@@@@@@@@@........@...@................@@.@@@@@@
@.............@@@@@@..............@@..........@.@@@@@@..............................@@@@@@
.....@........@@@@@@......@.........................................................@@@@@@
@.@....@......@@@@@@.................@...@...@@.....................................@@@@@@
..@....@@.....@@@@@@....@.........@@@....@.....@........@.........@................@@@@@@@
@....@.........@@@@@@...........@@@...........................@...@................@@@@@@@
@.............@...@@.......................................@@.@....@...............@@@.@@.
@.....@....................................@@@...@@........@@@@......@.............@@@....
@.@@..@................@...@.....@..@@....@@@..............@@@@@@@...@.............@@@....
@@@......@............@@@@....@..@@@@@....@..............@@.....@@........................
@@@@@....@@........@..@@@@....@...@@@@....@...............@@@@..@@............@.......@...
@@@@.....@.........@@@@@@@@@@@......@@....@...@@...........@@@......@@....................
@@@@@........@........@@@@@@@@....@.......@@......@.@@@@@..@........@@@..@................
@@@@.........@.........@@@@@@@@....................@@@@@@..........@@@@..@...........@@@..
@@@@@..................@@@@@..@....@...............@.@@@@..@@@.......@@@.......@.@...@@@..
@@@@@@.................@@.@@....@.....................@....@@.....@@.@@@@@...@@.....@@@@..
@@@@@@..@.................@@..............@...@@............@.....@@@@@@@@...........@@@@@
@@@@@@@..@@................@..........@...@......@.@@...................@............@@@@@
@@@@@@@..@@@......@@...........@.........@.....@@..@@................@......@@@@......@@@@
@@@@@....@.@@......@.......@...@.......@............................@@.......@@@....@@@@@@
@@@@@....@...............@@@@.........@@.....................@......@@@..@...@@....@@@@@@@
@@@.@...................@@@@@@.......@@@@@.....@.......@..@.........@....@........@@@@@@@@
@@.................@.@@.@@@@@@@.......@@@@.....@@.....@@..........................@.@@@@@@
............@...@.........@@@@@.....@@@@@@@.@.@@@@.............@......@.........@...@@@@@@
...........................@@@@@....@@@@@@@...@@@@@@.......@@..................@@.@.@@@@@@
............................@@@...@@@@@@@.....@@@@@.....@......................@@@@@@@@@@@
@......@......@..............@@....@@@@@@..@.@@@@@.....@@....................@@@@@@@@@@@@@
...@...@.......@.....................@@@.....@@@@@@.@@@@@...@@................@@@@@@@@@@@@
..@@.......@...........................@......@@@....@@@@...........@...@....@@@@@@@@@@@@@
................@@@.@.......@...........@...@@@@@....@@@.................@...@@@@@@@@@@@@@
................@@@.@..........@.............@............@...@.......@....@@@@@@@@@@@@@@@
.@........@.......................@..@......@@......@...@@...@@............@@@@@@@@@@@@@@@
@@@..................................@.....................@@..............@@@@@@@@@@@@@@@
@@@@@@.......................@..@@.@@@@@@@@..............@@@@...........@@.@@@@@@@@@@@@@@@
@@@@@@@@@......................@@@@@@@@@@@@........@@...@@@@............@@@@@@@@@@@@@@@@@@
@@@@@@@@@@...............@@@@@@@@@@@@@@@@@@@@.............@@..@.....@...@@@@@@@@@@@@@@@@@@
@@@@@@@@@@@@...........@.@@@@@@@@@@@@@@@@@@@@@............@@@@@...@@@....@@@@@@@@@@@@@@@@@
@@@@@@@@@@@@...@..@@@..@@@@@@@@@@@@@@@@@@@@@@@@......@@...@@@@@@@@@@@@..@@@@@@@@@@@@@@@@@@
@@@@@@@@@@@@@.....@@@.@@@@@@@@@@@@@@@@@@@@@@@@@......@@@...@@@@@@@@@@@@@@@@@@@@@@@@@@@@@@@
@@@@@@@@@@@@@.@..@@@@@@@@@@@@@@@@@@@@@@@@@@@@@@@.....@@@@@.@@@@@@@@@@@@@@@@@@@@@@@@@@@@@@@
8
8 34 0
73 10 0
66 63 0
41 55 0
64 3 0
27 79 0
57 54 0
63 10 0

81 25 0
76 11 0
48 60 0
12 55 0
22 79 0
32 68 0
77 26 0
37 56 0
