width 90
height 90
@@@@@@@@@@@@@@@@@@@@@@@@@@.............@@@@@@@@@@@@@@@@@@@@@@@@@@@@@@@@@@@@@@@@@@@@@@@@@@@
@@@@@@@@@@@@@@@@@@@@@@@@@..............@@@.....@@@@@@@@@@@@@@@@@@@@@@@@@@@@@@@@@@@@@@@@@@@
@@@@@@@@@@@@@@@@@@@@@@@@@..@@...........@@.@...@@@@@@@@@@@@@@@@@@@@@@@@@@@@@@@@@@@@@@@@@@@
@@@@@@@@@@@@@@@@@@..........@.@.......@@@@.@@.....@@@@@@@@@@@@@@@@@@@@@@@@@@@@@@@@@@@@@@@@
@@@@@@@@@@@@@@@@@@............@.@....@@@...........@@@@@@@@@@@@@@@@@@@@@@@@@@@@@@@@@@@@@@@
@@@@@@@@@@@@@@@@@@@.............................@...@@@@@@@@@@@@@@@@@@@@@@@@@@@@@@@@@@@@@@
@@@@@@@@@@@@@@@@@@@@@@..............................@@@@@@@@@@@@@@@@@@@@@@@@@@@@@@@@@@@@@@
@@@@@@@@@@@@@@@@@@@@.........................@......@@@@@@@@@@@@@@@@@@@@@@@@@@@@@@@@@@@@@@
@@@@@@@@@@@@@@@@@@@@.............@.......@...........@@@@@.@@@@@@@@@@@@@@@@@@@@@@@@@@@@@@@
@@@@@@@@@@@@@@@@@@@@..........@...@.......@...@..@...@@@@...@@@@@@@@@@@@@@@@@@@@@@@@@@@@@@
@@@@@@@@@@@@......@@@......@@................@@@@@..@@@@@.....@@@@@@@@@@@@@@@@@@@@@@@@@@@@
@@@@@@@@...................@@.....@@@........@@@@@..@@@@.....@@.@@@@@@@@@@@@@@@@@@@@@@@@@@
@@@@.@@....................@@.......@..........@.....@@@..........@@@@@@@@@@@@@@@@@@@@@@@@
@@@@.................@.....@@.......@@....@..@.......@@@@..@........@@@@@@@@@@@@@@@@@@@@@@
@@@@@.....@@...@@.@@@@.............................@.@@.......@.....@@@@@@@@@@@@@@@@@@@@@@
@@@@@@...@@@.......@@@...........@.................@..............@.@@@@@@@@@@@@@@@@@@@@@@
@@@@@@..@@@........@@..@..............@@.......@@.................@@@@@@@@@@@@@@@@@@@@@@@@
@@@@@@.........@..@@@...........@......@@@....................@....@@@@@@@@@@@@@@@@@@@@@@@
@@@@@@@@..........@@.....@.@....@@@...@...................@@........@@@@@@@@@@@@@@@@@@@@@@
@@@@@@@..........@@..@........@@@@...................................@@@@@@@@@@@@@@@@@@@@@
@@@@@@@.............@@@........@@......@...........................@@@@@@@@@@@@@@@@@@@@@@@
@@@@@@@@..............@......@.......@..........................@..@@@@@@@@@@@@@@@@@@@@@@@
@@@@@@@@.@@......@....@....@.............@..........................@@@@@@@@@@@@@@@@@@@@@@
@@@@@@@@@@@@.......@@......@...............@@.@....@...........@....@@@@@@@@@@@@@@@@@@@@@@
@@@@@@@@@@@@....@@..@@.................@......@..@@.................@..@@@@@@@@@@@@@@@@@@@
@@@@@@@@@@@@@.......@............................@@.................@..@@@@@@@@@@@@@@@@@@@
@@@@@@@@@@@@@....................................@@.........@.........@@@@@@@@@@@@@@@@@@@@
@@@@@@@@@@@@....@......@....................................@.........@@@@@@@@@@@@@@@@@@@@
@@@@@@@@@@@@@...@......................@................@...@.........@@@.@@@@@@@@@@@@@@@@
@@@@@@@@@@@@@@@@@@................................@@..................@@@.@@@@@@@@@@@@@@@@
@@@@@@@@@@@@@@@@@@.......@............................................@@@.@@@@@@@@@@@@@@@@
@@@@@@@@@@@@@@@@@@@@@...@@.......@.........@.@.........................@@..@@@@@.@@@@@@@@@
@@@@@@@@@@@@@@@@@@@@@@...........@.........@.@...............................@@..@@@@@@@@@
@@@@@@@@@@@@@@@@@@@@@@...........@@..@...............@..........@@@.@.............@@@@@@@@
@@@@@@@@@@@@@@@@@@@@@@.@.........................................@@@@@...........@@@@@@@@@
@@@@@@@@@@@@@@@@@@@@@@..............................@.......@....@@@@@...........@@@@@@@@@
@@@...@@@@@@@@@@@@@@@@.........@....@@..............@.............@@@@@...@@......@@@@@@@@
........@@@@@@@@@@@@@@@.@@..@@@@..@.............@...@@............@........@@@.......@@@@@
........@@@@@@@@@@@@@@@@@@.................................................@@@@......@@@@@
@........@@@@@@@@@@@@@@@@...........@@........@........................@@......@.....@@.@@
@.........@@@@@@@@@@@@@@@@..........@@...................@@............@@..........@@....@
....@@........@@@@@@@@.@@@@@...........@..............@........@...........@..............
.....@........@@@@@@@@.....@@..............@..........@...................................
.....@.....@@...@@@@@@......@......@..@@@@@@.@............................................
..................@@@@@@@..............@.....@@.@..........@......@@........@.@@..........
@......................@............@............@.........@......@@@.....................
@@@@....................................@..@..........@@.........@@@.................@....
@@@....@.....@..................@@........@@........@.............@.......@@.@@...........
@@@@@.............@.....@.......@@.@.@@.........@..@@.........................@........@@@
@@@@@.............@.............@@..............@.................@..............@.....@@@
@@@.........................................@@..@@...........@............@.@........@@@@@
@@@......................@..........@....@..@@..@@@@.@..@....@.......................@@@@@
@@@..............@@@.@...............@......@@...@@..............................@...@@@@@
@................@@@.@@....@@...............@@@..........@.@@...@@.............@@@@..@@@@@
............@......@.@......@...............@@....@..@@....@..@@@@........@@@..@@@@.@@@@@@
@....@@.@.........@..@.................@@@...........@........@@@@..@...@@@@@..@@@@@@@@@@@
@....@..@............@..........@......@....@.........................@@@@@@@@@@@@@@@@@@@@
@@........................@@.........................@...@.............@@@@@@@@@@@@@@@@@@@
................@@.....@..@@...@...................@.@.................@@@@@@@@@@@@@@@@@@@
......@@@@.@....@@.......@@@.........@.............@@@.................@@@@@@@@@@@@@@@@@@@
......@@@@@................@@@......................@@@......@.....@.@@@@@@@@@@@@@@@@@@@@@
......@@@@.............@.....@@..@......@...........@@@@..@@@......@@@@@@@@@@@@@@@@@@@@@@@
.......@@@.................@............@@@@@@.....@@@....@......@@@@@@@@@@@@@@@@@@@@@@@@@
...@@@@@@@@..................@@.......@@@@@@@@@..@@@@@.....@.....@@@@@@@@@@@@@@@@@@@@@@@@@
...@@@@@@@@@..........................@@@@@@@......@@@......@......@@@@@@@@@@@@@@@@@@@@@@@
@@.@@@@@@@@@@....................@@..@@@@@.....................@...@@@@@@@@@@@@@@@@@@@@@@@
@@@@@@@@@@@...........@@.........@@@@@@........................@@@@@@@@@@@@@@@@@@@@@@@@@@@
@@@@@@@@@@@..........@@@.........@@@@@@............@...........@@@@@@@@@@@@@@@@@@@@@@@@@@@
@@@@@@..@.............@@.@@@@....@@@@@@@.......................@@@@@@@@@@@@@@@@@@@@@@@@@@@
@@@@@...........@@....@@@.......@@@@@@@@@......................@@@@@@@@@@@@@@@@@@@@@@@@@@@
@@@@@...........@@......@......@@@@@@@@@@@@@................@..@@@@@@@@@@@@@@@@@@@@@@@@@@@
@.@@@......@...........@@......@@@@..@@@@@@@................@@@@@@@@@@@@@@@@@@@@@@@@@@@@@@
.................@@....@@.........@....@@@...............@@@@@@@@@@@@@@@@@@@@@@@@@@@@@@@@@
@@......@........@..@............................@@@@.....@@@@@@@@@@@@@@@@@@@@@@@@@@@@@@@@
@@..............@@@@@.@..........................@@@......@@@@@@@@@@@@@@@@@@@@@@@@@@@@@@@@
@@...@......@.....@@@......@.....................@@...@....@@@@@@@@@@@@@@@@@@@@@@@@@@@@@@@
@@@@@@@@.@.@@......@@............................@@......@..@@@@@@@@@@@@@@@@@@@@@@@@@@@@@@
@@@@@@@@...@@......@...@..@.....@@@.........................@@@@@@@@@@@@@@@@@@@@@@@@@@@@@@
@@@@.......@@@.....@.........................................@@@@@@@@@@@@@@@@@@@@@@@@@@@@@
@......@...@.@..............@.............@@........@@........@@@@@@@@@@@@@@@@@@@@@@@@@@@@
@...@@..........@...........@.@@....@...............@@@........@@@@@@@@@@@@@@@@@@@@@@@@@@@
@..........@......@@........................@@.@@....@@.......@.@@@@@@@@@@@@@@@@@@@@@@@@@@
@.......@..@.....@@@.................@@@........@...@@@.........@@@@@@@@@@@@@@@@@@@@@@@@@@
@@@...............@@.................@@@............@@@@........@@@@@@@@@@@@@@@@@@@@@@@@@@
@@@................@@...@..............@.............@@@........@@@@@@@@@@@@@@@@@@@@@@@@@@
@@@....................................@...@@..........@.@....@.@@@@@@@@@@@@@@@@@@@@@@@@@@
@@......................@@@......@.....@....@@..................@@@@@@@@@@@@@@@@@@@@@@@@@@
@@..@....@......@.......@.@......@....@@@@.@@@......@...........@@@@@@@@@@@@@@@@@@@@@@@@@@
@@@...............@@....@..@@@.......@@@@@@@..............@@.@@@@@@@@@@@@@@@@@@@@@@@@@@@@@
@@@......@@@.......@..@....@@@..@...@@@@@@@@..@..@.........@@@@@@@@@@@@@@@@@@@@@@@@@@@@@@@
8
41 13 0
47 15 0
10 44 0
40 5 0
3 85 0
77 52 0
20 51 0
10 75 0

36 58 0
19 3 0
17 78 0
35 37 0
31 22 0
25 9 0
28 48 0
47 3 0
