width 57
height 57
@@@@@@@@@......@@@@@@@@@.......@@@@@@@@@@........@@.@....
@@@@@@@@@.........@@@..@.......@@@@.@@@@@@@@@.......@....
@@@..@@@@.........@@@............@...@@@@@@.........@...@
@@......@.........@@.............@....@.@@@.....@@@......
@@@...@.......................@..@....@...............@.@
@@...@........................@.........................@
@.....@@.........................@.....................@@
@...@@@......................@...@..............@@......@
@@..@.@@@..@...................@....@@.........@@@.....@@
@@@........@.......@..@..............@...................
......@............@...........@.........................
...........................@.......@...................@@
...............@......@...............@..................
.@.............@..................................@......
...............@...@@...........................@........
@.........@@@......@@@@@.....@@...@......................
@......@@@@@@.........@@.....@...........................
@.......@@@@@@@.....@@@..............@................@..
...@..@@@@@@@@@@@@@..@@@.......@@@@@.@..........@@......@
..@@..@@@@@@@@@@@@@..@@..................@.....@........@
@@@@.@@@@@@@@@@@@..............@@.......@@@@@@@@@.......@
@@@@@@@@@@@@@@@@....@..@@@@@@..@@.......@@@@@@@@@@@.....@
@@@@@@@@@@@@@@@@@...@@@@@@@@@..@........@@@@@.@@@@@@@...@
@@@@@@@@@@@@@@@@@.@@@@@@@@@@@...........@@@@@...@@@@@..@@
@@@@@@@@@@@@@@@@@...@@@..@.@@..............@@@.@@@@@@..@@
@@@@@@@@@@@@@@@@@@.........@@...................@@@@@@@@@
@@@@@@@@@@@@@@@@@...............................@@@@@@@@@
@@@@@@@@@@@@@@@@@...............................@@@@@@@@@
@@@@@@@@@@@@@@@@..............@.@.....@..........@@@@@@@@
@@@@@@@@@@@@@@@@@.............@@@.................@..@@@@
@@@@@@@@@@@@@@@@...@...........@...@@....@........@..@@@@
@@@@@@@@@@@@@@@................@.........@..@@....@..@@@@
@@@@@@@@@@@@@@@@@@@........................@@@@@..@..@@@@
@@@@@@@@@@@@@@@@@@@@.......@@......@@.@.....@@@@.....@@@@
@@@@@@@@@@@.@@@.@@@@.......@@.@....@...@....@@@@.....@@@@
@@@@@@@..........@.@.......@@@@@..@@.......@@@@@@@@@@@@@@
@@@@@@@.@...@......@.......@@..............@@@@@@@@@@@@@@
@@@@@@@@@@......@..........@@.@.............@@@@@@@@@@@@@
@@@@@@@@@@........................@@..@@@@@@@@@@@@@@@@@@@
@@@@@@@@@@.@@.@@@@......@@........@..@@@@@@@@@@@@@@@@@@@@
@@@@@@@@@@@@@@@@........@@........@..@@@@@@@@@@@@@@@@@@@@
@@@@@@@@@@@@@@@@...............@.....@@@@@@@@@@@@@@@@@@@@
@@@@@@@@@@@@@@@@@@@..@..........@@@..@@@@@@@@@@@@@@@@@@@@
@@@@@@@@@@@@@@@@@@@@@@@@...@@@....@...@@@@@@@@@@@@@@@@@@@
@@@@@@@@@@@@@@@@@@@@@@@@....@@@@..@.....@@@@@@@@@@@@@@@@@
@@@@@@@@@@@@@@@@@@@@@@@@@@@.@.@...@.....@@@@@@@@@@@@@@@@@
@@@@@@@@@@@@@@@@@@@@......@...........@..@@@@@@@@@@@@@@@@
@@@@@@@@@@@@@@@@@@@@..............@@.......@@...@@@@@@@@@
@@@@@@@@@@@@@@@@@@@@..............@@........@..@@@@@@@@@@
@@@@@@@@@@@@@@@@@@@@@.....@......@@............@@@@@@@@@@
@@@@@@@@@@@@@@@@@@@@@@@@@@......@@@....@........@@@@@@@@@
@@@@@@@@@@@@@@@@@@@@@@@@@@...@..@@@@@..........@@@@@@@@@@
@@@@@@@@@@@@@@@@@@@@@@@@@@@@@@@@@@@.........@@@@@@@@@@@@@
@@@@@@@@@@@@@@@@@@@@@@@@@@@@@@@@@@...........@@@@@@@@@@@@
@@@@@@@@@@@@@@@@@@@@@@@@@@@@@@@@@@@.........@@@@@@@@@@@@@
@@@@@@@@@@@@@@@@@@@@@@@@@@@@@@@@@@@@@@......@@@@@@@@@@@@@
@@@@@@@@@@@@@@@@@@@@@@@@@@@@@@@@@@@@@.......@@@@@@@@@@@@@
8
16 16 0
40 19 0
24 8 0
33 44 0
51 10 0
16 15 0
29 12 0
12 37 0

16 9 0
38 19 0
43 54 0
31 43 0
40 12 0
43 56 0
40 46 0
18 35 0
