width 57
height 57
@@@@@@@@@@@@@@@@@@@@@@@@..@@@@@@@@@@@@@@@@@@@@@@@@@@@@@@@
@@@@@@@@@@@@@@@@@@@@@@@@...@@@@@@@@@@@@@@@@@@@@@@@@@@@@@@
@@@@@@@@@@@@@@@@.@@@@@@@.......@@@@@@@@@@@@@@@@@@@@@@@@@@
@@@@@@@@@@@@@.....@@@@....@@...@@@@@@@@@@@@@@@@@@@@@@@@@@
@@@@@@@@@@@.........@@@..@@@.@@@@@@@@@@@@@@@@@@@@@@@@@@@@
@@@@@@@@@@@..........@@..@@@@@@@@@@@@@@@@@@@@@@@@@@@@@@@@
@@@@@@@@@@@......@.@.@@.@@@@@@@@@@@@@@@@@@@@@@@@@@@@@@@@@
@@@@@@@@@@@....@@@......@@@@@@@@@@@@@@@@@@@@@@@@@@@@@@@@@
@@@@@@@@.......@.......@@@@@@@@@@@@@@@@@@@@@@@@@@@@@@@@@@
@@@@@@@@@..@.............@@@@@@@@@@@@@@@@@@@@@@@@@@@@@@@@
@@@@@@@@@@@@............@@@@@@@@@@@@@@@@.@@@@....@@@@@@@@
@@@@@@@@@@@@@...........@..@@@@@@@@@@@@@........@.@@@@@@@
@@@@@@@@@@@@@...@..........@@@@@@@@@@@@@@.........@@@@@@@
@@@@@@@@@@..................@@@@@@@@@@@@...@......@@@@@@@
@@@@..@..............@.......@@@@@@@@@@@..@@......@@@@@@@
@@...........................@@@.....@@@@@@@.........@@@@
@@@...............@..@........@......@@@@@@@.........@@@@
@@@.....@@@.......@..........@@@.........@@@.@........@@@
@@@@.@........@.....@@@@.....@@@..........@@.@........@@@
@@@@................@@@@..................@@@.........@@@
@@@@.....@...@......@@@@@@.................@.......@@@@@@
@@@@@........@......@@@@@@@.........................@@@@@
@@@@.........@......@@@@@@@...................@......@@@@
@@@@.....@..@..........@@@@@@........................@@@@
@@@@@@.....@........@@@@...@@@........@..............@@@@
@@@@@@@@........@@.........@............@....@...@..@@@@@
@@@@@@@@......@@@@.............@.......@.@.......@@@@@@@@
@@@@@@@@......@@@@@...@......@...................@@@@@@@@
@@@@@@@@......@@@@....@.....@.......@........@...@@@@@@@@
@@@@....@........@.......@..........@......@@@..@@@@@@@@@
@@@@@....@.......@........@....@............@@...@@@@@@@@
@@@......@....@.....@.........@....................@@@@@@
..@....@...@.@@....@@@...@@@.@...........@........@@@@@@@
@.....@..@.@.......@@@@@@@@..@.....@@.@...............@@@
.........@.@......@@@@@@@@@..@...@@@@@@................@@
.......@@..@@....@@@@@@@@....@.....@@@@@@..@...........@@
@@..................................@@@.................@
.......@@.......@@@...................@..@...............
.................@@.................................@....
....@..@.....................@...........................
...........@......................@........@.............
.........@.........@....@............@.....@.............
.........@...@@.@@.@@.................................@@@
.............@@.@@@@@.....@@@........................@@@@
..@.....@@@@@@@@@@@@@.......@........................@@@@
@@@@@...@@@@@@@@@@@@@........@.......@@.....@........@@@@
@@@@@...@@@@@@@@@@@@...............@@@@@....@@@@.....@@@@
@@@@@@.@@@@@@@@@@@@@............@..@@@..@@@....@.....@@@@
@@@@@@.@@@@@@@@@@@@@@.....@........@@@.............@..@@@
@@@@@@@@@@@@@@@@@@@@@@@@..............................@@@
@@@@@@@@@@@@@@@@@@@@@@@@.......................@.....@@@@
@@@@@@@@@@@@@@@@@@@@@@@@@....@.....@....@......@......@@@
@@@@@@@@@@@@@@@@@@@@@@@@@@@@...................@@@@...@@@
@@@@@@@@@@@@@@@@@@@@@@@@@@@@@...................@@...@@@@
@@@@@@@@@@@@@@@@@@@@@@@@@@@@@......@@@@..........@...@@@@
@@@@@@@@@@@@@@@@@@@@@@@@@@@@@@......@@@...........@@.@@@@
@@@@@@@@@@@@@@@@@@@@@@@@@@@@@@@@....@@@@......@...@@.@@@@
8
47 43 0
31 45 0
19 15 0
25 11 0
34 39 0
12 26 0
45 35 0
31 36 0

19 38 0
30 42 0
16 9 0
36 19 0
40 36 0
18 29 0
47 39 0
21 17 0
