width 20
height 30
@...@@@@@@@.....@@@@
.....@.............@
...@...............@
.....@...@.@........
....................
....................
..@......@.....@....
......@...@.......@@
..@@@......@.....@@@
.................@@@
..........@.@.@.@@@@
@@..@...............
@@..................
@@..@.......@.@.....
@@....@.............
..@........@..@.@...
@....@..............
@.............@.....
..@.....@.@.......@.
.......@.@..........
...................@
....@...@..........@
..........@.........
...........@....@...
....................
......@.....@....@..
....................
...@.......@@.......
....@.....@@@@@.....
.........@@@@@@@@...
6
18 19 0
14 25 0
10 17 0
4 27 1
18 24 1
1 7 1

1 2 0
4 26 0
1 0 0
16 7 1
18 20 1
3 23 1
