width 20
height 30
.....@@@...@@.......
.....@@@............
...@.......@.....@..
...@..@.............
.....@........@...@.
....................
.......@.........@..
.........@..........
...@.......@........
.@..........@.......
....@.@.........@...
........@.....@.....
.......@..@.........
@@.@...........@.@..
....................
...........@.....@..
..@..@.....@........
...@..@...........@.
...............@....
..@..............@..
..........@.........
...@..@....@.....@..
.............@......
.....@....@.........
.@..................
......@..@..@...@..@
..............@.....
......@.............
.....@.@..........@.
@.............@.....
6
5 2 0
14 25 0
7 25 0
16 13 1
17 0 1
17 12 1

15 28 0
15 25 0
14 0 0
15 16 1
0 28 1
7 19 1
