width 20
height 30
....................
....................
....................
............@@......
..@.........@@..@...
.......@............
......@.............
.......@............
..............@.@...
@................@..
.....@.....@........
...............@....
..@........@........
.....@...@.......@..
.@..........@.......
..............@.....
.@.@....@....@....@.
....................
.....@..@..@........
.............@......
.......@...@....@...
.......@............
..@.................
...........@........
...@................
........@...........
..........@....@....
.......@............
..............@.....
.......@...........@
6
17 4 0
2 13 0
13 25 0
11 21 1
13 27 1
7 2 1

18 4 0
19 12 0
19 5 0
17 0 1
16 19 1
5 1 1
