width 20
height 30
...@@...@...........
....................
..........@.........
.....@..............
......@....@..@.....
..........@.........
....................
.......@.@..........
...@.........@......
.@..@.@.@...........
....................
.......@.......@....
........@.........@@
...........@........
............@.......
.....@.@........@...
.................@..
....@...............
..@..............@..
.......@.....@..@...
.@..........@..@....
....@...............
.....@.@.....@.@..@.
.................@..
......@.............
.........@.....@....
@....@......@...@...
.@....@........@....
.........@..........
.....@.............@
6
3 16 0
12 7 0
1 3 0
0 19 1
7 18 1
1 22 1

19 0 0
7 27 0
9 4 0
17 3 1
8 24 1
12 3 1
