width 88
height 88
@@@@@@.....@@@@@@@@@@@@@@@@@@@@@....@@@@@@@@@@@@@@@@@@@@@@@@@@@@@@@@@@@@@@@@@@@@@@@@@@@@
@@@@......@@@@@@@@@.@@@@@@@....@....@@@@@@@@@@@@@@@@@@@@@@@@@@@@@@@@@@@@@@@@@@@@@@@@@@@@
@@@@......@@@@@@@......@..@.........@@@@@@@@@@@@@@@@@@@@@@@@@@@@@@@@@@@@@@@@@@@@@@@@@@@@
@@@@..@...@@.@@@@............@......@@@@@@@@@@@@@@@@@@@@@@@@@@@@@@@@@@@@@@@@@@@@@@@@@@@@
..@.@.@...@@........@..@...........@@@@@@@@@@@@@@@@@@@@@@@@@@@@@@@@@@@@@@@@@@@@@@@@@@@@@
......@.....@.......@@@@@..........@@@@@@@@@@@@@@@@@@@@@@@@@@@@@@@@@@@@@@@@@@@@@@@@@@@@@
.....................@...........@@@@@@@@@@@@@@@@@@@@@@@@@@@@@@@@@@@@@@@@@@@@@@@@@@@@@@@
.@...................@@..........@@@@@@@@@@@@@@@@@@@@@@@@@@@@@@@@@@@@@@@@@@@@@@@@@@@@@@@
...@....................@@.......@@@@@@@@@@@@@@@@@@@@@@@@@@@@@@@@@@@@@@@@@@@@@@@@@@@@@@@
.................................@@@@@@@@@@@@@@@@@@@@@@@@@@@@@@@@@@@@@@@@@@@@@@@@@@@@@@@
@..................@@.............@@@@@@@@@@@@@@@@@@@@@@@@@@@@@@@@@@@@@@@@@@@@@@@@@@@@@@
.........@@........@@@@...........@.@@@@@@@@@@@@@@@@@@@@@@@@@@@@@@@@@@@@@@@@@@@@@@@@@@@@
.....@.....@.......@@@................@@@@@@@@@@@@@@@@@@@@@@@@@@@@@@@@@@@@@@@@@@@@@@@@@@
@.................@..@@..@........@...@@@@@@@@@@@@@@@@@@@@@@@@@@@@@@@@@@@@@@@@@@@@@@@@@@
@..............@.........................@@@@@@@@@@@@@@@@@@@@@@@@@@@@@@@@@@@@@@@@@@@@@@@
@.....@..................@@..............@..@@@@@@@@@@@@@@@@@@@@@@@@@@@@@@@@@@@@@@@@@@@@
......@.@....@...............................@@@@@@@@@@@@@@@@@@@@@@@@@@@@@@@@@@@@@@@@@@@
@.....@@@....@..@......................@@......@@@@@@@@@@@@@@@@@@@@@@@@@@@@@@@@@@@@@@@@@
...@.............@@........@...........@@........@@@@@@@@@@@@@@@@@@@@@@@@@@@@@@@@@@@@@@@
....@@@@..............@@@........@@...@@@...@.....@@@@@@@@@@@@@@@@@@@@@@@@@@@@@@@@@@@@@@
......@.............@..@@.....@..@@@@@@@.@....@...@@@@@@@@@@@@@@@@@@@@@@@@@@@@@@@@@@@@@@
......@...........@@@.............@@.....@...........@@@@@@@@@@@@@@@@@@@@@@@@@@@@@@@@@@@
.....................@...........@@..................@@@@@@@@@@@@@@@@@@@@@@@@@@@@@@@@@@@
.............@.......@@..........@@...................@@@@@@@@@@@@@@@@@@@@@@@@@@@@@@@@@@
................@@.@.@@.@.......@@@@@................@@@@@@@@@@@@@@@@@@@@@@@@@@@@@@@@@@@
@@@@...@@...@...@................@@@@.........@.......@@@@@@@@@@@@@@@@@@@@@@@@@@@@@@@@@@
@@......@.................@...................@.@......@@@@@@@@@@@@@@@@@@@@@@@@@@@@@@@@@
@@..@.........................................@.@@@....@@@@@@@@@@@@@@@@@@@@@@@@@@@@@@@@@
@@..@@@........@..@...............@@@.........@@@@......@@@@@@@@@@@@@@@@@@@@@@@@@@@@@@@@
@@@.@@@.@...@.............@@.....@@@@@@@.......@@@@@....@@@@@@@@@@@@@@@@@@@@@@@@@@@@@@@@
@@@@@@@........@...@...@..@......@@@@@@@........@@@....@@@@@@@@@@@@@@@@@@@@@@@@@@@@@@@@@
@@@@@@@.@......@.......@.@@......@@@@@@..........@@....@@@@@@@@@@@@@@@@@@@@@@@@@@@@@@@@@
@@@@@@@@......@@.........@@....@@@@@@@@...........@.@@@@@@@@@@@@@@@@@@@@@@@@@@@@@@@@@@@@
@@@@@.@@.......@...............@@@@@@@@.............@@@@@@@@@@@@@@@@@@@@@@@@@@@@@@@@@@@@
@@@@@..@.........@..@..........@@@@@@@@.............@@@@@@@@@@@@@@@@@@@@@@@@@@@@@@@@@@@@
...@@...........@..@@...........@@@@@@@@...............@@@@@.@@@@@@@@@@@@@@@@@@@@@@@@@@@
....@@.........@@@@@@..@...........@@@@@@.@@@.@.......@.@@...@@@@@@@@@@@@@@@@@@@@@@@@@@@
..............@@.@@.....@@@@...@..@@@@@@@@@@@.@@........@....@@@@@@@@@@@@@@@@@@@@@@@@@@@
..............@..........@@@@.......@@@@@@@@@........@.......@@@@@@@@@@@@@@@@@@@@@@@@@@@
.@.......................@@@@...@...@@@@@@@@@........@@....@@@@@@@@@@@@@@@@@@@@@@@@@@@@@
...........@...@@@........@@...@.....@@@@@@.@........@@@...@@@@@@@@@@@@@@@@@@@@@@@@@@@@@
..................@.......@@.........@@@@@@..........@.....@@@@@@@@@@@@@@@@@@@@@@@@@@@@@
@@..@@..................@@@..........@@@@@@@......@.@@@....@@@@@@@@@@@@@@@@@@@@@@@@@@@@@
@...@@..................@@@@@.........@@@@@@.@@.....@@.....@@@@@@@@@@@@@@@@@@@@@@@@@@@@@
..............@.......@@@@@@@.........@@@@@@@@@@.....@.....@@@@@@@@@@@@@....@@@@@@@@@@@@
...........@..@@...@.....@@............@.......@@..........@@@@@@@@@@@@@@...@@@@@@@@@@@@
.......@.....@@..........@...........@@@...............@@@.@@@@@@@@@@@@@....@@@@@@@@@@@@
.............@@...@............@......@@...............@@@@@@@@@@..@@@@@....@@@@@@@@@@@@
.....@..@.....@@......................@@...............@@@@@@@@@...@@@......@@@@@@@@@@@@
.....@@@......@@............@.@.......@......@.......@...@@@@..@............@@@@@@@@@@@@
..........@.@@........@.......@......@@..............@....@@@...@...........@@@@@@@@@@@@
..@..........@....@..........@@...........@@@@@............@@@..............@@@@@@@@@@@@
.............................@....@........@@@@@........@...@.............@..@@@@@@@@@@@
............................................@@@@.....@@@@...@....@...........@@@@@@@@@@@
..................@.........@.@..........@@.@@@@@....@@.....@.@@............@@@@@@@@@@@@
.......@.......................@........@@@@@@@@.....@@@...............@...@@@@@@@@@@@@@
.......@.@..............@....@@@........@@@@@@@@...........................@@@@@@@@@@@@@
.............@...............@.@...@.....@@@@@@...................@........@..@@@@@@@@@@
......@...............@@.........@.........@@@@..@...........@................@@@@@@@@@@
......@.........@.....@@.....................@@......@@@.....................@@@@@@@@@@@
@@.............................@......@.....@@@......@@@.@@...............@..@@@@@..@@@@
........@@.........@@@.....@@.........@@@.........@...@..@@.........@@.......@@@...@@@@@
.....@@@@@.................@@@...@....@@..........@...@@..@@........@@.@@......@....@...
......@@@@......................@....@.@.....@@.............@........@.@@.......@@......
........@@...................................@..........................@...............
@@@...@@@.....@.........@@@@.....@.....................................@................
@@@@.@@@@.@......................@@........................@....@..........@.....@......
@@@@@@@@@................@@@.................@....@@@@@......@..@@.............@........
@@@@@@@@...............................@.........@@@@@@@...@@@@.........................
@@@@@@@@@.....@@@.....@@................@@.......@@@@@@@...............................@
@@@@@@@.......@@@...........................@.@..@@@@@@@.......@@........@............@@
@@@@@@@@@..........@.......@..........@.........@@@@@@@@@@.....@......................@@
@@@@@@@...........@........@@@...............@....@@@@@@@.............@......@@.......@@
@@@@@@@@...................@@@..................@@@@@@.........@.@..@.......@@.......@@@
@@@@@@...................@.@@@@.....@@..........@@@@@@.......@......@.........@.....@@@@
@@@@@.......@@........@@@@@@@@@....@@@@.@...@@@.@@@@@@......@......................@@@@@
@@@@@....@.@@@.......@...@@@@.......@@@@@@.@@@@@@@@@@...@..@@..........@@...........@@@@
@@@@@@....@@@@@@..........@@@@@@@...@@@@@@@@@@@@@@@@@.......@......................@@@@@
@@@@@@@@@@@@@@@@.....@....@@@@@@@..@@@@@@@@@@@@@@@@@...................@@@@...@..@@@@@@@
@@@@@@@@@@@@@@@@@@........@@@@@@@@@@@@@@@@@@@@@@@@.................@...@@@@..@@..@@@@@@@
@@@@@@@@@@@@@@@@@@.@.......@@@@@@@@@@@@@@@@@@@@@@......................@@@@@@@@@@@@@@@@@
@@@@@@@@@@@@@@@@@@.@........@@@@@@@@@@@@@@@@@@@@@@............@....@@@..@@@@@@@@@@@@@@@@
@@@@@@@@@@@@@@@@@@..........@@@@@@@@@@@@@@@@@@@@@@@@@................@..@@@@@@@@@@@@@@@@
@@@@@@@@@@@@@@@@@@.........@@..@@.@@@@@@@@@@@@@@@@@@@@@........@@......@@@@@@@@@@@@@@@@@
@@@@@@@@@@@@@@@@@@@@@.............@@@@@@@@@@@@@@@@@@@@@.......@@@........@@@@@@@@@@@@@@@
@@@@@@@@@@@@@@@@@@@@@...........@.@@@@@@@@@@@@@@@@@@@@@...@@@.@@@.......@@@@@@@@@@@@@@@@
@@@@@@@@@@@@@@@@@@@@@@@.........@.....@@@@@@@@@@@@@@@@....@@@@@@@.......@@@@@@@@@@@@@@@@
@@@@@@@@@@@@@@@@@@@@@@@@@.......@.....@@@@@@@@@@@@@@@@@...@@@@@@@......@@@@@@@@@@@@@@@@@
8
71 69 0
21 65 0
38 24 0
41 50 0
19 16 0
29 4 0
38 18 0
34 36 0

32 2 0
8 56 0
5 16 0
68 65 0
32 20 0
53 76 0
0 21 0
18 83 0
