width 88
height 88
@@@@@@@@@@@@@@....@.@.@@............@@@................@@@@@@.....@@@@@@@@@@@.@.@@@...@@
@@@@@@@@@@@@@...................@..............@.....@.@@@@@@.....@@@@@@@@@@....@.....@@
@@@@@@@@@.......................@....@.....@.........@@@@@........@@@@@@@@@@...........@
@@@@@@@@.................@@@@@.......................@@@@@...@.@@.@@@@@@@@@.........@..@
@@@@@@@@..........@@.....@@.@.......................@@@@@@.....@@@@@@@@@@@@@......@.....
@@@@@@@@..................@.............................@@......@@@...@@@@@@......@@...@
@@@@@@@@........@..........@@.................@.................@@....@@@@......@@@@@@@@
@@@@@@@@...........@...@...@@.............@..@....@..............@....@@@@@@@....@@@@@@@
@@@@@@@@...........@@@.....@@...........@....@..............................@....@@@@@@@
@@@@@@@@@........@.........@@.........@@...@@....@............@@@...............@@@@@@@@
@@@@@@@@@..................................@@....@.............@@.@.............@@@@@@@@
@@@@@@@@@@...............@..................@....@................@....@@@@......@@@@@@@
@@@@@@@@@@.@...................................@.@.......................@@.....@@@@@@@@
@@@@@@@@@@....................@@...............@.................@.@........@@@@@@@@@@@@
@@@@@@@@@@@@@.........@@....@@@@..@.........@.....................@..........@@@@@@@@@@@
@@@@@@@@@@@@@@@@......@@.....@@@...@@@@...@@@.......@@.....@..........@.....@@@@@@@@@@@@
@@@@@@@@@@@@@@..@.....@@..........@...@@....@@@....@@@.....@.................@@@@@@@@@@@
@@@@@@@@@@@@@@@.............................@@.....@@@.............@.........@@@@@@@@@@@
@@@@@@@@@@@@@@@............@@@.....@@..@............@...................@@@.@@@@@@@@@@@@
@@@@@@@@@@@@......@........@@...........@..................@........@@@@@@@@@@@@@@@@@@@@
@@@@@@@@@@@@......@........@@...........@.................@.......@@@@@@@@@@@@@@@@@@@@@@
@@@@@@@@@@@@...@.....@..........@@.............@...............@...@@@@@@@@@@@@@@@@@@@@@
@@@@@@@@@@@@@..............@@........@.......@......................@@@@@@@@@@@@@@@@@@@@
@@@@@@@@@@@@@......@@....................@.........@@............@@@@@@@@@@@@@@@@@@@@@@@
@@@@@@@@@@@@@.@....@...@..............@..........@@@@.............@@@@@@@@@@@@@@@@@@@@@@
@@@@@@@@@@@@@......@....@.....@..@........@@.....@..@..@@.@...@@@@@@@@@@@@@@@@@@@@@@@@@@
@@@@@@@@@@@@@.....@@....................@@@@..........@@......@@@@@@@@@@@@@@@@@@@@@@@@@@
@@@@@@@@@@@@@..@@@@.........@@...........@@@@........@.........@@@@@@@@@@@@@@@@@@@@@@@@@
@@@@@@@@@.......@.......@..@@@..............@........@...@@@...@@@@@@@@@@@....@@@@@@@@@@
@@@@@@@.............@...@@@.........................@..........@..@@..@@@.....@@@@@@@@@@
@@@@@@@@@.....@...........@............@@.....@@@@@@@..........@...@.@@........@@@@@@@@@
@@@@@@@@@..@..............@.................@@@@@@@@@.......@@.....@........@@@@@@@@@@@@
@@@@@@@@@.................@................@@@@@@@@@..................@......@@@@@@@@@@@
@@@@@.............@.@.....@.@..@@@@.......@@@@@@@@@@..................@.....@@@@@@@@@@@@
@@@@@@.........@@@@@@..@@@@@@..@@@@@@@...@@@@@@@@.................@....@@..@@@@@@@@@@@@@
@@@@@@.........@@@@...@@@@@@@@.@@@@@@@...@@@@@@@@@.................@....@@.@@@@@@@@@@@@@
@@@@@@....@@............@@@@@@@@@@@......@@@@@@@@@@...........@.............@@@@@@@@@@@@
@@@@@@....@@@@@........@@@@@@@@@@@@......@@@@@@@@@@.......................@@@@@@@@@@@@@@
@@@@@@....@@@@@@@@....@@@@@@@@@@@@@......@@@@@@..@..................@@@...@@@@@@@@@@@@@@
@@@@@@....@@@@@@@@....@@@@@@@@@@@@@...@.....@@@..............@....@@@@@@@@@@@@@@@@@@@@@@
@@@@@@.....@@@.@@......@@@@@@@@@@@@.........@@@...............@...@@@@@@@@@@@@@@@@@@@@@@
@@@..........@.@@.......@...@@@@@@@@@........@@.............@@@@.@@@@@@@@@@@@@@@@@@@@@@@
@@@...................@@.....@@@@@@@@@@@.....@@@.........@..@@@@@@@@@@@@@@@@@@@@@@@@@@@@
@@@@.......................@@@@@@.@@@@@@.......@.@..@........@@@@@@@@@@@@@@@@@@@@@@@@@@@
@@@@@.....................@@@......@@@@@@....................@@@@@@@@@@@@@@@@@@@@@@@@@@@
@@@@@@@...........................@@@@@@@....................@...@@@@@@@@@@@@@@@@@@@@@@@
@@@@@@@.............@.............@@@@.......@....................@@@@@@@@@@@@@@@@@@@@@@
@@@@.@@..@.....@@...@@@@...@..@@....@@@......................@...@@@@@@@@@@@@@@@@@@@@@@@
@@...@......@@@@....@@@@@@@@.........@.@@@@................@@@...@@@@@@@@@@@@@@@@@@@@@@@
....@@......@@@@....@@@@@@@@........................@@.....@@......@@@@@@@@..@@@@@@@@@@@
.....@........@@@.....@@@@@@.....................@...@@@@@..@......@@@.......@@@@@@@@@@@
......................@@@@@@.@@..........@...........@.............@@@....@....@@@@@@@@@
@@..........@.........@@@@@@@@@@@...@...........@....@@....................@...@@@@@@@@@
@@@....@....@@........@@@@.@@@..................@....@@..@@....................@@@@@@@@@
....................@...@@...@.........@........@.....@...@...@@@.............@@@@@@@@@@
.............@..........@..............@..........@...........................@@.@@@@@@@
.......@.............@..@......................@.@...@....@.......@@@............@@@@@@@
.........@@@.........................@.........@.@...@@...........@@@.....@......@@@@@@@
........@@@@...@...................@........@@....................@@..@...........@@@@@@
............................@.........@....@..........................@......@..@@@@@@@@
.....@......................@@............@@....@....................@@.......@..@@@@@@@
.................@@....@....@@@.................@@.................@@@@....@..@@@@@@@@@@
............@...............@@@..................@......@@@@@.......@.....@..@@...@@@@@@
..@......@@.....@....@@......@..@................@.@....@@@@@.....................@@@@@@
..@@............@....@@@......................@@@@......@@@@.....@...............@@@@@@@
.........................@....................@@@@..@@@@@@@@@.............@..@...@@@@@@@
......................@............................@..@@@@@@@......@.......@...@..@@@@@@
......@@@............@...........@...................@@@@@@........@...@@........@@@@@@@
@@....@@@@........@..............@..................@@@@@@........@@.@..........@@@@...@
@@....@@@@@@@...@@@..................................@@@@@@@@@@...@.....................
@@...@@@@@@@@@@@@@@...............@.@@.....@....@@...@@@@@@@@@@@..............@@.....@..
@..@..@@@@@@@@@@@@@@..............@.@..@....@@@@@@.@@@@@@@@@@@@@..............@@.....@..
.......@@@@@@@@@@@......@...................@@@@@@@@@@@@@@@@@@@@............@.@@@.@@....
........@@@@@@@@@...........................@@@@@@@@@@@@@@@@@@@@@@@.............@.......
..........@@@@@@@@.@.....@@@.....@.......@...@@@@@@@@@@@@@@@@@@@@@@...@@............@@@@
@.........@.@@@@@....@...@@@..............@@@@@@@@@@@@@@@@@@@@@@@@@..@@@....@.....@@@@@@
@.............@@....@@...@@@...............@@@@@@@@@@@@@@@@@@@@@@@..@@@@..........@@@@@@
..@@..............@....@..@.......@.......@@@@@@@@@@@@@@@@@@@@@@@@@@@@@@..........@@@@@@
.@@.......@.......@.......@..........@...@@@@@@@@@@@@@@@@@@@@@@@@@@@@@@@.......@@...@@@@
@@@@...@@@@@................@....@........@@@@@@@@@@@@@@@@@@@@@@@@@@@@@@@@.........@@@@@
@@@@...@@@@@...............@@@..........@..@@@@@@@@@@@@@@@@@@@@@@@@@@@@@@@.......@@@@@@@
@@@@..@@@@@@..........@..@@@@@......@@.....@@@@@@@@@@@@@@@@@@@@@@@@@@@@@@@.......@@@@@@@
@@@@@..@@@@.......@......@@@@@...........@@@@@@@@@@@@@@@@@@@@@@@@@@@@@@@@........@@@@@@@
@@@@@@@@@@@......@@@.....@@@@@..........@@@@@@@@@@@@@@@@@@@@@@@@@@@@...@@...@@.@.@@@@@@@
@@@@@@@@@@@......@@@..@..@@@@@@@.......@@@@@@@@@@@@@@@@@@@@@@@@@@@@@...@@@..@..@......@@
@@@@@@@@@@@@@....@@......@@@@@@@.......@@@@@@@@@@@@@@@@@@@@@@@@@@@@@........@@@.......@@
@@@@@@@@@@@@@............@@@@@@...@@...@@@@@@@@@@@@@@@@@@@@@@@@@@@@@...........@........
@@@@@@@@@@@@@...@......@.@@@@@@@...@@@@@@@@@@@@@@@@@@@@@@@@@@@@@@@@@..@@......@@@....@..
8
63 24 0
41 72 0
24 13 0
31 77 0
59 61 0
38 83 0
10 30 0
36 50 0

87 73 0
60 47 0
41 73 0
44 41 0
49 26 0
80 11 0
61 0 0
44 62 0
