width 88
height 88
@@@@@@@@@@@@@@@@@@@@@@@@@..@@@@.....@........@@@@@@@@@@.........@@@@@@@@@@@.......@@@@@@
@@@@@@@@@@@@@@@@@@@@@@@@...@......@............@@@@@@@@..........@@@@@@@@@@.......@@@@@@
@@@@@@@@@@@@@@@@@@@@@@@@...@..@@@@@.....@.....@@@@@@@@@@.@...@@..@@@@@@@@@.........@@@@@
@@@@@@@@@@@@@@@@@@@@@@.........@@@@@.........@@@@@@@@@@@.....@@@@@@@...@@@......@@@@@@@@
@@@@@@@@@@@@@@@@@@@@@@.........@@@@@.......@@@@@@@@@@@@...@.@@@@@@@@@..@@@@@.....@@@@@@@
@@@@@@@@@@@@@@@@@@@@@@...................@@@@@@@@@@@@@@......@@@@...@.....@@.....@@@@@@@
@@@@@@@@@@@@@@@@@@@@@@..@...............@@@@@@@@@@@@@@@@.....@.@......@@.........@@@@@@@
@@@@@@@@@@@.@@@@@@@@@@@@@...............@@@@@@@@@@@@@@.................@........@@@@@@@@
@@@@@@@@@@@.@@@@@@@@@@@@.........@........@@@@@@@@@@@@@@.....@........@@@..@.@.@@@@@@@@@
@@@@@@@@@....@@@@@@@@@@.....@..@@@.........@@..@@@...@@@...@.........@..@....@@@@@@@@@@@
@@@.@@@@.....@@@@@@@@@@....@.....@...@.............@.@@@@@....@...............@@@@@@@@@@
@@...@....@...@@@@@@@....@@............@...........@@@@@@@@@..................@@@@@@@@@@
@@@.......@@@.@@@@@@@@@.@@@...@.................@@@@@@@@@@@@.@.....@...........@@@@@@@@@
@@@@.....@@...@@@@@@@@@@@@@...................@.@@@@@@@@@@@@...............@@..@@@@@@@@@
@@@@....@@@...@@@@@@@@.@@@@........@..........@@@@@@@@@@@@@@@..............@@..@@@@@@@@@
@@@.....@@@.....@@.@@....@.........@....@@@.@@@@@@@@@@@@@@@@@@..............@..@@@@@@@@@
@@@............@.@..........................@@@@...@@@@@@@@@@@..@@...........@@@@@@@@@@@
@@@@@..........................@............@@@.....@@@@@@@@@@..@@@@.........@@@@@@@@@@@
@@@@.....................@....@@@..@.....@........@.@@@@@@@@@@@@@@@@.....@....@..@@@@@@@
@@@@............@............@..@...@....@...........@@@@@@@@@@@@@@@..@.....@...@@@@@@@@
@@@............................@@...................@@@@@@@@@@@@@@@@.............@@@@@@@
@@@.............@@...@......................@@@....@@@@@@@@@@@@@@@@@@.............@@@@@@
@@@@............@...........................@@.....@@@@@.@@@@@@@@@@@@@............@@@@@@
@@@.............@.................................@......@@@@@@@@@@@@@...@........@@@@@@
@@....@.......................@..........................@@@@@@@...@...@@@@........@@@@@
@@..........@................@@.@...............@@......@@@@@@@@.......@@@@@@..@....@@@@
@...@...........@............@@.@@@@.........@.@@.......@@@@@@@@.........@@@........@@@@
................@..........@@@@@@@@@@@@.................@@@@@....@.................@..@@
................@...........@@@@@@@@@...............@...@@@.....@@...................@@@
@@@@............@@........@@@@@@@@@.@.........@..@@@@...@@@....@@....................@@@
...@..............@.......@@@@@@@@..@@@..........@......@@@.................@@@....@.@@@
..........................@@@@@@@....@@.........@@......@@@................@@@@@.....@@@
..@...@@....@.............@.@........@@@...@....@@......@...................@@@@@.....@@
......@@....................@.....@...@....@...................@......@@....@@@@@.....@@
.......@@@@.................@................@........@..@............@................@
.......@@@@........@......@..........@@@.............@@@........@........@.........@....
..@.....@..@.......@.....@@.........@@.@.....@....@.@@..................................
.....................@..@@@.................@...@.@@......................@@@@....@...@.
......................@@@@@...............................................@@@@..@.@....@
.......................@@.......@........................@...........@....@..@@@@@@@....
......................@@@.......@.....@@@....@@@.......@@..@@@...............@@@@@@@...@
......................@................@.....@@@........@...@@@.............@@@@@@@@@@.@
................@.....@...............@.......@@@.@@@...@@@@@@@@..@........@@@@@@@@@@@@@
...............@@@.............@......@@@....@@.@@@@@@@@...@@@@.......@...@@@@@@@@@@@@@@
...@.....@.....@@@..@............@.....@..@......@@@@@.....@@@@@@@....@..@@@@@@@@@@@@@@@
....................@............@........@@@......@@@@....@...@@........@@@@@@@@@@@@@@@
..........................................@@@......@@....................@@@@@@@@@@@@@@@
..............@..@@.........................@............................@@@@@@@@@@@@@@@
@...@...........@@@....@....................@............................@@@@@@@@@.@..@@
@@.....@@............@@@..................@............@@@..................@@@@@@......
@@@@....@@@@@...@...@....................@@@.........@.@@...................@@@@@@@@....
@@@@....@@@@@@@.....@....................@@@.................@..@...........@@@@@@@@....
@@@@....@@@@@.......@.@@@................@@@...@@..@..@.................@....@@@@@@@@@..
@@@@......@@...........@@.................@@......@...@@................@.......@@@@@@..
.@@...@............@...@@@..........@.....@..@.....@..@@....@@.....................@@...
.........@........@@...@....@@@.............@@.........@.@...@............@..@..........
@................@@@..@@@@..@@@@@@.........@.............@.@@.............@...@...@@....
@......@.....@@...@@@...@...@@@@@...............@...@......@@.@@.....@...@@......@@@.@..
..........@..@@...............@@@.@....@@.........@.........@............@@.....@@@@@...
...@@.@.......@...........@...........@@................................@...@@@.@@@.....
...@@@@.....................................................................@@@@@@@.....
...@@@@................@@@.......@...@..@......................................@@@@.....
......@...@@...........@@@@........@@@..@...@@@.............@@@...@........@....@@..@...
...........@...........@@@...........@@.....@@@.@@.........@..@.....................@..@
.......................@@@..................@@.....@......@........@@.....@...@@@.......
.............@.....@@........@........@....@.....@.................@@@@.@@@.@@@@@.......
.....@...........@...........@......................@@.@....@.@@@@.@@@@@@@@@@..........@
@...............................@@@@@................@.........@@@@@@@@@@@@@@@...@@@...@
@@.........@@@....@...........@....@@@...@...............@......@@@@@@@@@@@@@@@@@@@@@..@
............@@@............................................@@..@@@@@@@@@@@@@@@@@@@@@@@@@
........@@@@........@........................@@.............@@@@@@@@@@@@@@@@@@@@@@@@@@@@
@......@@..@......@.@.........................@.............@@@@@@@@@@@@@@@@@@@@@@@@@@@@
@@@...@..............@@@...............@@..............@....@@@@@@@@@@@@@@@@@@@@@@@@@@@@
@@@@................@@@@............................@.......@@@@@@@@@@@@@@@@@@@@@@@@@@@@
@@@@...@...@.......................@...@....@...............@@@@@@@@@@@@@@@@@@@@@@@@@@@@
@@@@@@...................................@..................@@@@@@@@@@@@@@@@@@@@@@@@@@@@
@@@@@@@...@.....................@.............................@@@@@@@@@@@@@@@@@@@@@@@@@@
@@@@@@@..........................@..@@@@@.................@@@@@@@@@@@@@@@@@@@@@@@@@@@@@@
@@@@@@@..@.......@..................@@..@...@@....@......@@@@@@@@@@@@@@@@@@@@@@@@@@@@@@@
@@@@@@@..@......@@@@..@@@............@.@........@.@@.....@@@@@@@@@@@@@@@@@@@@@@@@@@@@@@@
@@@@@@@..........@@@@@@@@@@...@....................@.....@@@@@@@@@@@@@@@@@@@@@@@@@@@@@@@
@@@@@@@..........@@@@@@@@@@@.....@@@@..........@.........@@@@@@@@@@@@@@@@@@@@@@@@@@@@@@@
@@@@@@..@@@@.....@@@@@@@@@@@@@@..@@.....................@@@@@@@@@@@@@@@@@@@@@@@@@@@@@@@@
@@@@@@..@@@@...@@@@@@@@@@@@@@@@....................@....@.@@@@@@@@@@@@@@@@@@@@@@@@@@@@@@
@@@@@@@@@@@@@.@@@@@@@@@@@@@@@@.....................@@.@...@@@@@@@@@@@@@@@@@@@@@@@@@@@@@@
@@@@@@@@@@@@@@@@@@@@@@@@@@@@@..@@.@@.@@....................@@@@@@@@@@@@@@@@@@@@@@@@@@@@@
@@@@@@@@@@@@@@@@@@@@@@@@@@@@@@@@@@@..@@@@..................@@@@@@@@@@@@@@@@@@@@@@@@@@@@@
@@@@@@@@@@@@@@@@@@@@@@@@@@@@@@@@@@@@@@@@@@....@@@@@@.....@@@@@@@@@@@@@@@@@@@@@@@@@@@@@@@
8
29 6 0
76 9 0
11 72 0
40 21 0
84 57 0
16 24 0
73 21 0
26 41 0

15 42 0
78 23 0
74 41 0
85 61 0
70 21 0
5 40 0
24 29 0
58 39 0
