width 20
height 27
.............@....@@
...@@.............@@
..................@@
..@..............@@@
..............@..@@@
.....@.@..@......@@@
.........@..........
..........@.@.@.....
...............@....
......@.............
....................
..@.............@...
..................@.
@...................
@.......@...@....@..
......@...........@.
...@......@.........
...........@.@.@....
.........@@...@.@...
.@.......@@.......@.
.....@...@@.........
....................
@...................
.......@.........@..
......@.....@......@
.............@......
...............@....
6
9 14 0
12 5 0
16 13 0
8 4 1
0 25 1
15 12 1

17 25 0
0 10 0
16 21 0
2 0 1
16 5 1
1 0 1
