width 20
height 27
@...................
@........@..........
...............@.@..
....................
.......@............
..........@....@....
....@@.@.@..........
..............@..@..
..@....@............
...............@.@@@
@................@@@
@.......@@@.....@.@@
....@..@.....@.....@
................@..@
........@.@....@...@
@.....@.....@.@.....
....................
...@......@.........
................@...
....................
@................@..
....................
....@.@...@.........
..@.....@....@..@...
...........@........
....................
..........@@......@@
6
3 15 0
17 5 0
8 15 0
9 4 1
8 10 1
11 14 1

16 1 0
14 22 0
18 1 0
10 24 1
17 14 1
0 2 1
