width 20
height 48
@@@@@@@@@.....@@....
@@@@@@@....@........
@@@@@@.@.@..........
.@@@@@........@...@.
.@@@@@.......@......
.@@@................
.@@@.......@........
............@.......
.......@......@.....
...@.@........@.....
....................
.......@...@........
......@........@....
..@....@....@.@.@...
.@..................
.........@..........
....................
..@..@.......@....@.
....@.@....@....@...
........@...........
.............@......
.@..@..@............
.@....@....@........
....................
.@..................
.......@.@..........
...........@..@.....
....................
..@.@...............
....................
..............@....@
.@...@..@...@.......
....................
.....@.@.@..........
..@.....@...........
......@.........@...
..................@.
.........@...@.@....
.....@....@.........
........@...........
....@.....@.........
...............@....
...@....@...@.......
......@..@........@@
.............@.@....
....@.@.........@...
......@@@...........
......@@@.@.........
6
5 21 0
7 1 0
18 27 0
11 44 1
2 37 1
11 30 1

19 5 0
7 45 0
10 26 0
8 16 1
17 16 1
16 10 1
