width 20
height 48
....................
....................
.@..@.@.@.@.@.......
....................
.....@....@@....@..@
....................
...@.@......@...@...
...............@....
...@...@.@..........
.....@.........@....
...@....@...........
............@@......
.......@............
....@.....@.........
.................@..
........@..@........
....................
.@............@..@..
...@................
....................
...@..@.............
....................
............@....@..
......@.............
.......@...@........
....................
....@.....@....@....
....................
.@........@........@
.@..................
..@...........@.....
........@...........
.....@@....@........
....@........@......
................@...
.........@..........
............@....@..
........@.....@.....
..........@........@
.@.@.@...@..@.......
..............@.....
.@.......@.....@...@
......@....@........
@.......@......@....
..................@.
....................
.........@..........
............@@.@@@.@
6
10 10 0
12 1 0
7 22 0
13 44 1
3 14 1
16 5 1

0 47 0
5 0 0
19 44 0
10 43 1
11 45 1
0 25 1
