width 20
height 48
@@@@......@@...@@...
@@@@................
..@...........@.@...
.......@..@.....@.@.
........@...@.......
....................
......@..@....@.....
..@...............@.
...@................
....@...@.@........@
..............@.....
...@.............@..
.....@.@....@.......
..........@...@.....
...........@.@......
..@..@..............
................@..@
...........@.......@
........@....@.....@
.........@....@....@
....@........@......
.......@.......@....
.@...@...@..........
....................
.........@..........
......@........@.@..
..@.............@...
....................
....................
......@.....@.......
..@............@....
.............@......
@.......@..........@
@.@..........@......
....@.....@.....@...
....................
.@...@..@...........
.........@....@.....
...........@....@...
.@..@...............
...@...@............
@...................
.............@......
@...@.@.............
.........@.@...@....
...........@........
..@.................
....................
6
10 47 0
15 40 0
15 24 0
8 26 1
11 24 1
11 31 1

8 11 0
8 3 0
10 26 0
16 22 1
11 25 1
19 33 1
