width 20
height 48
...................@
...................@
..............@....@
......@.@..@.......@
.@.....@......@..@.@
....................
......@.............
.....@...@..@.......
..........@....@....
..@.@.............@.
...@...@.@..........
......@.@.....@.....
..@.@...............
....................
..@........@.@@.....
@..........@@@@.....
@...@..@...@.....@..
.........@..........
..@..........@....@.
.......@.......@....
........@........@..
...@.....@@@...@....
......@...@@........
...............@...@
..@.@.......@.@.....
....................
.......@............
...@....@..@.@....@@
..@................@
....................
......@.............
.........@..........
.......@..@......@..
.......@........@...
@............@......
...@...@............
..@............@....
@@.....@..........@.
@@...@....@......@..
@............@......
@...................
........@..@.....@..
..........@.........
........@.......@...
....................
....@......@@@......
...........@@@@@.@..
............@@@@....
6
18 11 0
7 41 0
6 45 0
17 43 1
13 9 1
18 45 1

1 3 0
13 8 0
19 29 0
0 9 1
0 46 1
15 14 1
