width 20
height 48
...............@..@@
.............@......
..................@.
.@......@...........
...........@......@.
....@...............
.........@..........
......@.@...........
.........@..........
.................@..
.......@..@..@......
...@................
...............@....
.......@......@@....
..........@..@.@....
..@.................
......@.......@...@.
....@...@...........
...................@
...@.....@.@.....@..
....@...............
......@......@......
..............@.....
..........@.......@.
.............@......
...............@....
.................@..
@.....@........@....
.......@..@.........
..@.............@...
.....@........@..@..
.......@............
...@.@.......@......
......@.@.....@.....
..........@.....@...
...........@........
@@...........@....@.
@@..@...@..@........
..............@.....
.@.@................
..@......@.@.@......
............@.@...@.
........@...........
.......@....@....@..
....@...@....@......
...........@........
.......@..@..@......
@@@.................
6
17 6 0
0 9 0
0 31 0
15 46 1
4 24 1
0 40 1

16 6 0
6 34 0
12 1 0
1 0 1
10 21 1
1 18 1
