width 20
height 48
.@@..@@.............
.....@..............
...........@...@....
.......@............
..@.................
...........@........
....................
....................
......@...@...@.....
....................
.........@.......@..
.....@..........@...
..........@.........
............@.......
@.......@...........
@.....@.............
..........@........@
................@...
....@...@....@...@..
...............@....
..........@.........
.......@....@@.@....
..@...........@..@..
......@.............
.......@.@.@........
...@.............@..
.............@.....@
........@..@.......@
..@.......@........@
.....@..............
..@....@......@.....
..................@@
....@.....@.......@.
.....@..............
.............@.@....
....@.@....@........
.........@..........
.....@..........@...
@..@....@...........
.........@...@.@....
....................
.@..@..@......@.....
...............@....
...@.@..............
...........@........
........@......@....
....................
.......@............
6
18 18 0
4 12 0
18 38 0
9 38 1
18 22 1
19 5 1

15 15 0
8 30 0
16 33 0
11 38 1
14 31 1
13 8 1
