width 20
height 48
..................@@
...@..............@@
@@...............@..
@@....@...@.........
@...@...@..........@
.@............@..@@@
.......@.........@@@
....................
.........@..........
....@.....@.........
.......@....@.......
......@..........@..
.......@.@...@......
..................@.
.....@...@..........
................@.@.
...................@
....@..............@
@@..........@.@....@
@..@....@.@........@
..@....@.......@...@
..........@.........
....................
....................
@.@.@....@.@........
.....@..............
...............@....
....................
..@............@....
....@.@..@..@.......
....................
....@.........@.@@..
....@........@..@@@@
......@@..@......@@@
..................@@
............@.....@.
...@.........@......
....................
...@...@@........@@@
.@...............@@@
...........@.......@
.....@...@..........
......@.@...........
@............@....@.
@@..................
@@@@...@..@.@.......
@@@.............@...
@@@@................
6
17 45 0
11 11 0
13 15 0
7 5 1
16 16 1
17 9 1

5 1 0
11 11 0
12 23 0
3 42 1
18 47 1
14 11 1
