width 20
height 48
....................
@@............@.....
@@........@.....@...
.................@..
....@...............
........@...........
.............@...@..
....@..@............
.........@......@...
....................
@..............@....
.......@............
..............@.....
...@..@@.....@.@....
.........@..........
....................
........@.@..@....@.
...@................
..@........@........
...............@..@.
..@.................
.@.................@
.....@.......@....@@
.........@........@@
...@........@.....@@
.@..............@.@@
..................@@
.....@.........@...@
........@.........@@
...@........@.......
.........@..........
..@...........@...@.
.@....@.....@.......
....................
....@............@..
.......@............
......@.............
..@.................
.......@...@.@......
..@.................
....................
........@.@.@.....@.
....................
....................
..............@.....
..........@.........
....................
.....@........@@....
6
4 36 0
7 39 0
11 15 0
2 33 1
16 15 1
13 12 1

14 19 0
19 0 0
4 10 0
10 21 1
5 42 1
14 42 1
