width 20
height 48
@@@................@
...................@
.......@.@...@......
............@@....@@
...@....@.....@.....
..@.@......@........
......@........@..@.
.......@......@.....
..................@.
........@...........
...........@........
@....@..............
..@...........@.....
.@......@..@...@....
....................
@@..........@.......
@...................
.........@.........@
....@...............
.......@....@.......
...........@......@.
....................
.@...@..............
...........@......@.
...@.........@....@.
.....@........@.....
.@.@...@...@......@.
....................
.@...............@@.
.......@......@.....
......@...@.........
....................
.@.........@........
....@.......@.....@.
.............@......
....................
..@..@..@...........
@...................
@@.....@..@..@.@....
@...................
@..........@.@......
@........@....@.....
....................
....@..........@....
......@.............
@@.@................
@@@@..........@.....
@@@@..........@.....
6
10 27 0
19 16 0
13 44 0
15 26 1
19 43 1
9 14 1

0 1 0
4 31 0
11 8 0
0 33 1
12 43 1
15 3 1
