width 20
height 48
.....@..............
...........@........
...@..............@.
.@..................
....@..@.@.@........
@....@........@.....
..@..........@......
...@................
......@......@......
.....@.@............
...@............@...
...........@.....@..
....................
.@.....@..........@.
...........@........
.@..................
.....@...@.@...@....
.....@.......@......
...@.@..............
..@.................
.................@..
@...@...@...@..@....
@@@..............@..
@@@......@..........
........@....@......
.......@............
....@.....@....@....
...........@.....@..
@@.....@..........@.
........@.......@...
..@.........@.......
.@...@..............
...........@........
......@......@......
.................@..
....................
.....@.@...@....@...
.@..................
....@..@.@........@.
...@...........@....
..@.................
.@........@.........
..................@.
....@.......@.......
...............@....
..@......@..........
....................
....................
6
7 30 0
6 34 0
3 9 0
5 39 1
5 2 1
12 28 1

12 8 0
8 40 0
6 5 0
15 34 1
7 3 1
5 2 1
