width 84
height 84
@@@@@@@@@@@@@@@@@@@@@@@@@@@@@@@@@@@@@@........@......@@@........@@.@@@@@...@@.....@@
@@@@@@@@@@@@@@@@@@@@@@@@@@@.@@@@@@@@@@..........@@@...@@.........@.@@@@@...........@
@@@@@@@@@@@@@@@@@@@@@@@@..@....@@@@@@@........................@.....@.@............@
@@@@@@@@@@@@@@@@@@@@@@@@..@......@@@@....@...@.................@......@@........@@.@
@@@@@@@@@@@@@@@@@@@@@@@@..........@@..................@@@@.@...........@..........@@
@@@@@@@@@@@@@@@@@@@@@@@..........@....................@@...................@..@.@@@@
@@@@@@@@@@@@@@@@@@@@@@@.........@@..........@..........@..@@...........@.@@@@......@
@@@@@@@@@@@@@@@@@@@@@@....................@.@.............@@@............@@@@@....@@
@@@@@@@@@@@@@@@@@@@@................@.....................@@@@.......@@@@@@.......@@
@@@@@@@@@@@@@@@@@@@................@@..............@@@@....@@@@@...@@@@@@@@.......@@
@@@@@@@@@@@@@@@@@@@@@...@@@........@@....@..@@@...@@@@@.....@@@@.....@@@@@@@@.....@@
@@@@@@@@@@@@@@@@@@@@@..............@@...@@@@.........@@.......@@.@...@@@@@@@.....@@@
@@@@@@@@@@@@@@@@@@@@@@..............@....@.................@.........@@@@@@@.@..@@@@
@@@@@@@@@@@@@@@@@@@@@@.@..........@........................@.@@.........@@@..@@@@@@@
@@@@@@@@@@@@@@@@@@@@..................@@.............@@....@@@@.........@@@@@@@@@@@@
@@@@@@@@@@@@@@@@@@@@................@@@@..........@@.......@..@.@......@@@@@@@@@@@@@
@@@@@@@@@@@@@@@@@@@@@.....@@@.....@@@@@@..@.@@...@@@...................@@@@@@@@@@@@@
@@@@@@@@@@@@@@@@@@@@@@....@@.......@@@@@@..@...@@@@......@@@.............@@@@@@@@@@@
@@@@@@@@@@@@@@@@@@@.@@........................@@@.....@.............@@..@@@@@@@@@@@@
@@@@@@@@@@@@@@@@@@@...@.......................@@@@...........@@.........@@@@@@@@@@@@
@@@@@@@@@@@@@@@@@@@@...@.@..................@@@@@@.@.........@@@@..@.....@@@@@@@@@@@
@@@@@@@@@@@@@@@@@@.......@.@@................@@@@........@@..@.@@.........@@@@@@@@@@
@@@@@@@@@@@@@@@@@............................@..@........@.......@@......@@@@@@@@@@@
@@@@@@@@@@@@@.@@........@@............@@....@@..........@@@.....@@@......@@@@@@@@@@@
@@@@@@@@@@@@@.@@........@@@....@............@@............@.....@@@......@@@@@@@@@@@
@@@@@@@@@@@@@..@...@@@..@@@....@..@.......@...@.@.................@....@.@@@@@@@@@@@
@@@@@@@@@@@@....@..@@@@@@@......................@....@...@@@....@........@@@@@@@@@@@
@@@@@@@@@@@@.......@@@@@..............................@@...@..........@@..@@@@@@@@@@
@@@@@@@@@@@@.......@@.@.............@@..........@.....@@.....@....@@..@@@@@@@@@@@@@@
@@@@@@@@@@@@@.......@.....................@......@....@@..............@@@@@@@@@@@@@@
@@@@@@@@@@@@@@@.......................................@@.....@@......@@@@@@@@@@@@@@@
@@@@@@@@@@@@@@@.....................@..@@.............@@............@@@@@@@@@@@@@@@@
@@@@@@@@@@@@@@@@@@..................@@...............@@@.@@@........@@@@@@@@@@@@@@@@
@@@@@@@@@@@@@@@@@@................@@@@@................@..@@@.....@.@@@@@@@@@@@@@@@@
@@@@@@@@@@@@@@@@@@................@@@.@...@............@@.@@........@@@@@@@@@@@@@@@@
@@@@@@@@@@@@@@@@@........@.........@@...@...............@.........@..@@@@@@@@@@@@@@@
@@@@@@@@@@@@@@@@@@@.........@....@.@@...........................@@@@@@@@@@@@@@@@@@@@
@@@@@@@@@@@@@@@@@..........@@......@@........@.......@.........@@@@@@@@@@@@@@@@@@@@@
@@@@@@@@@@@@@@@@@...........@@@..............@.......@.........@@@@@@@@@@@@@@@@@@@@@
@@@@@@@@@@@@@@@@...@.........@@.......................@.@....@@@@@@@@@@@@@@@@@@@@@@@
@@@@@@@@@@@@@@@@@@@@.............................@......@.@@@@@@@@@@@@@@@@@@@@@@@@@@
@@@@@@@@@@@@@@@@@@........@.........@....@.....@..........@@@@@@@...@@@@@@@@@@@@@@@@
@@@@@@@@@@@@@@@@@@...........@.....@@.@.@@....@@@..@@.....@.@@@@@..@@@@@@@@@@@@@@@@@
@@@@@@@@@@@@@@@@@@...............@@@@@@.@...@@@@@@.@..@...@.@@@@@@.@@@@@@@@@@@@@@@@@
@@@@@@@@@@@@@@@@@...........@@...@@@@@.......@@@@@@..........@@@@...@@@@@@@@@@@@@@@@
@@@@@@@@@@@@@@...@..........@....@@@@@.........@.............@@@....@@@@@@@@@@@@@@@@
@@@@@@@@@@@@......................@@@@.........@@@..@......@.........@@@@@@@@@@@@@@@
@@@@@@@@@@@@....................@.@@@@...........@...@...............@@@@@@@@@@@@@@@
@@@@@@@@@@@@@@..........@@@.....@....@...........@..@..............@@@@@@@@@@@@@@@@@
@@@@@@@@@@@@@@.........@.........@..@@@......@@@..............@....@@@@@@@@@@@@@@@@@
@@@@@@@..@@@@@@............@....@............@....@..........@...@@@@@@@@@@@@@@@@@@@
@@@@@@......@@@.....@......@....@...........@....@@...@...@.......@@@@@@@@@@@@@@@@@@
@@@@@.........@.....@......................@@.....@@@.............@@@@@@@@@@@@@@@@@@
@@@................@@......................@@@.....@@@@......@....@@@@@@@@@@@@@@@@@@
....................................@...............@@..........@@@@@@@@@@@@@@@@@@@@
...@..........................@.......................@..@@.....@@@@@@@@@@@@@@@@@@@@
@....@@....................@@.@...................@...@@.@@.....@@@@@@@@@@@@@@@@@@@@
...........................@@...........@..@@.........@@...@..@@@@@@@@@@@@@@@@@@@@@@
.......................@....................@@........@@.......@@@@@@@@@@@@@@@@@@@@@
..@.........................................@@@@@......@@@.....@@@@@@@@@@@@@@@@@@@@@
@............@@.@@....@....................@@@@@........@@.....@@@@@@@@@@@@@@@@@@@@@
.....@...............@@...@....@@......@...@@@@@.........@....@..@@@@@@@@@@@@@@@@@@@
@....@@......@......@@@.......@@@.........@@@@@@@.......@@.@.....@.@@@@@@@@@@@@@@@@@
@.@................@@.@..@...................@@@@......@@....@@.........@@@@@@@@@@@@
@.........................@...@.....@@@@.@@.@@@@@@@....@@....@@@@@@.....@@@@@@@@@@@@
..........................@...........@@@@@@@@@@@@@@@@.@@.....@@@@@.....@@@@@@@@@@@@
.....................@................@@@@@@@@@@@@@@@@......@@@@@@@.....@@@@@@@@@@@@
@............@@@.@.................@..@@@@@@@@@@@@@@............@@...@..@@@@@@@@@@@@
@..........@.@@...@.@.................@@@@@@@@@@....@...@@...@@.@....@..@@@@@@@@@@@@
...........@@@.................@@....@@.@@@@@@@@......@@@@...@.......@@.....@@@@@@@@
.....@@@.....................................@@........@@..................@@@@@@@@@
.....@@@........@.........@..................@@...........................@@@@@@@@@@
@..@@@@@..................@..@@..@..................@@@@.............@.@..@@@@@@@@@@
@..@@@@@@...@@@...@...........@@@@@@...........@@...@@@@.@...............@@@@@@@@@@@
@...@@@@@@@@@@@....@..........@@@@@@...........@@..@@.@@@.........@......@@@@@@@@@@@
@@.@@@@@@@@@@@@@@..........@@.@@@@@@........@...@..@@....................@@@@@@@@@@@
@@@@@@@@@@@@@..@.......@...@@@@@@@@@........................@............@@@@@@@@@@@
@@@@@@@@@@.............@@@@@@@@@@@@@@@@@..........@.........@@...........@@@@@@@@@@@
@@@@@@@@@@@.......@...@@@@@@@@@@@@@@@@@@@...................@@.....@..@.@@@@@@@@@@@@
@@@@@@@@@@@@..........@@@@@@@@@@@@@@@@@..................@..@@........@@@@@@@@@@@@@@
@@@@@@@@@@@@@@@@@....@@@@@@@@@@@@@@@@@@............@....@@@@@@...........@@@@@@@@@@@
@@@@@@@@@@@@@@@@@@...@@@@@@@@@@@@@@@@@...@@@@.........@.@@@@@@@@@@@.......@@@@@@@@@@
@@@@@@@@@@@@@@@@@@.@.@@@@@@@@@@@@@@@@@................@@@@@@@@@@@@@@......@@@@@@@@@@
@@@@@@@@@@@@@@@@@@@@@@@@@@@@@@@@@@@@@....@@..........@@@@@@@@@@@@@@@...@.@@@@@@@@@@@
8
2 70 0
67 8 0
34 48 0
55 53 0
51 26 0
52 62 0
59 73 0
68 76 0

58 11 0
41 31 0
77 2 0
62 75 0
52 15 0
54 66 0
76 12 0
48 49 0
