width 84
height 84
........@@@@.....@@@...@@@@@@@@@@@@@@@@@@@@@@@@..........@@@@@@@@@@@@@@@@@@@@@@@@@@@
........@@@@............@@@@@@@@@@@@@@@@@@@@..@..........@@@@@@@@@@@@@@@@@@@@@@@@@@@
........@@@@@@.......@@@@@@@@@@@@@@@@...@@@...@...........@..@@@@@@@@@..@@@@@@@@@@@@
.....................@@@@@@@@@@@@@@@@...@.....@@....@....@@.......@@@...@@@@@@@@@@@@
....................@@@@@@@@@@@@@@@@...@@...........@@...@@......@@@.....@@@@@@@@@@@
..@...@@@..........@@@@@@@@@@@@@@@@@@......@@.......@@....@.......@.....@@@@@@@@@@@@
.....@@@@.........@@@@@....@@@@@@.@@....@@..........@@....................@@@@@@@@@@
..@.@@@@@.@........@@@@@...........@......@............................@@@@@@@@@@@..
@......@...........@@@.................@@............@...........@....@@@@@@@@@@@@..
@......@...........@@@..@.............@@....................@.........@@@@@@@@@@@@..
@....@..............@.@.@@...........@@@@............@...............@@@@@@@@@@@@@..
................@@@@@......@.......@@@@@@@@.................@.........@@@@@@@@@.....
................@@.@@......@......@....@@@@........@@.......@.............@@@@@@....
@...........@...@@.@@...................@@....@....@@@......@.........@...@@@@......
.........@....................@@........@...................@@......................
.....@@......................@@@.......@..........@........@@@..@.....@..........@.@
.....@....@@@........@@.@........................@.....@@@.@@@........@...@....@....
...........@@....@...@@..........................@.....@@..@@@........@........@....
.................@....@..................@........@@.......@...................@....
..............@.@................@................@@..................@.............
@...............@.................................@@..................@.............
............................................@.@.......................@.............
.@....@............................@....@...........................@@..............
.@@...............@.....................@.....................@@....@@@.............
.................@......@........@..........................@@@@@@.@@@@...@@@...@...
........................@@.....................@...........@@@@@@@@@@@....@.........
@@@...@........@......@@@......................@@...@@.....@@@@@@@@@@@@...@.........
@@@@@..@....@@.......@..@........@......@...@..@@..........@@@@@@@@@@@@@..@......@.@
@@@@@@@@...............@@@.....................@@...........@@....@@@@..............
@@@@@@@@..............@......@..@..................................@@..@.@......@@..
@@@@@@@..............@@@...............@......................@.....................
@@@@@@@............@..................@@.................@...@@@............@......@
@@@@@@@...........@@@.........@..@......@....................@@.............@......@
@@@@@@@@...@.....@@@@............@...........@@........@.....@....@.................
@@@@@@.........@@@@@@.....@@@................@@@......@..........@@@@@..@@........@.
@@@@@....@.......@@@@.@......@..............@@@@@....@@...........@@@...........@@@.
@@@@@@@..@@.......@@@@@......@...............@@@@...@@@.....@.....@@@............@..
@@@@@@@@@@@@......@@@@@....@..................@@....@.......@...@@@@@.......@.......
@@@@@@@@@@@@....@@@@@@@.......@...............@@....@@......@@......@@..............
@@@@@@@@@@@@...@@@@@@@@@@.....................@.............@.......@...@@..........
@@@@@@@@@@@@@@@@@@@@@@@..@.....@................@.............................@@....
@@@@@@@@@@@@@@@@@@@@@@@.......................@..............................@@@...@
@@@@@@@@@@@@@@@@@@@@@@@.......@@.@...........@@@...............@.......@......@@....
@@@@@@@@@@@@@@@@@@@@@.@.................@.....@...............................@@@...
@@@@@@@@@@@@@@@@@@@@@..........@.............@@.........................@.......@@..
@@@@@@@@@@@@@@@@@@@@.......@..@@.........................................@.@........
@@@@@@@@@@@@@@@@@@@...........@@@@...........................@@.........@@@.........
@@@@@@@@@@@@@@@@@........@.............@@@.....@@..@........@@@@........@@..........
@@@@@@@@@@@@@@@@@@....@@........@@.....@@......@@...........@@@@@......@@@..........
@@@@@@@@@@@.@@@@@@..............@@..........@..@....@...........@......@@@@@@..@.@@@
@@@@@.......@@@@@.@.............@@..................@.................@@@@@@@...@@@@
@...@@@.......@.@.@......................@............@@....@..@@@@@@@@@@@@@@...@@@@
...@@@............@......................@..@.........@........@@@@@@@@@@@@@@@@..@@@
...........@@...@@@...............@@.......@@.@................@@@@@@@@@@@@@@.....@@
..........@@@....@...............@@@........@.@@...............@@@@@@@@@@.........@@
...........@@@.....................@.........@@@..@..@........@@@@@@@@@........@@@@@
............@@...................@@...........@@@@............@@@@@@@@@......@.@@@@@
.@...............................@@.@@@....@@@@@@@@...........@@@@@@@@@...@@@@@@@@@@
...................@............@@@@@...@....@@@@..............@@@@@@@@@@@@@@@@@@@@@
.................@@@@@@......@..@@@@@........@@@@..............@@@@@@@@@@@@@@@@@@@@@
......@.....@..@.@@@@........@..@@@@.........@@@........@......@@@@@@@@@@@@@@@@@@@@@
.....@@@@..@.....@@@@.@....@.@@@@@@@@........@@@...............@@@@@@@@@@@@@@@@@@@@@
@...@@@@@.............@@..@@@@@@@@@@@@......................@..@@@@@@@@@@@@@@@@@@@@@
@@..@@@@..............@@@@@@@@@@@@@@@@@@.......@.......@@@@.....@@@@@@@@@@@@@@@@@@@@
...@@@@@@...........@@@@@@@@@@@@@@@@@@@@....@.........@@@@@........@@@@@@@@@@@@@@@@@
..@@@@@@@.........@@@@@@@@@@@@@@@@@@@@...@@.@.......@.@@........@@@@@@@@@@@@@@@@@@@@
..@@@@@@@...........@@@@@@@@@@@@@@@@@@@@@@@@@@@.....@@@@...@....@@@@@@@@@@@@@@@@@@@@
.@@@@@@@@@@@........@@@@@@@@@@@@@@@@@@@@@@@@@@......@.@@@.......@@@@@@@@@@@@@@@@@@@@
.@@@@@@@@@.........@@@@@@@@@@@@@@@@@@@@@@@@@@@....@@@......@.....@@@@@@@@@@@@@@@@@@@
@@@@@@@.@@..........@@@@@@@@@@@@@@@@@@@@@@@@@@@@@@@@@.......@@@@@@@@@@@@@@@@@@@@@@@@
@@@@@@@..@@@........@@@@@@@@@@@@@@@@@@@@@@@@@@@@@@@@@......@@@@@@@@@@@@@@@@@@@@@@@@@
@@@@@@@..............@@@@@@@@@@@@@@@@@@@@@@@@@@@@@@@@.......@@@@@@@@@@@@@@@@@@@@@@@@
@@@@@@...................@@@@@@@@@@@@@@@@@@@@@@@@@@@@.........@@@@@@@@@@@@@@@@@@@@@@
@@@@@@...........@......@@@@@@@@@@@@@@@@@@@@@@@@@@@@@@.......@@@@@@@@@@@@@@@@@@@@@@@
@@.@@@.................@@@@@@@@@@@@@@@@@@@@@@@@@@@@@@@@......@@@@@@@@@@@@@@@@@@@@@@@
@@.@@@...@..@......@....@@@@@@@@@@@@@@@@@@@@@@@@@@@@@@@...@@.@@@@@@@@@@@@@@@@@@@@@@@
@@...@...@@........@@...@@@@@@@@@@@@@@@@@@@@@@@@@@@@@@@@@@@@@@@@@@@@@@@@@@@@@@@@@@@@
@....@...@@............@@@@@@@@@@@@@@@@@@@@@@@@@@@@@@@@@@@@@@@@@@@@@@@@@@@@@@@@@@@@@
@........@@...........@@@@@@@@@@@@@@@@@@@@@@@@@@@@@@@@@@@@@@@@@@@@@@@@@@@@@@@@@@@@@@
@@.......@@...........@@@@@@@@@@@@@@@@@@@@@@@@@@@@@@@@@@@@@@@@@@@@@@@@@@@@@@@@@@@@@@
@..................@@@@@@@@@@@@@@@@@@@@@@@@@@@@@@@@@@@@@@@@@@@@@@@@@@@@@@@@@@@@@@@@@
@@@@.....@.....@....@@@@@@@@@@@@@@@@@@@@@@@@@@@@@@@@@@@@@@@@@@@@@@@@@@@@@@@@@@@@@@@@
@@@@@@@@..........@@@@@@@@@@@@@@@@@@@@@@@@@@@@@@@@@@@@@@@@@@@@@@@@@@@@@@@@@@@@@@@@@@
@@@@@@@@@..........@@@@@@@@@@@@@@@@@@@@@@@@@@@@@@@@@@@@@@@@@@@@@@@@@@@@@@@@@@@@@@@@@
8
73 37 0
82 38 0
19 51 0
61 30 0
67 42 0
71 38 0
14 26 0
35 27 0

2 64 0
3 15 0
82 11 0
6 52 0
69 41 0
8 72 0
57 71 0
36 31 0
