width 84
height 84
@@@@@@@@@@@@@@@@@@@@@@@@@@@@@@@@@@@@@@@@@@@@.........@@@@@@@@@@@@@@@@@@@@@@@@@@@@@@@
@@@@@@@@@@@@@@@@@@.@@@@@@@@@@@@@@@@@@@@@@@@@.......@.@@@@@@@@@@@@@@@@@@@@@@@@@@@@@@@
@@@@@@@@@@@@@@@@@@.....@@@@@@@@@@@@@@@@@...........@@@@@@@@@@@@@@@@@@@@@@@@@@@@@@@@@
@@@@@@@@@@@@@@@@@...@...@@@@@@@@@@@@@@@@........@.@@@@@@@@@@@@@@@@@@@@@@@@@@@@@@@@@@
@@@@@@@@@@@@@@@@@.......@@@@..@@@@@@@@@@......@@@@@@@@@@@@@@@@@@@@@@@@@@@@@@@@@@@@@@
@@@@@@@@@@@@@@@@@........@@@.@@@@@@@@@@@...@@@@@@@@@@@..@@...@@@@@@@@@@@@@@@@@@@@@@@
@@@@@@@@@@@@@@@@@.............@@@@@@@@@......@@@@@@@@........@@@@@@@@@@@@@..@@@@@@@@
@@@@@@@@@@@@@@@@@@.............@@@@@@@@........@@@@@@@........@@@@@@.@@@...@@@@@@@@@
@@@@@@@@@@@@@@@@@@@...@.......@@@@@@@@@@.@.....@@@@.@@....@...@.@@..........@@@@..@@
@@@@@@@@@@@@@@@@@@@.........@@@@@@@@@@@@.@.....@.@...@..........@@..........@@@...@@
@@@@@@@@@@@@@@@@@@@........@..@@@@@@@@@@.............@........@@@@..........@@......
@@@@@@@@@@@@@@@@@@@.@.........@@@@@@@@.......@.................@@@@.........@@......
@@@@@@@@@@@@@@@@@@..@@@@.@@....@@@@@@@..........@...........@...@@@.....@...@@..@...
@@@@@@@@@@@@@@@@@@..@@@.........@@@@@...........@@.......@@.............@...@.......
@@@@@@@@@@@@@@@@@@..............@@..@..........@@@@......@@.@..........@............
@@@@@@@@@@@@@@@@@@...@.......@......@.......@@@@@@............@.@...........@.......
@@@@@@@@@@@@@@@@@..@........@@@...............@...................@.......@.@@..@..@
@@@@@@@@@@@@@@@@@............@@...............@................@@@@..........@..@...
@@@@@@@@@@@@@@@@@@...........@@@@..@@@@.......@@@................@@.......@@.@..@...
@@@@@@@@@@@@@@@@@@@.............@@.@@@........@@@.@.........@....@@..@....@@.....@.@
@@@@@@@@@@@@@@@@@@..............@.@..@........@@..@.@@......@........@...@@@@.@....@
@@@@@@@@@@@@@@@@@@........@..................@@@..@@@....................@@@........
@@@@@@@@..@@@@@@@@@....@...@..............@@@@@@...@@...................@@.@....@...
@@@@@@@@@.@@@@@@@@@.......................@@@@@@.@.....................@@......@@...
@@@@@@@@..@@@@@@@@@@@@....................@@@@....@.@..............@@..@@..@........
@@@@@@@......@@@@@@@@@@...................@@..........@............@@@@@@...........
@@@@@@@......@@@@@@.......@.@......@...@.@@.........@...............@@@@............
@@@@..@......@@@@@@................@@..@....@@@..............@..@..@@@@@............
@@@..@@......@@@@@.....@...............@....@@@@..........@....@@..@@@@......@@.....
@@@...@.......@@@@.@@..@....@.................@................@@@@@@@@.......@.....
@@@@.....@.......@@@@.......@........................@.....@.....@@@@@@@@.....@.....
@@@@.............@@@@.......@@@..@...........@@..................@@@@@@@@.........@@
@@@@@@..........@@@@..@.....@@........@@..............................@.......@...@@
@@@@@@.......@@..@@@..@....@@.........@@........@@@...........@....@..........@...@@
@@@@@@..@..........@..................@@...@..@@@@@......@........@@.@..........@..@
@@@@@@@@....@@.....@@@.........@......@.........@@.....@@@........@@@@.......@.@@...
@@@@@@@@@.......@..@@@........@.........................@@.....@.@.@.....@......@.@@
@@@@@@@@@....@..@@.................@@..@.@..............@........@.......@........@@
@@@@@@@@@@....@@..................@@@...@@......@.....@.....@..............@......@@
@@@@@@@@@@.@.....................@@@@....@......@..........@@..............@......@@
@@@@...@@.......................@@@@.......@@............@..@.....................@@
@@@....@..................@@...@@@.........@................................@......@
@@.....@....@..........@......@@@..........................@.............@..........
@@.............@..............@@@.....@...........@...............@.....@@.........@
.@...........@@@...............@@.............@@............@.@..........@.......@..
......@......@.....@@.......@........................@......@.......@...........@@@@
.................@@@@@@@.@@.................................@...@@..............@@@@
..................@@@@@@.......@.....@@.........................@@@@............@@@@
..................@@@@@@....@@............@..@..........@@......@@@@................
.................@@@@@@@@..@@@@@.........@@@............@.....@.@......@............
.................@@@@@@@@....@@@.........@@@............@@....@@...............@...@
@@.@......@@@....@@@@@@@@@@....@@@........@................@.@@@..........@......@@@
@@@@.....@@@@@@@.@@@@@@@@@@....@.@@......@@........@...@.....@@@@@..................
@@@@.......@@@@@@@@@@@@@@@@...@@..........@......@@@..............................@.
@@@@.......@@@@@@@@@@@@@@@....@@@................@@@................@.............@@
@@@@@@@.....@@@@@@@@@@@@@@...@@@@................................@@.............@@@@
@@@@@@....@...@@@@@@@@@@@@...@@@.@...........@.........@@....@.@.@@@................
@@@@@@@...@....@@@@@@@@.......@@.................@@....@@......@..@@@@@.@.@@........
@@@@@@@@@@@@@@@@@@@@@@@@@@.....@.................@@....@@.........@@@@..............
@@@@@@@@@@@@@@@@@@@@@@@@@@.@@..@...................@....@..@@....@@@@...............
@@@@@@@@@@@@@@@@@@@@@@@@@@@@@@....................@.....@..@@.....@@@...............
@@@@@@@@@@@@@@@@@@@@@@@@@@@@@@..........................@..........@@...............
@@@@@@@@@@@@@@@@@@@@@@@@@@@@@@.@@@..........@..@@....@..................@@..........
@@@@@@@@@@@@@@@@@@@@@@@@@@@@@@@@@@.@...........@@.......................@@..........
@@@@@@@@@@@@@@@@@@@@@@@@@@@@@@@@@@@@@..........@@..................@....@...........
@@@@@@@@@@@@@@@@@@@@@@@@@@@@@@@@@@@@@.@.....@...@..........@.......@................
@@@@@@@@@@@@@@@@@@@@@@@@@@@@@@@@@@@@@@@..............@@@...@.................@......
@@@@@@@@@@@@@@@@@@@@@@@@@@@@@@@@@@@@@@@@@.....@.....@...@@@@@................@@.....
@@@@@@@@@@@@@@@@@@@@@@@@@@@@@@@@@@@@@@......@@@.....@......@.................@......
@@@@@@@@@@@@@@@@@@@@@@@@@@@@@@@@@@@.@.....................................@.@@@@....
@@@@@@@@@@@@@@@@@@@@@@@@@@@@@@@@@@@.@........................@@...........@@@@@@....
@@@@@@@@@@@@@@@@@@@@@@@@@@@@@@@@@@@........................@..@...........@@@@@@@@@.
@@@@@@@@@@@@@@@@@@@@@@@@@@@@@@@@@@...@.@@@@@@.............@@@.@..........@@@@@@@@@@@
@@@@@@@@@@@@@@@@@@@@@@@@@@@@@@@@@@@@@@@@@@@@@.......@@..@@@@@@@......@@...@@@@@@@@@@
@@@@@@@@@@@@@@@@@@@@@@@@@@@@@@@@@@@@@@@@@@@.........@@......@@@@@@@.......@@@..@@@@@
@@@@@@@@@@@@@@@@@@@@@@@@@@@@@@@@@@@@@@@@@@@@.........@@@........@@@.....@......@@@@@
@@@@@@@@@@@@@@@@@@@@@@@@@@@@@@@@@@@@@@@@@@@@......@@...@@...............@.......@@@@
@@@@@@@@@@@@@@@@@@@@@@@@@@@@@@@@@@@@@@@@@@.........................@@...........@.@@
@@@@@@@@@@@@@@@@@@@@@@@@@@@@@@@@@@@@@@@@@@@@@@@............@@@.....@..........@@...@
@@@@@@@@@@@@@@@@@@@@@@@@@@@@@@@@@@@@@@@@@@@@@@@.........@.......@................@@@
@@@@@@@@@@@@@@@@@@@@@@@@@@@@@@@@@@@@@@@@@@@@@...........@.......@.@..@.........@@@@@
@@@@@@@@@@@@@@@@@@@@@@@@@@@@@@@@@@@@@@@@@@@@......@@......@.....@.@.....@@.....@@@@@
@@@@@@@@@@@@@@@@@@@@@@@@@@@@@@@@@@@@@@@@@@@@@@....@...........@@@...@.........@@@@@@
@@@@@@@@@@@@@@@@@@@@@@@@@@@@@@@@@@@@@@@@@@@@@@@@.......@@@....@@@@@...........@@@@@@
8
57 49 0
66 21 0
69 32 0
83 52 0
33 58 0
71 79 0
27 26 0
25 25 0

12 31 0
36 63 0
7 56 0
65 15 0
55 61 0
25 13 0
79 61 0
24 19 0
