width 20
height 15
@@@.@@@@........@@@@
@@.........@.....@@@
@@....@.....@....@.@
@...................
......@.............
..@.......@.....@...
...........@........
.......@............
.@@@@........@...@..
@@@@................
@@@@........@......@
@@@@@......@.....@..
@@@@@.....@.........
@@@.................
@@@.................
6
15 11 0
12 5 0
8 4 0
14 9 1
9 1 1
9 12 1

18 2 0
11 5 0
9 4 0
14 9 1
5 8 1
19 3 1
