width 20
height 15
....................
....@...............
@...................
......@.............
........@.......@...
...@................
...........@........
......@.............
@...................
......@.@....@.@....
....................
........@...@..@....
....................
....................
.................@..
6
9 1 0
0 6 0
4 3 0
5 2 1
9 13 1
6 0 1

3 14 0
7 2 0
4 4 0
19 9 1
17 8 1
18 11 1
