width 20
height 15
.....@@@............
.....@@.............
.....@@.@...........
................@...
..@.@..@............
......@...@....@....
..@....@............
....................
.........@..........
....@.........@@....
......@......@......
...........@........
..@@....@...........
..@..........@..@..@
....@@@............@
6
9 2 0
11 0 0
8 14 0
0 0 1
2 2 1
2 9 1

15 8 0
10 3 0
7 13 0
2 9 1
19 9 1
3 4 1
