width 20
height 15
.........@@.........
....@...............
...@......@......@..
..@.................
...@...@.....@.@....
....@.......@.......
...........@.....@..
.......@............
....................
...@................
..............@...@.
........@......@....
...@.............@@@
................@@@@
@...........@...@@@@
6
15 1 0
14 6 0
13 13 0
1 5 1
7 2 1
10 5 1

16 9 0
3 3 0
0 0 0
10 8 1
16 7 1
11 3 1
