width 20
height 15
..........@..@......
....................
........@...@@......
...........@.@......
....@........@....@.
..........@..@....@.
...............@....
....@...@...........
..............@.....
.@..@@.....@.....@..
.................@..
...@..@..@..@.......
...@..........@.....
..........@.........
..@.................
6
19 9 0
12 8 0
7 6 0
10 2 1
19 11 1
0 5 1

11 7 0
19 8 0
0 0 0
0 3 1
9 8 1
14 6 1
