width 36
height 36
.......@@@..@@@.@@@@@...@@@@@@......
@...........@@@.@...@....@@@........
@...............@........@.@......@@
@...........@.@@@....@...........@@@
@@.....@.@.....@@............@@..@@@
@........@@....................@....
@.......@@...@@..............@......
@@.....@@@@...@@..............@.....
@@........@......@..................
@@...................@.........@....
@@....@.....................@..@@...
@.......@......................@@...
.........................@@....@@@..
..............@.............@.@.....
.........@..........................
.....@@.....@.........@.....@...@...
............@.........@.............
.......@...........................@
@..........@.......................@
@............@.......@@..@....@@.@@@
..........@.@@@@......@@@@....@@@@@@
......@@@@@.@@@@...@..@@@.....@@@@@@
......@@@@@.@@@.........@......@@@@@
......@@@@@@@.......@@@.@.....@@@@@@
....@@@@@@@@@.......@@@@@.....@@@@@@
..@@@@@@@@@@@......@@@@@@@@@...@@@@@
@@@@@@@@@@@@@@@@...@@@@@@@@@...@@@@@
@@@@@@@@@@@@@@@@@.@@@@@@@@@@@...@.@@
@@@@@@@@@@@@@@@@@@@@@@@@@@@@@@....@@
@@@@@@@@@@@@@@@@@@@@@@@@@@@@@@@...@.
@@@@@@@@@@@@@@@@@@@@@@@@@@@@@@@.....
@@@@@@@@@@@@@@@@@@@@@@@@@@@@@@@@....
@@@@@@@@@@@@@@@@@@@@@@@@@@@@@@@@...@
@@@@@@@@@@@@@@@@@@@@@@@@@@@@@@.....@
@@@@@@@@@@@@@@@@@@@@@@@@@@@@......@@
@@@@@@@@@@@@@@@@@@@@@@@@@@@@...@@.@@
8
31 14 0
14 14 0
23 23 0
27 16 0
21 12 0
5 6 0
11 2 0
19 24 0

8 3 0
13 9 0
18 6 0
30 8 0
23 9 0
5 5 0
26 11 0
18 24 0
