width 36
height 36
@@@@@@@@@@@@@@@@...@@@@@...@....@@@@
@@@@@@@@@@@@@......@@@@@..@@.....@.@
@@@@@@@@@@@@@@....@@@@@@..@@@......@
@@@@@@@@@@@@......@@@@@@@.@@.......@
@@@@@@@@@@@@@.....@@@@@@@..@.@..@@..
@@@@@@@@@@@@@@.......@@@@@..........
@@@@@@@@@@@@@.....@....@............
@@@@@@@@@@@@......@@@..............@
@@@@@@@@@@@@..@...@.@.............@@
@@@..@@@@@@@@.@........@@..@@....@@@
@@@.@@..@@@@....@......@..........@.
@@@.....@@...........@.......@......
@@.@....@@..@.@@.....@@.....@@......
............@.@@....................
....................................
@.....................@...........@.
@..@@@@@@@@..........@..............
@@.@@@@@@@@.........................
@@@@@@@@@@..................@.......
@@@@@@@@@@......@@..................
@.@@@@@@@@@......@@.......@.........
@..@@@@@@@@@.....................@@.
@.....@@....@.@...................@.
@...................................
........@...................@..@@@..
...............................@@@..
...............................@@...
...@@.............@..@...@@@@@.@@@..
...................@.@...@...@@@@...
@.................@..@@@.@...@@@....
@................@@.................
......@.@........@..................
........@@@.........................
........@@...@......................
..@@................................
@@@@........@.............@.........
8
21 35 0
21 22 0
5 31 0
25 23 0
34 3 0
34 13 0
13 19 0
30 34 0

33 34 0
1 33 0
25 6 0
2 33 0
32 6 0
13 23 0
13 24 0
26 30 0
