width 36
height 36
@@@@@@@@....@........@@@.......@..@@
@@@@@@@@.......................@..@@
@@@@@.....................@....@...@
@@@@......................@.........
@@@@@@@@............................
@@@@@@@@...................@........
@@@@@@@..................@@@@.......
@@@@@@@....@..............@@.......@
@@@@@@@@......@@.............@.....@
@@@@@@@@@@....@@..@@@@...........@@@
@@@@@@@@.........@@@@@...........@@@
@@@@@.........@@@..@@@..............
.@@...........@@@....@.....@........
.@...........@@@@......@......@@....
.............@@@.........@.........@
.............@@....@................
.......@@@...@@....@................
.......@......@................@.@@.
.....@......@.....@@..........@@@@@@
@........................@.@..@@@@@@
@..............@....@..@@@@@@.@@@@@@
@.......................@@@@@@@@@@@@
.........@@............@@@@@@@@@@@@@
@@@....@@..............@@@@@@@@@@@@@
@@@@....@..............@@@@@@@@@@@@@
@@@@@..@@@@......@........@@@@@@@@@@
@@@@@@@@@@@@@.......@....@@@@@@@@@@@
@@@@@@@@@@@@@...........@@@@@@@@@@@@
@@@@@@@@@@@@@..@.....@.@@@@@@@@@@@@@
@@@@@@@@@@@@@@@@@@@.@@.@@@@@@@@@@@@@
@@@@@@@@@@@@@@@@@@@....@@@@@@@@@@@@@
@@@@@@@@@@@@@@@@@@@....@@@@@@@@@@@@@
@@@@@@@@@@@@@@@@@@@...@@@@@@@@@@@@@@
@@@@@@@@@@@@@@@@@@@...@@@@@@@@@@@@@@
@@@@@@@@@@@@@@@@@@....@@@@@@@@@@@@@@
@@@@@@@@@@@@@@@@@@@...@@@@@@@@@@@@@@
8
28 8 0
7 18 0
26 1 0
16 20 0
20 5 0
6 18 0
12 8 0
16 15 0

13 24 0
17 17 0
26 1 0
17 5 0
19 7 0
22 30 0
10 7 0
17 14 0
