width 36
height 36
@..........@@@...@.....@@@@@@@@@@@@@
@............@.........@@@@@@@@@@@@@
.@@...........@.....@..@@@@@@@@@@@@@
..@...................@@@@@@@@@@@@@@
....@.........@....@@.@@@@@@@@@@@@@@
.....@.........@@..@@@@@@@@@@@@@@@@@
....@@......@.@@@.@@@@@@@@@@@@@@@@@@
....@@.......@@@@.@@@@@@@@@@@@@@@@@@
@...@@......@@@@@@@@@@@@@@@@@@@@@@@@
@...........@@@@@@@@@@@@@@@@@@@@@@@@
@..........@..@@@@@@@@@@@@@@@@@@@@@@
................@@@@@@@@@@@@@@@@@@@@
....................@@@..@@@@@@@@@@@
.....................@.....@@@@@@@@@
................@@...........@@@@@@@
........@.....@..............@@@@@@@
.............................@@@@@@@
...................@..@.......@@@@@@
@.....@............@...........@@@@@
@@.................@.......@...@@@@@
@@.............@......@@..@...@@@@@@
@@@.....@..@.............@..@@@@@@@@
@@@.....@@.@.............@.@@@@@@@@@
@@.........................@@@@@@@@@
@@........................@@@@@@@@@@
@@@@........@@@...@@......@@@@@@@@@@
@@@@......................@@@@@@@@@@
@@@@......................@@@@@@@@@@
@@@@..@@.@.........@.....@@@@@@@@@@@
@@@@..@@.@@@@@...........@@@@@@@@@@@
@@@@.@@@@@@@@...@..@....@@@@@@@@@@@@
@@@@.@@@@@@........@...@@@@@@@@@@@@@
@@@@.@@@@.............@@@@@@@@@@@@@@
@@@..@@@@@........@.@@@@@@@@@@@@@@@@
@....@@@@....@...@@@@@@@@@@@@@@@@@@@
@@...@@@@@.......@@@@@@@@@@@@@@@@@@@
8
16 24 0
6 25 0
17 12 0
23 27 0
5 18 0
3 14 0
3 21 0
7 19 0

3 19 0
5 25 0
20 0 0
4 35 0
9 2 0
5 14 0
11 31 0
6 26 0
