width 23
height 23
@@@@@@@@@@@@@@@@@@@@@@@
@@@@@@@@@@@@@@@@@@@@@@@
@@@@@@@@@@@@@@@@@@@@@@@
@@@@@@@@....@@@@@@@@@@@
@@@@@@@@@@..@@..@@@@@@@
@@@@@@@@@@@.....@@@@@.@
@@@@@@@@@@@............
@@@@@@@@@@.............
@@@@@@............@@...
@@@@@@.................
......................@
........@.............@
.........@............@
...@...................
...@...................
@..@.................@@
......................@
.@@.......@............
........@.@............
..@@...@@...@....@.....
@@@@@@..@.......@......
@@@@@@@@@@@@@@@.@......
@@@@@@@@@@@@@@@.@@@@@..
8
15 18 0
22 14 0
4 15 0
5 12 0
9 16 0
14 10 0
5 18 0
14 7 0

10 9 0
0 16 0
22 6 0
18 6 0
22 9 0
14 9 0
5 16 0
7 15 0
