width 23
height 23
......@.@..........@@@.
........@@.....@....@@.
.....@......@.......@..
...............@@......
........@@.....@@......
........@@.....@@...@@@
...........@..........@
......................@
......@................
.......................
............@..........
..@@........@..........
...................@@@@
...@...............@@@@
@....@.......@.....@@@@
@@...........@....@@@@@
@.................@@@@@
@@................@@@@@
@@.........@......@@@@@
@@@...............@@@@@
@@...............@@@@@@
@@...............@@@@@@
@@.....@@...@....@@@@@@
8
7 8 0
0 3 0
13 1 0
7 3 0
18 10 0
9 15 0
2 0 0
7 14 0

13 11 0
7 15 0
21 11 0
16 19 0
15 2 0
22 3 0
0 2 0
9 19 0
