width 23
height 23
.@@....@@@@@@@....@@...
.........@@@@@@@.......
.........@@@@@@@...@...
.........@@@@@@....@...
........@...@@.........
.@..@..................
.......................
..@..............@@@.@@
...............@@@@@@@@
...............@@@@@@@@
@..............@@@@@@@@
@........@.....@@@@@@@@
........@@.......@@@@@@
.@....@.@@@.@..@@@@@@@@
......@@@@@@@.@@@@@@@@@
...@@@@@@@@@@@@@@@@@@@@
.....@@@@@@@@@@@@@@@@@@
.....@@@@@@@@@@@@@@@@@@
.@...@@@@@@@@@@@@@@@@@@
.........@@@@@@@@@@@@@@
....@....@@@@@@@@@@@@@@
.........@@@@@@@@@@@@@@
..@......@@@@@@@@@@@@@@
8
21 3 0
21 0 0
8 9 0
0 13 0
1 11 0
7 20 0
11 7 0
9 4 0

2 15 0
18 4 0
22 3 0
6 21 0
17 1 0
4 6 0
7 22 0
0 22 0
