width 23
height 23
@........@@@@@@@@@@@@@@
@....@.....@@@@@@@@@@@@
@.....@...@@@@@@@@@@@@@
@.@@@....@@@@@@@@@@@@@@
...@@..@.@@@@@@@@@@@@@@
@....@......@@.@@.@.@..
.......................
.............@.........
...@.................@@
.....................@@
......@@@@..@@.@....@@@
....@..@..@@@@@@@..@@@@
@..........@@@@@....@@@
@...........@@@@....@@.
@.@.........@@@........
@@@........@.@@........
@@@...................@
@@@.................@.@
@@@...@@@......@@@@....
@@@@..@@@@.....@@@@....
@@@@..@@@@@@@@.........
@@@@@.@@@@@@@@.........
@@@@@@@@@@@@@..@....@..
8
0 9 0
9 2 0
1 10 0
14 21 0
10 17 0
4 18 0
3 6 0
19 22 0

11 17 0
4 0 0
4 12 0
14 18 0
2 0 0
5 21 0
9 18 0
8 7 0
