width 23
height 23
@@@@@@@@@@@@@@@....@@@@
@@@@@@@@@@@@@@@.....@@@
@@@@@@@@@@@@@@@.....@@@
@@@@@@@@@@@@@@@@.....@@
@@@@@@.@@.@@@@.........
@@@@@......@@@.........
@@@@@........@...@.....
@@@@...................
@@@@.................@.
@@@@..........@........
@@@@@.........@@......@
@@@@@.......@@.........
@@@@@@.......@@@@@.....
@@@.........@@@@@@@@@..
.......@@@..@@@@@@@@@@@
.............@@@@@@@@@@
.........@...@@@@@@@@@@
............@@@@@@@@@@@
..........@.@@@@@@@@@@@
............@@@@@@@@@@@
....@@.......@@@@@@@@@@
....@@@......@@@@@@@@@@
..@@@@@......@@@@@@@@@@
8
10 19 0
9 17 0
4 14 0
22 4 0
0 15 0
12 12 0
20 12 0
3 21 0

0 20 0
19 8 0
21 10 0
0 22 0
6 12 0
12 12 0
21 12 0
3 21 0
