width 20
height 32
....................
....................
@..........@.@......
..............@..@..
....@....@..........
@@................@@
@@........@........@
....................
....@...........@...
.....@......@.......
.......@......@.@...
...@..@@............
......@@.@..........
@@@...@@.....@....@.
@@@..@.@.@..........
@@@......@......@...
@@@......@..........
.....@...........@..
...........@........
....................
.......@............
@....@....@..@..@...
...........@........
..........@.........
..@...@...........@.
................@...
....@....@..........
....@.......@.......
@.........@...@.....
@.....@.............
@@........@@@.......
@@.@.....@@@@.......
6
6 25 0
13 26 0
11 5 0
15 3 1
19 30 1
5 5 1

6 6 0
14 23 0
16 20 0
0 25 1
14 4 1
14 30 1
