width 20
height 32
@@@@...............@
@............@....@.
....................
.........@.....@.@..
...................@
.@.@...........@....
......@..@..........
.............@...@..
....@......@........
...........@....@...
.....@..............
...@....@.@....@....
.......@............
....@.......@......@
..@.....@......@....
@....@......@.......
....................
..........@.@.......
@....@..........@...
....@.......@@......
...............@....
......@.............
........@.....@.....
...@...............@
@.............@.....
@@.@....@...........
....................
....@...............
......@.@...@.@.....
................@...
...............@....
@@......@@....@@....
6
10 23 0
5 14 0
11 28 0
2 11 1
13 12 1
19 10 1

18 24 0
16 30 0
12 10 0
18 22 1
16 15 1
17 31 1
