width 20
height 32
....................
.......@......@.@...
.....@....@.........
..@..........@......
........@.@....@..@.
.......@............
...........@........
.....@......@.......
...@....@........@..
....................
.......@............
@..............@..@.
......@.....@.......
..@.@..@............
.................@..
....@....@...@.@....
............@.@.....
@@@..............@..
@........@..@.......
@..@......@.....@...
....................
.....@.@............
.@...@@...........@.
....@.@..@..@.@.....
........@...........
.@...@....@......@..
....................
....................
.......@....@.@.....
....................
...............@....
...........@@......@
6
17 6 0
12 0 0
12 17 0
2 10 1
14 25 1
12 14 1

15 26 0
3 27 0
13 31 0
7 25 1
1 1 1
5 30 1
