width 27
height 27
@@@@.........@........@@@@@
@@@@@@.................@@@@
@@@@@...@............@.@@@@
@@@@@@....@..........@@@@..
@@@@@......................
@@@@@...............@@.....
@@@@@......@....@@..@@....@
@@@@@......@....@@.@@@.....
@@@@@......@....@@...@....@
@@@.........@.......@@...@@
@@@.................@....@@
@@@@....@................@@
@@@...............@......@@
@........................@@
@........................@@
@........@@................
....@@@@@@@@........@......
@@..@@@@@.....@@...........
@@@@@@@@@....@@......@.@@..
@@@@@@@@..@@@@...@@@@@@@@..
@@@@@@@@.....@.@.@@@@@@@@.@
@@@@@@.......@...@@@@@@@@@@
@@@@....@.........@@@@@@@@@
@@@@..................@@@@@
@@@@@@.................@@@@
@@@@@@@@......@......@@@@@@
@@@@@@@@........@@....@@@@@
8
26 5 0
17 10 0
9 14 0
19 8 0
26 7 0
22 8 0
4 10 0
16 10 0

5 23 0
6 24 0
24 15 0
9 2 0
17 22 0
19 3 0
18 17 0
15 26 0
