width 27
height 27
.....@@..@@@@@@@@@@@@@@@@@@
...........@@@@@@@@@@@@@@@@
..........@@@@@@@@@@@@@@@@@
.........@@@@@@@@@@@@@@@@@@
.........@@@...@@@@@@@@@@@@
@@.............@@@@@@@@@@@@
@@.@.....@.......@@@@@@@@@@
......@..@.........@....@@@
................@.@..@@..@@
..@@.@@@.................@@
.@@..................@..@@@
@@@@@........@.@@.......@@@
@@@@@@........@.@......@@@.
@@@@...............@.......
@@@@.................@@@...
@@@@@@.......@.@@....@@...@
@@@@@@@........@.....@@..@@
@@@@@@.......@@@...@@@@@@@@
@@@@@@........@.....@@....@
@@@@@@@@............@@....@
@@@@@@@@@..@@..@...........
@@@@@@@...............@@...
@@@@@@@@@..@...............
@@@@@@@@@..................
@@@@@@@@.............@@....
@@@..................@@@...
@@@@@.........@......@@@@@@
8
20 9 0
20 15 0
7 25 0
17 12 0
13 24 0
2 5 0
0 3 0
6 11 0

6 26 0
6 6 0
26 12 0
11 23 0
13 5 0
4 25 0
8 26 0
16 23 0
