width 27
height 27
@.......@...@@@@@@@......@@
@..........@@@@@@..........
@@@..........@...@.........
@.................@........
@@........@@......@........
@@............@..........@.
@..........................
@@....@.....@............@@
@...@@@...............@..@@
.....@@.@......@.........@@
.@.............@......@@@@@
.@.........@@....@....@@@@@
...................@@@@@@@@
.....@@............@@@@@@@@
.....@@.............@@@@@@@
......................@@...
.......@..@..........@.....
@@@@@..@...@..@@....@......
@@@@@.@@...@@@@@@.......@@.
@@@@@........@..........@..
@@.......@@................
@@.......@@.....@..........
@@@......................@@
@@@.........@...........@@@
@@@@.@....@@@......@@.@@@@@
@@@@@@@....@@@@..@@@@@@@@@@
@@@@@@....@@@@@@@@@@@@@@@@@
8
24 2 0
19 3 0
5 21 0
13 11 0
0 16 0
3 11 0
15 4 0
17 22 0

0 11 0
9 19 0
20 19 0
26 20 0
3 10 0
3 11 0
8 25 0
1 0 0
