width 27
height 27
............@...........@@@
...@...................@@@@
.......................@.@@
@@@..........@.....@@..@.@@
@@...........@...........@@
@@.....@...@...........@..@
@@.....@.....@...........@@
@@.......................@@
@@..........@.......@....@@
@...............@........@@
@..............@@.@........
.....@.........@@..........
...........................
....@@.....................
.............@@.@.....@.@.@
.............@@@@@@@@@@...@
....@@........@@@@@@@@@...@
....@@@@......@@@@@@@@....@
..@@@@@@@@....@@@@@@@@@....
..@@@@@@@@..@@@@@@@@@@@@...
...@@@@@@@.@@@@@@@@@@@@@...
....@@@@@@@@@@@@@@@@@@@@...
....@@@@@@@@@@@@@@@@@@@@@..
@....@@@@@@@@@@@@@@@@@@@@@@
@....@@@@@@@@@@@@@@@@@@@@@@
@@.@@@@@@@@@@@@@@@@@@@@@@@@
@@@@@@@@@@@@@@@@@@@@@@@@@@@
8
16 8 0
8 17 0
21 0 0
14 11 0
5 2 0
12 3 0
8 13 0
12 15 0

3 23 0
7 8 0
8 15 0
25 14 0
25 15 0
1 24 0
4 6 0
13 0 0
