width 27
height 27
...@..@@@@......@@....@@@@@
...............@.......@@@@
.......................@@@@
@........................@.
.............@@@@..........
.............@@@@.....@....
@.........@.....@..........
@...............@..........
.........................@.
.@.........................
.....................@.....
..................@.......@
@@..@@....................@
@@@@@@....@................
@@@@@@...................@.
@@@@@@@@@......@..@.....@@.
@@@@@@@@@......@......@.@@.
@@@@@@@@@@.....@@......@@@@
@@@@@@@@@@..............@@.
@@@@@@@@@@.................
@@@@@@@@@.....@@...........
@@@@@@@@@@@....@...........
@@@@@@@@.@@..........@.@@@@
@@@@@@@@.............@.@@@@
@@@@@@@@@............@.@@@@
@@@@@@@@@@@...@.....@@@@@@@
@@@@@@@@@@@@........@@@@@@@
8
13 16 0
15 25 0
24 8 0
8 23 0
0 8 0
20 15 0
11 10 0
5 9 0

15 13 0
3 1 0
19 24 0
8 22 0
16 13 0
2 4 0
26 21 0
14 3 0
