width 27
height 27
@@@@@@......@@.....@@@..@@@
@@@..@@.....@@.......@..@@@
@@@@.....................@@
@@@@.............@....@...@
@@@..........@.............
@@@.@......@.....@.........
@@@......@..........@.@....
@@.......@@.......@@..@....
@@......@@..@......@......@
@.................@.......@
...@....................@.@
..@.............@....@@.@@@
................@@...@@@@@@
@......................@@@@
....@...........@......@@@@
....@...........@.....@@..@
.@@........................
..........................@
....@..................@...
..@@@.....@......@.........
....@....@@.@@.............
.........@@@@@.......@@....
...@......@@@.........@..@@
....@....@@@@@@@.........@@
.......@@@@@@.@@........@@@
.......@@@.......@.........
@.@........@@@@............
8
25 15 0
20 10 0
22 16 0
3 12 0
8 22 0
6 12 0
25 26 0
23 19 0

3 1 0
6 22 0
8 3 0
11 13 0
21 4 0
3 20 0
20 22 0
23 11 0
