width 27
height 27
...@@@@@@@@@@@@@@@@.....@@@
...@@@@@@@@@@@@@@@..@..@@@@
....@@@@@@@@@@@@@......@@..
....@.@@@@@...@@@@.....@@..
......@@@@@...@.........@..
....@......................
..@@..........@@...........
...............@@@@@......@
.@@............@@@@@@....@@
.@.............@@@@@@....@@
.....@..................@@@
@@...@....................@
@@...@.....................
...........................
.............@@...........@
@.............@...........@
.......@......@........@...
...........................
....@..@@@.................
....@@@@@@................@
......@@@@...............@@
......@@@@...............@@
......@@@@...............@@
@@...@@@@@.@........@@..@@@
@@@@@@@@@@@@...@@@@.@@..@@@
@@@@@@@@@@@@@@@@@@@.@@@@@@@
@@@@@@@@@@@@@@@@@@@@@@@@@@@
8
12 13 0
26 18 0
13 16 0
19 20 0
17 6 0
24 7 0
16 5 0
14 10 0

0 1 0
12 12 0
6 8 0
12 18 0
18 6 0
15 20 0
18 5 0
24 16 0
