width 27
height 27
@@@@@@@@@@@@@@@@@@@@@@@@...
@@@@@@@@@@@@@@@@@@@@@@@@...
@@@@@@@@@@@@@@@@...@@@@@...
@@@@@@@@@@@@..@....@@@@....
@@@@@@@@@.@@.......@@.....@
@@@@@@@@@..........@@......
@@@@@@@@@................@@
@@@@@@@@..............@@@@@
@@@@........@@.........@@@@
@@@@.@@.@@..@@@........@@@@
@@...@@.....@@@.........@@@
@....@@.....@@...........@@
@......@@@................@
@@.....@@...........@.....@
@@@..@..............@....@@
@@@@....................@@@
@@@...........@@........@@@
@@@..................@@@@@@
@@@@@.@@@@@@....@...@@@@@@@
@@@@@@@@@@@.....@...@@@@@@@
@@@@@@@@@@@.......@@@@@@@@@
@@@@@@@@@@@...@.@@@@@@@@.@@
@@@@@@@@@@....@...@......@@
@@@@@@@@@@@....@...........
@@@@@@@@@@@..@..@..........
@@@@@@@@@......@@..........
@@@@@@@@@......@@@.........
8
15 15 0
12 3 0
18 7 0
17 4 0
15 8 0
24 2 0
16 3 0
8 8 0

24 4 0
9 8 0
18 26 0
10 15 0
12 15 0
19 19 0
26 0 0
8 7 0
