width 29
height 29
@@@@@@@@......@@@...@@@@@@@@@
@@@@@@@@........@....@.@@@@@@
@@@.@..........@@............
.@............@@@............
.........@@.................@
.....................@......@
.....................@@@@@..@
.......@...............@.....
@....@@.....................@
.....@...............@.....@@
.....@.......@.......@@....@@
..........................@@@
.....@.................@@.@@@
.............@.......@.@@@@@@
........@@@@...@.......@@@@@@
........@@.....@.......@@@@@@
@@...@..@.................@@@
@.......................@.@@@
@.........@..................
....................@..@.....
...........@..........@@.....
...........@.........@@@@....
....@......@.........@@@@@@@@
.....................@@@@@@@@
.....................@@@@@@@@
.......@@@@@@@.......@@@@@@@@
.....@.@@@@@@@..........@@@@@
@@@....@@@@@@@.@........@@@@@
@@@@..@@@@@@@@@@........@@@@@
8
20 16 0
19 3 0
18 10 0
18 28 0
23 16 0
17 9 0
25 12 0
2 7 0

2 25 0
6 2 0
8 19 0
20 20 0
13 18 0
5 23 0
21 26 0
20 13 0
