width 29
height 29
..@@@@@...@@@@@@..@@@@....@@@
.@@@@@@..@.....@....@@@@.....
.@@......@..@......@@@@@@...@
............@@.....@@@@@.....
.....@@............@@@@...@@.
...@@@@........@...@@@@...@..
....@@@.@.....@@.@.@.@....@@.
@..........@...............@@
....................@........
.................@.@...@@....
.....@.......................
..................@@.......@@
...........................@@
.....@@@.....@...............
.............@@.............@
@............@@..............
@@...........@@..............
@@@..........@@............@.
@@@@@.......@@@..@.......@...
@@@.......@@@@@@@@...........
@@......@@@@@@@@@@....@...@@@
@.......@@@@@@@@@@@..........
@....@@@@@@@@@@@@@@..........
......@@@@@@@@@@@@@......@@..
....@@@@@@@@@@@@@@@@...@@@@@@
.@....@@@@@@@@@@@@@@@...@@@@@
........@@@@@@@@@@@@@@..@@@@@
.....@@.@@@@@@@@@@@@@...@@@@@
.....@@@@@@@@@@@@@@@@@..@@@@@
8
15 9 0
5 12 0
3 17 0
7 19 0
6 18 0
1 15 0
22 8 0
23 11 0

23 21 0
20 16 0
7 17 0
6 15 0
2 24 0
18 10 0
5 11 0
26 11 0
