width 29
height 29
@@@@@@@@@@@@@.......@........
@@@@@@@@@@@@...............@.
@@@@@@@@@@@.......@.......@@@
@@@@@@@@@@@........@........@
@@@.....@@@......@..........@
@@@......@......@@..........@
@@@@............@............
@@@@@@@.....................@
@@@@@@......................@
@@@@@@.....@..@.....@........
@@@@@......@.....@..@........
@@@@@@@.@@......@@...@@@....@
@@@@@@@@@@.....@@.....@@....@
@@@@@@@@@....@.@.....@@.....@
@@@@@@@@@....@@@............@
@.....@@......@@...@.@@......
.......@............@........
....................@........
............................@
...........@................@
.................@...........
@@@......@..........@........
@@@...@@@@.......@@...@...@..
@@@..@@@@@....@@.@@@.........
@@@....@@@.@@@@@.@@....@.....
@......@@@@@@@@@@@@@@........
@......@@@@@@@@@@@@@@@@......
..@@@.@@@@@@@@@@@@@@@@@......
..@@@@@@@@@@@@@@@@@@@@@......
8
4 15 0
10 18 0
3 26 0
21 25 0
19 20 0
26 18 0
24 2 0
26 3 0

18 4 0
18 21 0
11 7 0
27 10 0
14 8 0
28 23 0
12 11 0
1 27 0
