width 67
height 67
@@@@@@.@@@@@.........@@@@@@@@@@@@@@@@@@@@@@@@@@@@@@@@@@@@@@@@@@@@@@
@@@@...@@@@..........@@@@@@@@@@@@@@@@@@@@@@@@@@@@@@@@@@@@@@@@@@@@@@
@@@@.........@.......@@@@@@@@@@@@@@@@@@@@@@@@@@@@@@@@@@@@@@@@@@@@@@
@@...................@@@@@@@@@@@@@@@@@@@@@@@@@@@@@@@@@@@@@@@@@@@@@@
......................@@@@@@@@@@@@@@@@@@@@@@@@@@@@@@@@@@@@@@@@@@@@@
.............@..........@@@@@@@@@@@@@@@@@@@@@@@@@@@@@@@@@@@@@@@@@@@
..........@..@..@.......@@@@@@@@@@@@@@@@@@@@@@@@@@@@@@@@@@@@@@@@@@@
@@.........@..@@...@@.@.@@@@@@@@@@@@@@@@@@@@@@@@@@@@@@@@@@@@@@@@@@@
@............@@@...@@...@@@@@@@@@@@@@@@@@@@@@@@@@@@@@@@@@@@@@@@@@@@
.........@...@@@........@@@@@@@@@@@@@@@@@@@@@@@@@@@@@@@@@@@@@@@@@@@
@.......................@@@@@@@@@@@@@@@@@@@@@@..@@@@@@@@@@@@@@@@@@@
@@@.....@.....................@@@@@@@@@@@@@@@@.@@@@@@@@@@@@@@@@@@@@
@@@............................@@@@@@@@@@@@@...@@@@@@@@@@@@@@@@@@@@
@@@@...@@................@...@@@@@@@@@@@@@@@.......@@@@.@@@@@@@@@@@
@@@@@@.@................@@.@@@@@@@@@@@@@@@@...@.........@@@@@@@@@@@
@@@@@@.@..............@....@@@@@@@@@@@@@@@........@@....@@@@@@@@@@@
@@@@@................@......@@@@@@@@@@@@@@@......@@@@@@@@@@@@@@@@@@
@@@@@...@....................@@@@@@@@@@@......@..@@@@@@@@@@@@@@@@@@
@@@@..........................@@...@@..@.........@@@@@@@@@@@@@@@@@@
@@.....@.......@@@@................@....@.....@..@@@@@@@@.@@@@@@@@@
...............@.......@.........................@@@@@@@...@.@@@@@@
.......................@.....................@@..@@@@@@@......@@@@@
...................@......................@..@@...@@@@@@....@@@@@@@
......@.@.....................@@@............@@@@@@@@@@@@......@@@@
@......@@@@.....................@@@...........@@@@@@@@@@@@......@@@
.............................@@..@@..@.....@@.@@@@@@@@@@@@@.....@@@
..........@...................@@....@@....@.@.@@@@@@@@@@@@......@@@
............@.........@.......@.....@@...@@.@......@@@@@@@.......@@
.@..........@..@......@............@@@.............................
@@@@............@.@.............................@...............@@@
@@@@...............@............@.@......@@........@.............@@
@@@@..............@.......@...............@........@.........@...@@
..@@@.........@@@.@@.@@@@..............@.@@.@@...................@@
......@@.....@@@@@@@..........@@.............@@...................@
......@@@....@@@@@@.........@.@@..........................@@@..@..@
.....@@@@.......@@@....@.@@@@@@@.........................@@@@@@@...
@@...@.....@....@@@......@.@@@.............@.@@@.......@@@@@@@@@..@
@@.....................@...@@..............@.@@@@....@@@@@@@@@@...@
@@............@@.......@...................@@@@@@......@@@@@@@@...@
@@...........@@@.........@.....................@.......@@@@@@@@....
@@.......@....@@...@................@@@....@@..........@@..@@@@@..@
.........@@................@@.......@@@@....@.....@........@@@@@@@@
..........@................@.........@@@.........@@@........@@@@@@@
@...............................................@@@@.........@@@@@@
@........................................@.....@@@@@.........@@.@@@
@@@@............................@......@........................@@@
..@........................................@..@......@.......@.@@@@
.......................@..............................@........@@@@
....@@@@@..................@....................................@@@
......@@...................@.....................................@@
......@@@@..................................@.............@..@@@@@@
......@@@@.............................@@@..@....@...........@@@@@@
........@.........@@.@.................@@@..@..............@@@@@@@@
............@.....@@.@..................@@@.@@@@@@.......@@@@@@@@@@
....@@..........@.@@....@.@.................@@@@@@@@@...@@@@@@@@@@@
@@@@@@.......@..@.....@@...@.....@@@........@@@@@@@@@...@@@@@@@@@@@
@@@@@@............@....................@....@@@@@@@@@....@@@@@@@@@@
@@@@@@..........@@@@...................@.......@@@@@@@@@.@@@@@@@@@@
@@@@@@..........@..........@.@@.......@...@..@.@@@@@@@@@@@@@@@@@@@@
@@@@@@..........@...@....@.@@@@.@..@@@@....@.@..@@@.@@@@@@@@@@@@@@@
@@@@@@@@..........@......@@..@@....@..@@@@@@....@...@@@@@@@@@@@@@@@
@@@@@@@@@@@.........@@@..............@@@@@........@@@@@@@@@@@@@@@@@
@@@@@@@@@@@@@......@@@...............@@@@@@@@...@@@@@@@@@@@@@@@@@@@
@@@@@@@@@@@@@@@@...@@@...............@@@@@@@....@@@@@@@@@@@@@@@@@@@
@@@@@@@@@@@@@@@@@..@@@@@@@...........@@@@@@@@...@@@@@@@@@@@@@@@@@@@
@@@@@@@@@@@@@@@@@..@@@@@@@@.......@..@@@@@@@@...@@@@@@@@@@@@@@@@@@@
@@@@@@@@@@@@@@.....@@@@@@@@@@@@@@@@@..@@@@@@@..@@@@@@@@@@@@@@@@@@@@
8
5 21 0
48 22 0
28 22 0
52 15 0
20 16 0
61 33 0
24 51 0
65 37 0

11 39 0
40 33 0
26 48 0
41 19 0
1 42 0
37 53 0
18 1 0
20 12 0
