width 67
height 67
@@@@@@@@@@@@@@@@@@@@@@@@@@@@@@@@@@@@@@@@@@@@@@@@@@@@@@@@@@@@@@@@@@@
@@@@@@@@@@@@@@@@@@@@@@@@@@@@@@@@@@@@@@@@@@@@@@@@@@@@@@@@@@@@@@@@@@@
@@@@@@@@@@@@@@@@@@@@@@@@@@@@@@@@@@@@@@@@@@@@@@@@@@@@@@@@@@@@@@@@@@@
@@@@@@@@@@@@@@@@@@@@@@@@@@@@@@@@@@@@@@@@@@@@@@@@@@@@@@@@@@@@@@@@@@@
@@@@@@@@@@@@@@@@@@@@@@@@@@@..@@@@@@@@@@@@@@@@@@@@@@@@@@@@@@@@@@@@@@
@@@@@@@@@@@@@@@@@@@@@@@@@@@..@@@@@@@@@@@@@@@@@@@@@@@@@@@@@@@@@@@@@@
@@@@@@@@@@@@@@@@@@@@@@@@@......@@@@@@@@@@@@@@@@@@@@@@@@@@@@@@@@@@@@
@@@@@@@@@@@@@@@@@@@@@@@@.......@@@@@@@@@@@@@@@@@@@@@@@@@@@@@@@@@@@@
@@@@@@@@@@@@@@@@@@@@@@@@@@.@@...@@@@@@@@@@@@@@@@@@@@@@@@@@@@@@@@@@@
@@@@@@@@@@@@@@@@@@@@@@@@@.....@.@@@@@@@@@@@@@@@@@@@@@@@@@@@@@@@@@@@
@@@@@@@@@@@@@@@@@@@@@@@..........@@@@@@@@@@@@@@@@@@@@@@@@@@@@@@@@@@
@@@@@@@@@@@@@@..@@@@@.............@@@@@@@@@@@@@@@@@@@@@@@@@@@@@@@@@
@@@@@@@@.@@@@....@@@.............@@@@@@@@@@@..@@@@@@@@@@@@@@@@@@@@@
@@@@@@@..@@@@@........@...@@@@@@@@@@@@.@@@@@..@@.@@@@@@@@@@@@@@@@@@
@@@@@@.@...@@.............@@.@@@@@@@@..@@@.......@@@@@@@@@@@@@@@@@@
@@@..........@....@@.........@@@@@@.....@@.@......@@@@@@@@@@@@@@@@@
@@@........................@..@@@@@.....@@..@.....@@@@@@@@@@@@@@@@@
@@@........................@...@@@@.....@....@@.....@@@@@@@@@@@@@@@
@@...........@..................@@....................@@@@@@@@@@@@@
@..........@@..........................................@@@@@@@@@@@@
.......................................................@@@@@@@@@@@@
..@@.............@.@..............@@@..................@@@@@@@@@@@@
................@...............@.@@@..................@@@@@@@@@@@@
..........@........@@...............@@..................@@.....@@@@
.....@@............@@.........@@@..........@..........@@@...@@.@@@@
.....@@............@@................................@..@........@@
@@..@@@....@@@..........................@@...........@.@@.......@@@
@@@.@@@@@@@@@@....................@......@@@...........@@@......@@@
@@@@@@@@@@.@@@..@.@....@.............@@................@@@........@
@@@@@@@@@..@@@.......................@@@......@..@..@..@@@.........
@@@@@@@@..........@.....@..........@@@@@@...@.@@....@@..@@...@.....
@@....@@..........@@@.....@@.....@.@@@@@@@.@@.@@.@..@....@@........
@...@.@@....@............@@@...@.@@@@@@@@@@@..@@@@..@..............
...@@......@@...@@.......@@@@.@@@@@@@@@@@@@@..@.@@.........@@......
......@....@.@.@@@.........@@...@@@@@@@@@@@@..@..@.@.......@@..@...
.....@@@@........................@@@@@@@@@@@.............@@@@.....@
.....@........................@@..@@@@@@@@@@@@.....@@............@@
....@@......................@.@..@@@@@@@@@@@@@@@..............@@@@@
.....@.....@.......@@............@@@@@@@@@@@@@@@..............@@@@@
....@@....@@@.....@@....@........@@@@@@@@@@@@.....@........@@@@@@@@
....@@..@@.@......@@.............@@@@@@@@@@@@@............@@@@@@@@@
.....@.@@.........@@.............@@...@@@@@@.............@@@@@@@@@@
@....@@...........@@.....................@@............@@@@@@@@@@@@
@....@@@..........@@.................@...@.............@@@@@@@@@@@@
@....@............@........@...@......@@............@@..@@@@@@@@@@@
@.@@.......................@@....@....@@@........@............@@@@@
@@@@...@@..........@..@@@..@..........@....@.....@@................
@@@@.......@..........................@@@..@.................@.....
@@@@@..@@@@@@@.........................@...@................@@.....
@@@@@.....@@@@..............................................@@@@@..
@@@@@........@..@...@@....@..........@@.......@...........@@@@@@@@@
@@@..@............@@@@...@@......@@...@.................@...@@@@@@@
@@@..@@........@...@@@@@...@...............@...@.............@@@@@@
@@.......@..@........@@@@@...............@.......................@@
@@.........@..........@@@@@...@@................@................@@
@@.@.........................@@..............@.@@.................@
@@...@.................@.....................@...................@@
@@...@........................@@.......@.....@@@.......@@..........
@@@@.@@....@......@.....@@@@@@@@.......@@....@@@.......@@......@...
@@@@.@@..................@@@@@@@@.....@@@.....@@@@.........@@@.@@@@
.....@...@............@@@@@@@@@@@.....@@@@....@@...............@@@@
@........@..........@@@@@@@@@@@@@......@@@..@@@@@@............@@@@@
@...................@@@@@@@@@@@@@@..........@@@.....@......@...@@@@
@@@@@...............@@@@@@@@@@@@@@.@@....@........@@@@@@....@..@@@@
@@@@@.............@.@@@@@@@@@@@@@@...............@@@@@@@@@....@@@@@
@@@@@@...@......@.@@@@@@@@@@@@@@@@@...............@@@@@@@.....@@@@@
@@@@@@.@@@@@@.@@@@@@@@@@@@@@@@@@@@@.........@.....@@@@@@@@....@@@@@
8
38 17 0
45 50 0
35 43 0
32 21 0
52 57 0
52 24 0
54 55 0
53 18 0

19 44 0
45 63 0
38 55 0
13 19 0
49 62 0
58 27 0
28 18 0
15 42 0
