width 67
height 67
@@@@@@@@.@@@@....@@@@@@@@@@@@@..@@..@.@@@.@@@@@@@@@@@@@@@@@@@@@@@@@
@@@@@@@@.........@@@.@...........@.....@..@@@@@@@@@@@@@@@@@@@@@@@@@
@@@@@@@@.......@.@@.......................@@@@@@@@@@@@@@@@@@@@@@@@@
@@@@@@@@.........@........................@@@@@@@@@@@@@@@@@@@@@@@@@
@@@@@@@@.........@..................@@@.@@@@@@@@@@@@@@@@@@@@@@@@@@@
@@@@@@@@..@......@......................@@@@@@@@@@@@@@@@@@@@@@@@@@@
@@@@@@@@@.@@.............@@..@.....@....@@@@@@@@@@@@@@@@@@@@@@@@@@@
@@@@@@@@.......@@@...@....@........@.....@@@@@@@@@@@@@@@@@@@@@@@@@@
@@@@@@@........@@..................@.....@@@@@@@@@@@@@@@@@@@@@@@@@@
@@@@@.........@...@......@.................@@.@@@@@@@@@@@@@@@@@@@@@
@..@@@..................@@@@.........@@@@@.....@@@@@@@@@@@@@@@@@@@@
...@...........@........@@@@...................@@@@@@@@@@@@@@@@@@@@
.........................@@@@..........@.............@@@@@@@@@@@@@@
............@............@@@@@.........@@............@@@@@@@@@@@@@@
...@@@.....@@..........@@@@@@@@@..@.....@.@..........@@@@.@@@@@@@@@
@@@@@@@................@@@@@@@@@@@.....@@............@@@....@@@@@@@
@@@@@@@..@@...........@@@@@@@@@@@@@..........................@@@@@@
@@@@@@@@@@@.............@@@@@@@@@@@..........................@@@@@@
@@@.@@@@@...@.....@@....@@..@@@@@@@@......................@.@@@@@@@
@@@.@@@.@..@......@@....@@..@@@@@@@@@.........@...........@..@@@@@@
.@..@@@................@@@@.@@@@@@@@@..@..................@@.@@@@@@
....@@@@...........@...@@@..@@@@.@@@...@@................@@@@@@@@@@
...@@@@................@@@..@@@..@@@@.......@............@@@@@@@@@@
....@@@...@@................@@@..@@@.....................@@@@@@@@@@
.............................@@..@@..@.@.................@@@@@@@@.@
...........@...................@..@..@........@@@........@@@@@@...@
...........@..........@.....@............@@@@..@...........@@@.....
........................................................@.@........
..........................................@....@@@.................
@...@....@.....................................@@@.......@.........
............................@@@.......@@...@@.@.@.......@..........
...........@.......@.......@@@@@@@@...........................@@...
@@.@..@.......@............@@@@@@................................@@
@@@@.......................@@@@@........................@@....@...@
@@@....@...............@....@@@@...............@........@@....@@@@@
@@@@@.......................@..................@........@@....@..@@
@@@@@......@@......@@............@.....@...@..@@...@.....@.......@@
@@@.............@@@@@..........@..............@@...@........@.@....
@@@..............@@@@........@.@..............@@...........@@@.....
@@@.............@@@@@..@@.....................@@...................
@@..............@@@@@@@@@.....................@@@@......@@.........
.................@@@@@@@@@....................@@@....@@@...........
......@...@@........@@@@@@..@.........@@......@@.....@@............
..........@@..@.....@@@@@............@@.......@@....@@@.......@@...
@..........@@..@@...................................@@@@@.....@....
@@@.....@..@@@@@@@.@.......................@........@@@@...........
@@@@.......@@@@@@@.@.@.............................@@@@..@@@.......
@@@.....@....@@@@.@@@@..............@.........@@....@@@.......@....
@@@.....@...@.....@@@@@.......................@@.@@................
@@@...@...........@...@....@...........@@.....@@...................
@@@...............@.......@@@........@.....@.......................
@....@.......@............@@@@............@........................
......@@@....@@..........@@.@@.........................@.........@.
.......@@................@@..@@......@.........@@..@@@......@@@....
......................@@.@...........@@..@.....@@@@@@@@@......@..@.
.....................@@@@..........@@.........@@@@@@@@@@......@@...
@..@............@@@@@@@@@..@.........@........@@@@@@@@@............
@@@@@@..............@@@@......................@@@@@@@@@@@@@@@.@....
@@@@@@....@...........@@...........@.........@@@@@@@@@@@@@@@@@@....
@@.@@.......@...@...........@..@......@.......@@@@@@@@@@@@@@@@...@.
@.......@..@@.............@@@.........@.......@@@@@@@@@@@@@@@@.....
.................@...@@...@@@.@.............@@@@@@@@@@@@@@@@@@.....
.................@@@@@@...@@@.@@....@.......@@@@@@@@@@@@@@@@@@...@.
...........@......@@@@@@@@@@@@@@@..@@@...@...@@@@@@@@@@@@@@@@....@.
....@@...@.@@@....@@@@@@@@@@@@@@@............@@@@@@@@@@@@@@@@@@@@@@
....@@@@@.........@@@@@@@@@@@@@..............@@@@@@@@@@@@@@@@@@@@@@
@...@@@@@........@@@@@@@@@@@@@@...@@@@..@..@@@@@@@@@@@@@@@@@@@@@@@@
8
33 58 0
16 15 0
37 40 0
9 49 0
43 24 0
61 51 0
45 39 0
29 39 0

8 0 0
40 9 0
21 25 0
23 52 0
41 9 0
35 59 0
49 27 0
66 54 0
