width 67
height 67
...@@....@@@@@.@@@@@@@@@@@@......@.........@@@@.......@@...@..@@@..
...@@..........@@@@@@@@@@@..........@.........@@...................
....@...............@@.@@..@........@.......@..@.........@..@@.....
....@........@.....@.....................@@@@@.@.............@.....
.............@........@..................@.....@@..................
..@@@@.....@@@.....@..@@....@@@@@........@@...@@@@..........@.....@
...........@@@.......@@.........@@@............@.@.@.@....@.@...@@@
............@@.....@................@@...........@..........@...@@@
............@@@......................@..........................@@@
.............@@..................................................@@
............@@@..@...........@@@...............................@@@@
............@...@............@@.........................@..........
@.......@....@@...@........@@@@.............................@@....@
@.......@@@@..@............@@@@..............................@.....
.......@@@@............@...................@...@................@..
.......@@@............@@..................................@.....@..
............@.........@@.....................@@@..........@........
.....@......@@@@...@@@@@...@.....@@......@..@@@@@....@@............
.....@......@@@@@.@@@@@@...@....@@@@@@@@.@...@@@......@@...........
............@@@@@@@@@@@@........@@@@@@@@.@...........@@@.@......@@@
..@....@....@@@@@...@............@@@@@@@.@.@......@.@@@..@..@....@@
.......@....@.....................@@@@@@.............@@..@.@.....@@
..................................@@@@@@......@......@@@@@@@.......
.....................@@...........@@@@@@......@.....@@@@@@.........
...............@.....@.......@@..@@@@@@@.....@@.....@@@@@@...@@@@@@
@.@............@.................@.@@@@..@.@.@....@@@@@@@@...@@@@@@
...........@...@@@.................@.@...@@@......@@@@@@@@@..@@@@@@
.@.......@......@@@.....................@.......@@@@@@@..@@..@@@@@@
.........@......@@@@@@................@.........@@@@@@.......@@@@@@
..........@......@@@@@...@.......@.@.............@@@@@....@...@@@@@
.................@@@@@........@..@............@@@@@@@@@...@@@@@@@@@
.....@...........@@@@@.................@@..@@@@@@@@@@@@@@@@@@@@@@@@
...@@@.........@.@..@@................@@@@@@@@@@@@@@@@@@@@@@@@@@@@@
@..@@@.@.@.....@....@......@....@@@....@@@@@@@@@@@@@@@@@@@@@@@@@@@@
..@@.@........@@...@.......@@.@.@@@....@@@@@@@@@@@@@@@@@@@@@@@@@@@@
@.@@.......................@@@@@@@@@@@@@@@@@@@@@@@@@@@@@@@@@@@@@@@@
@@@@@.........@..@.........@@@@@@@@@@@@@@@@@@@@@@@@@@@@@@@@@@@@@@@@
@@@@@....................@.@@@@@@@@@@@@@@@@@@@@@@@@@@@@@@@@@@@@@@@@
@@@@...@.@....@..........@@@@@@@@@@@@@@@@@@@@@@@@@@@@@@@@@@@@@@@@@@
@@@@@@@@@@....@.......@..@@@@@@..@@@@@@@@@@@@.@@@@@@@@@@@@@@@@@@@@@
@@@@@@@@@@@.@@@.......@..@@@@....@@@@@@@@@......@@@@@@@@@@@@@@@@@@@
@@@@@@@@@@..@@...........@@@....@@@@@@@@@@@.....@@@@@@@@@@@@@@@@@@@
@@@@@@@@@....@...@@...@@.@......@@@@@@.@@@@.....@@@@@@@@@@@@@@@@@@@
@@@@@@@@..........@...@@...........@@..@........@@@@@@@@@@@@@@@@@@@
@@@@@@@@@......@@@@....@....@..........@........@@@@@@@@@@@@@@@@@@@
@@@@@@@@......@@@@@....@.@@....@@......@.........@@@@@@@@@@@@@@@@@@
@@@@.@.......@@@@@@.....@..................@@@...@@@@@@@@@@@@@@@@@@
@@@@....@...@@@@@@....@..........@........@@@@...@@@@@@@@@@@@@@@@@@
@@@@........@@@@.................@@.@@...@@@@@@.@@@@@@@@@@@@@@@@@@@
@@@@.@.......@@@................@@@@@@..@@@@@@@@@@@@@@@@@@@@@@@@@@@
@@@@@@........@....@......@...@@@@@@@@@@@@@@@@@@@@@@@@@@@@@@@@@@@@@
@@@@...............@..........@@@@@@@@@@@@@@@@@@@@@@@@@@@@@@@@@@@@@
@@@@@...@.........@@@.........@@@@@@@@@@@@@@@@@@@@@@@@@@@@@@@@@@@@@
@@@@@.............@@......@..@@@@@@@@@@@@@@@@@@@@@@@@@@@@@@@@@@@@@@
@@@@@.............@@@.....@@@@@@@@@@@@@@@@@@@@@@@@@@@@@@@@@@@@@@@@@
@@@@@.............@@@.....@@@@@@@@@@@@@@@@@@@@@@@@@@@@@@@@@@@@@@@@@
@@@.............@@@@@.....@@@@@@@@@@@@@@@@@@@@@@@@@@@@@@@@@@@@@@@@@
.@..............@@@@@.....@@@@@@@@@@@@@@@@@@@@@@@@@@@@@@@@@@@@@@@@@
.@............@...@@@@....@@@@@@@@@@@@@@@@@@@@@@@@@@@@@@@@@@@@@@@@@
.......@.@........@@@@...@@@@@@@@@@@@@@@@@@@@@@@@@@@@@@@@@@@@@@@@@@
........@.........@@.....@@@@@@@@@@@@@@@@@@@@@@@@@@@@@@@@@@@@@@@@@@
...@......@......@@@@.@@@@@@@@@@@@@@@@@@@@@@@@@@@@@@@@@@@@@@@@@@@@@
.................@@@@@@@@@@@@@@@@@@@@@@@@@@@@@@@@@@@@@@@@@@@@@@@@@@
..............@..@@@@@@@@@@@@@@@@@@@@@@@@@@@@@@@@@@@@@@@@@@@@@@@@@@
...@..........@@@@@@@@@@@@@@@@@@@@@@@@@@@@@@@@@@@@@@@@@@@@@@@@@@@@@
@@.@.........@@@@@@@@@@@@@@@@@@@@@@@@@@@@@@@@@@@@@@@@@@@@@@@@@@@@@@
@@@@.....@@@.@@@@@@@@@@@@@@@@@@@@@@@@@@@@@@@@@@@@@@@@@@@@@@@@@@@@@@
8
30 47 0
61 14 0
9 4 0
24 8 0
22 28 0
6 37 0
29 7 0
2 28 0

20 7 0
3 59 0
29 25 0
22 14 0
25 26 0
43 8 0
17 12 0
64 22 0
