width 67
height 67
@@@@......@@.@@@.@...@....@@@@@@@@@@@..........@@@@@@@@@@@@.......@
@@@@..........@@.....@@...@@@@@@@@@@@@@@.......@@@@@@@@@@..........
@@@............@...........@@@@@@@@@@@@@@...@...@@@@@..............
@..@.......................@@@@@@@@@@@@........@@@@@@..........@@..
......@..............@@....@@..@@@@@@@@@...@@@@@@@@@...........@...
.....................@.....@@..@@@@@@@@.....@@@@@@@@.....@.........
.....@...................@@@@....@@@@@......@@@@@@@@.......@.......
.................................@@.........@@@@@@@...@...@........
...............................@@@@.........@@@@@@........@........
.............@..@.........................@@@@@@..........@........
.......................@..................@@@@@..@@.......@@......@
.........@......@..................@...@..@@@.@@@@@@..............@
.........@....@....................@.@@@..@.@..@@@@@..............@
@......@@@@.......@............................@...@@.............@
......@@@@......@@@@..................@......@.@......@..........@.
@@....@@.........@@@..@...............@...@..@.......@........@..@.
@@@@...@.....@...@.@@@..@.....@..@.......@@..........@....@@..@@...
@@@@...@............@@@@@@.............@@@@..........@.............
@@@...................@@@..@.........................@.@...........
@@@....@..@..........@@@@@...............@............@@@......@...
@@........@@.........@@@@@.............@........@......@...........
@@........@@@.........@@@@......@...@..@........@@@....@@..........
@@....@@@@@@...........@@@.....@....@@@.@..@....@@@...........@....
@@.....@@@@@@............@...........@........@...................@
@@...@@@@@@@@...........@@....@@.......@@..........@..............@
.....@@@@@@@............@@..........@..............................
.....@@@@@@@.................@..........@................@.........
.....@@@@@@........@.....................................@.........
..@..@@.................@............@.............................
@@@...@..........@..........@@............@@@......................
.@.................@@......@@@..............@..@.@@@...@@...@......
......@......@.............@@@....@@..@@...............@@.........@
..........................@@@@@.................@.............@..@@
.....@@.@.@................@@@@....@...................@........@@@
.@..@@@...@@@................@@....@@..............................
.....@.................@........@@@@@............................@@
.....@...@@@.......@...@.............@...........................@@
.@...........@.....@..@@@..@.............@@@......................@
@.................@@.@@@@.......@....@..@......@......@..........@@
..@@..................@@............@@.......@......@.@.....@@..@@@
..@@.................@@..............@@@....@@@.......@...@@@@...@@
..@@....@....@.@@....@@.........@@..@@@@@@@..@@....................
.............@.@@.....@@@...@.@.@@...@@@@@@..@@...@................
............@@@@@@.....@@............@@@@...@@@@..@......@.........
............@@@@@@@@.@.@.............@..................@@@@..@@...
............@@@@@@@@..@@....................@@...@@@......@...@@...
@.............@@@@@@@@@@........@@@@.........@.....@......@......@@
@.............@@@@@@@@@@.........@@..@@@.......@..........@@....@@@
..............@@@@@@@@@..............@@...............@............
...............@@@@@@@......@...@....@.............................
..@....@@.....@@@@@@@@.....@@......@@@@........................@...
.@@@..@@......@@@@@@@.............@@@@@@@@@..@.....................
@@@@@@@@.......@@@.@..............@@..@@....................@...@..
@@@@@@@.........................@.....@@@..........................
@@@@@@@@@....................@........@@@.....@......@@............
@@@@@@@@@@...........................................@.....@.@.....
@@@@@@@@@@@............@.........................@@.@......@@....@.
@@@@@@@@@@@@@...........................@...........@.......@......
@@@@@@@@@............@......@@.......................@..@..@@......
@@@@@@@@.............@@.....@@@@..........@.............@@@......@.
@....@@...............................................@........@@@@
......@@...@.@.............@......@..@@......@@.@..............@@@@
.....@@@.....@............@..................@@..............@@@@@@
....@.@.....................@................................@@@@@@
.............@.................................................@@@@
.....@.............@@@......@....@@......@@....@@@.........@...@@@@
.....@..@@..@..@..@@@@.@...@@.@@.....@.........@@@@.......@@@.@@@@@
8
42 4 0
3 34 0
30 17 0
42 5 0
59 9 0
4 24 0
40 64 0
62 41 0

38 55 0
27 45 0
51 57 0
54 50 0
60 6 0
48 49 0
16 65 0
4 1 0
