width 67
height 67
@@@...@..........@...@@@@@@@@@..@@@...@@.......@@@@@@@@...@@@@@@@@@
@@....@@.@@.@@.....@.@@@@@@@@@.................@@@@@@@@....@@@@@@@@
@.........@.....@@.......@@@@@.................@@@@@.......@@@@@@@@
...@....@.@.....@@........@@.....................@@@........@..@@@@
...@@@........................................@................@@@@
...@@@..............@@@.......................@.............@....@@
...@@@.............................@..............@@.............@@
...................@......@........@@........@..................@@@
.............@..@..........................@.@.........@....@@@@@@@
@............@..@...@@...........@@.@.....@@@@........@......@@@@@@
.....@@@...........@@.....@@@.....@.......@@..........@..@@..@@@@@@
.....@@.....@......@......@@@@....@............................@@..
.....@@............@@..@@@@@@....@@@...@........@.@@.......@......@
......@............@@.....@@@......@@@@.....................@.@...@
.........@....@...@......@@@@@@@..@@@@@.........@.@@@@.............
.........@@...@@.........@@@@@@...@@@@@@........@.@@@@@@...........
....@....@@@@@@@......@..@@@@@@@@@@@@@@@@@......@@@@@@@@....@@....@
..@@@.....@@@@@@........@@@@@@@@@@@@@@@@@@.......@@@@@@@@.........@
......@..@@@@@@@........@@@@@@@@@@@@@@@@@@.......@@@@@@@@@@.......@
..@...@.....@@@@.......@@@@@@@@@@@@@@@@@@.........@@@@@@@@.......@@
@@@...@................@@@@@@@@@@@@@@@@@@@.........@@@..@@.....@.@@
@@@......................@@@@@@@@@@@@@@@@@@...@.....@@.......@.@@@@
@@@.......@....@..........@@@@@@@@@@@@@@@@@..................@@@@@@
@@@@......@...........@....@@@@@@@@@@@@@@@@@@...............@@@@@@@
@................@@@.@@....@@@@@@@@@@@@@@@@@@...............@@@@@@@
@..@.....@.......@@@@@@.....@@@@@@@@@@@@@@@@............@@@.@@@@@@@
@@@@..........@.@@@@@@@.....@@.@@@@@@@@............@....@@@.@@@@@@@
@@@@@.........@@@@@@@@@.....@..@@@@@@....@......@@....@@@@@@@@@@@@@
@@@@@@........@@@@@@@@@...@......@@@@...........@@@...@@@@@@@@@@@@@
@@@@@@....@...@@@@@@@..............@@...........@....@@@@@@@@@@@@@@
@@@@@@.........@@@@@...........@.....................@@@@@@@@@@@@@@
@@@@@...@......@@@@@....@.....@..@@...........@......@@@@@@@@@@@@@@
@@@@@@..........@@@@.....@...@@.@@@........................@@@@@@@@
@@.........@....@.....@@@@@@@@@@@@@.........................@@@@@@@
@......@...@@@@@@@.....@@@@@@@@@@@@@@.........@.............@@@@@@@
@........@.@@@@@@..@@..@@@@@@@@@@@@@@@@.@......@.@..........@@@@@@@
@..@..@....@@......@@.@@@@@@@@@@@@@@........@.........@@@@.@@@@@@@@
@@..@.@@..........@@@@@@@@@@@@@@@@@@..........@@@.....@@@@.@.@@@@@@
.................@@@@@@@@@@@@@@@@@@@@@........@.@.............@@@@@
.................@@@@@@@@@@@@@@@@@@@@@........................@@@@@
@@@..............@@@@@@@@@@@@@@@@@@@@@@...@..@......@@......@@@@@@@
..@@...........@.@@@@@@@@@@@@@@@@@@@@@@......@......@@.@@@@..@@@@@@
..................@@@@@@@@@@@@@@@@@@@@@@@..........@@@@@@@@......@@
...@...........@..@@@@@@@@@@@@@@@@@@@@@@@@............@@@@@......@@
.....@@..........@.@@@@@@@@@@@@@@@@@@@@@@@@@@.......@...@@@......@.
@...@@................@@@@@@@@@@@@@@@@@@@@@@@@.....@@..............
...@.@.........@......@@@@@@@@@@@@@@@@@@@@@@@@.....................
......................@@@@@@@@@@@@@@@@@@@@@@@@.....................
@@@..........@.......@@@@@@@@@@@@@@@@@@@@@@@@@.....................
@@@........@.....@@@@@@@@@@@@@@@@@@@@@@@@@@@@@@...................@
@.........@..@.....@@@@@@@@@@@@@@@@@@@@@@@@@@@@@......@............
@@@@......@......@@@@@@@@@@@@@@@@@@@@@@@@@@@@@@@...@@.@.........@@.
@@...............@@@@@@@@@@@@@@@@@@@@@@@@@@@@@@.................@@.
@@@@...@...........@@@@@@@@@@@@@@@@@@@@@@@@@@@@....@@..........@...
@@@@@@@...@........@@....@@.@@@@@@@@@@@@@@@@....@@.@.......@@@@...@
@@@@@@@@..@.......@@@.......@@@@@@@@@@@@@@.........@....@..@@@@.@.@
@@@@@@@@@..........@.@.......@@@..@@@@@@@@.........@......@@@@@@@@@
@@@@@@@@@@@..................@......@@@@@..........@@.........@@@@@
@@@@@@@@@@@...@...........@..........@@@@................@@@@.@@@@@
@@@@@@@@@@@@@............@@@@........@@.@........@.......@@@@.@@@@@
@@@@@@@@@@@@@@@..........@@@@.........@................@@@@@@@@@@@@
@@@@@@@@@@@@@@@@@@......@@@@@...............@@@........@@@@@@@@@@@@
@@@@@@@@@@@@@@@@@@.@@@@...@@..............@..@@.......@@@@@@@@@@@@@
@@@@@@@@@@@@@@@@@@@@@@@................................@@@@@@@@@@@@
@@@@@@@@@@@@@@@@@@@@@@@...................@@...........@@@@@@@@@@@@
@@@@@@@@@@@@@@@@@@@@@@@.@............@...........@......@@@@@@@@@@@
@@@@@@@@@@@@@@@@@@@@@@@@@............@@@.........@........@@@@@@@@@
8
32 7 0
52 25 0
53 43 0
18 59 0
14 8 0
29 10 0
65 54 0
42 37 0

40 63 0
46 18 0
58 37 0
33 2 0
43 12 0
36 31 0
12 20 0
5 7 0
