width 67
height 67
@@@@@@...@@@@@@@@@....@@..@@@@@@@@@@@@@@@@@@@@@@@@@@@@@@@@@@@@@@@@@
@@@@@@...@@@.@@@@@...@@.....@@@@@@@@@@@@@@@@@@@@@@@@@@@@@@@@@@@@@@@
@@@@@@...@@@................@@@@@@@@@@@@@@@@@@@@@@@@@@@@@@@@@@@@@@@
@@@......@@@..............@.@@@@@@..@@@@@@@@@@@@@@@@@@@@@@@@@@@@@@@
@@@@..............@@@.....@.@@@@@@..@@@@@@@@@@@@@@@@@@@@@@@@@@@@@@@
@@@@.......@..............@@@@@@@@...@@@@@@@@@@@@@@@@@@@@@@@@@@@@@@
@@@@@...@.........@@.......@@@@@@.....@@@@@@@@@@@@@@@@@@@@@@@@@@@@@
@@@@@@.....@..............@@@@@@@.........@@@@@@@@@@@@@@@@@@@@@@@@@
@@@@@@@..@@@.............@@@@@@@..@@.......@@@@@@@......@..@@@@@@@@
@@@@@....@@@@@.@.........@@@@@@@..........@@@@@@@@@...........@@@@@
@@@@....@@@@@..@...@.....@@@@@@..........@@@@@@@@@@@..........@.@@@
@@@@....@@@@...@.@......@@@.@@@@........@@@@@@@@@@@@.............@@
@@@@@..@@@@@..........@.....@@@@.........@@@@@@@@................@@
@@@@@@@@@@@@.......@........@@@@....@....@@@@@@@@....@...........@@
@@@@@@@@@@...........@@@@....@...........@@@@@@@@@......@.........@
@@@@@@@@..................................@@@@@@@.......@@........@
@@@@@@@@.................@.......@........@@@@@@@@......@@@........
@@@@@@@@@....@............@.............@..@@@@@@@.......@@........
@@@@@@@@@......@.....@@@@..................@@@@@@..................
@@@....@@............@@@@..@@@@..........@@@@@@@@..................
@.......@@...........@@@@.....@.........@@@@@@@.@..............@@@.
@.......@@......@.....@@......@..........@@@@@@................@@@@
........@.@...........@......@@@...........@@....@.............@@@@
@.......@.............@.......@@@@@..............@..@..@......@@@@@
...................@.......@@..@..........@.........@...@....@@@@@@
....@@@@..........@........@@.......................@..@@....@@@@@@
@...@@@@@...............@@@@@.........@@.....@...............@@@@@@
....@@@@@................@@..........@@@.@.........@@..@.....@@@@@@
...@@@@.@.......@..................@.@@@....................@@@@@@@
...@@@@...................@@@......@........@.......@....@..@@@@@@@
..@@@@@..........@@....................@............@@.@@@.....@@@@
..@@@@........@@@................@@...........@.@.......@......@@@@
...@@..............................@..........@@........@.......@@@
................@.......................@.......................@.@
................@@@@....@@@@@......................................
.................@@...@@@@@........................................
........@........@@............................@...................
......@@@.......................@@@....@.........@@.@.............@
..................@.......@.....@@@............................@.@@
...................@@.....@.....@@@..............................@@
...@....@...@...@..@@.....@..@..@@@..@.............................
................@.............@@@@@@@@@@@..@@..@@.....@...@........
.......@..@........................@....@@@@@@@@@....@@.@@........@
...............@........................@@@@@@@@@......@@@.......@@
@...........@......@@...@................@@@@@@........@@@......@@@
..@........................@.........@@..@@@@@@........@@@.......@@
.......................@...........@@@@@...@@@.......@@@@@.......@@
@...............@......@.............@@@@.........@@.@@..@..@...@@@
@@.....@@@.....@@...@...........@....@@@@@@@......@@.....@@@@@@....
@@@@@.@@@@...@..@....................@@@@@@.............@@@@@@@....
@@@@@.@@@@.........@.........@@@@...@@@@@@@.............@@.........
@@@@@@@@@@....................@@@@@@@@@@@@@.......@.....@@.........
@@@@@@@@@@.................@...@@@@@@@@@@@...@...@@..@.............
@@@@@@@@@@..............@@@@@...@@@@@@@@@....@.....................
@@@@@@@@@...............@@@.....@@@@@@@@@....@@....................
@@@@@@@.................@...@....@@@@@@@@..@@...........@@@......@.
@@@@@@@...........@@..............@@@@@@@..@@...........@@@.@@@@@@@
@@@@@@@............@..............@@@@@@@.@@..........@@@@@@@@@@@@@
@@@@@@@.......................@@@@@@@@@@@@@@..........@@@@@@@@@@@@@
@@@@@@@......................@@@@@.....@@@@@@.@@@.....@@@@@@@@@@@@@
@@............................@@@@@....@@@@@@@@@@.@@.@@@@@@@@@@@@@@
@@@...........@@@.......@.....@@@@@.....@@@@@@@@@@@@@@@@@@@@@@@@@@@
@@@@..........@@........................@@@@@@@@@@@@@@@@@@@@@@@@@@@
@@@@.........@@@......@...........@.....@@@@@@@@@@@@@@@@@@@@@@@@@@@
@@@.......@...@@......@@@@.............@@@@@@@@@@@@@@@@@@@@@@@@@@@@
@@@.......@@...@...@@.@@@@....@@.......@@@@@@@@@@@@@@@@@@@@@@@@@@@@
@@@@....@@@@@@@@@@@@@@@@...@....@......@@@@@@@@@@@@@@@@@@@@@@@@@@@@
8
1 30 0
26 55 0
10 29 0
35 3 0
20 60 0
8 24 0
14 4 0
4 47 0

61 53 0
45 59 0
3 36 0
38 7 0
58 13 0
28 23 0
62 55 0
4 48 0
