width 67
height 67
...@@@....@@@@.......@@@@@@@@@@@@@@@@@@@@@@....@@@@@@@@@@@@@@@@@@@@
..@@@@.@...@@@.......@@...@@@@@@@@@@@@@@@@.....@.@@@@@@@@@@.@@@@@@@
.....@..............@@....@@@@@@@@@@@@@@@@@@@@.@..@@@@@@@...@@@@@@@
.................@@@@@@...@@@@@@@@@@@@@@@@@@@@...@@@@@@@....@.@@@@@
.............@.@.@.@@@@....@@@@@@@@@@@..@@@@@@..@@@@@@@@......@@@@@
........@....@.....@@@@....@@@@@@@@@....@@@@@.....@@@@@.......@@@@@
.............@@..@............@@@@......@@@.@..@..............@@@@@
.............@...@@...@...@@@@@@@@..........@..................@@@@
.......@@........@@@......@@@@@@@@.....@.....@.................@@@@
.......@.@....@@@@@@@.....@@@@@@@@........................@.....@@@
@...@..........@@...@.....@@@@@@@@.............................@@@@
@@......@..@@............@@@@@@@@..........................@...@@@@
@@..@.............@......@@@@@@@@@@@@.....@@...............@...@@@@
@.................@@......@@@@@@@@@@..@@@@@@@@.....@........@.@@@@@
@.................@@......@@@@...@@@..@@@@@@@.................@@@@@
@.................@@.......@@@....@@@.@@@@@@@.................@@@@@
@@..@.....@@.........@.....@@@.@............................@..@.@@
@@@.@@@...........@@@@......@@.............@................@..@..@
@@@@@@@@@@@@....@..@...@....@.......@...@@@@......................@
@@@@@@..@@@@........................@@...@@@.........@@.....@......
@@@@@@......@.....@.......................@.@...............@......
@@@@@@..@...@................................@....@................
@@@@@........................@.................@................@..
@@@@@........................................@@@@.....@........@@@@
@@@@@...@.................@........@@@...........@....@@@@.....@@@@
@@@@@...............@........@@@@@@@@@..........@@.@...@@@....@.@@@
@@@@@...........@....@@@@..@@@@@@@@@@.....@....@@@.....@@.......@@@
@@@@...............@@@@@@@@@@@@@@@@@.......@@@...@.....@@......@@@@
@@@@@@@@@@........@@@@@@@@@@@@@@@@@@.................@......@..@@@@
@@@@@@@@@@........@@@@@@@@@@@@@@@@@@@.....................@@@@....@
@@@@@@@@@@........@@@@@@@@@@@@@@@@@@@@@..................@@@.......
@@@@@@@@@@.....@@@@@@@@@@@@@@@@@@@@@@@@@@...............@@@@.......
@@@@@@@@@@....@@@..@@@@@@@@@@.@@@@.@@@@@@............@@@@@@.....@..
@@@@@@@@...........@@@@@@@@@..@@@@..@@@...............@@@@@@@......
.....@@@.......@..@@@@@@@@@.....@...@@@...............@@@@@@@......
.....@.............@@@@@@@@.........@@.................@@@@@@......
...........@......@@@@@@@@..........@@@...................@@@......
.................@@@@.@@@.........@@@@..........@..........@@......
.................@..................@....@........@@......@@@@.....
@@...........................................@....@@@@.@@@@@@@@@...
@@...........................@...................@@@@@@@@@@@@@@@@.@
@.....@......@............@@@@@.......@@..........@@@@@@@@@@@@@@@@@
@..@...........@.....@...@@@@@.....@..@@@@@....@@@@@@@@@@@@@@@@@@@@
...@..............@...@..@@@@@@@@@....@@@@@@@@@@@@@@@@@@@@@@@@@@@@@
........@.........@........@@@@@@......@@@@@@@@@@@@@@@@@@@@@@@@@@@@
@..........................@@@@@@......@@@@@@@@@@@@@@@@@@@@@@@@@@@@
...................@..@......@@@@......@@@@@@@@@@@@@@@@@@@@@@@@@@@@
.........@.....@...........@...........@@@@@@@@@@@@@@@@@@@@@@@@@@@@
.........@...@@.......................@@@@@@@@@@@@@@@@@@@@@@@@@@@@@
@....................................@@@@@@@@@@@@@@@@@@@@@@@@@@@@@@
@........................................@@@@@@@@@@@@@@@@@@@@@@@@@@
............@..............@............@@@@@@@@@@@@@@@@@@@@@@@@@@@
......@............@..@..@@@...........@@@@@@@@@@@@@@@@@@@@@@@@@@@@
......@...........@@......@@.............@@@@@@@@@@@@@@@@@@@@@@@@@@
...@@@@@@.................@............@.@@@@@@@@@@@@@@@@@@@@@@@@@@
...@@@@@............@@..................@@@@@@@@@@@@@@@@@@@@@@@@@@@
@@@@@@@@@.@.........@@@@.................@@@@@@@@@@@@@@@@@@@@@@@@@@
@@@@@@@@@.@@@@...@..@@@@........@........@@@@@@@@@@@@@@@@@@@@@@@@@@
@@@@@@@@@@@@@@@@@@@@@@@@@@@..@..@........@@@@@@@@@@@@@@@@@@@@@@@@@@
@@@@@@@@@@@@@@@@@@@@@@@@@@@@@@@..........@@@@@@@@@@@@@@@@@@@@@@@@@@
@@@@@@@@@@@@@@@@@@@@@@@@@@@@@@@.@...@@@@@@@@@@@@@@@@@@@@@@@@@@@@@@@
@@@@@@@@@@@@@@@@@@@@@@@@@@@@@@@@@.@@@@@@@@@@@@@@@@@@@@@@@@@@@@@@@@@
@@@@@@@@@@@@@@@@@@@@@@@@@@@@@@@@@@@@@@@@@@@@@@@@@@@@@@@@@@@@@@@@@@@
@@@@@@@@@@@@@@@@@@@@@@@@@@@@@@@@@@@@@@@@@@@@@@@@@@@@@@@@@@@@@@@@@@@
@@@@@@@@@@@@@@@@@@@@@@@@@@@@@@@@@@@@@@@@@@@@@@@@@@@@@@@@@@@@@@@@@@@
@@@@@@@@@@@@@@@@@@@@@@@@@@@@@@@@@@@@@@@@@@@@@@@@@@@@@@@@@@@@@@@@@@@
@@@@@@@@@@@@@@@@@@@@@@@@@@@@@@@@@@@@@@@@@@@@@@@@@@@@@@@@@@@@@@@@@@@
8
14 18 0
1 43 0
57 13 0
62 10 0
17 41 0
35 41 0
25 23 0
6 7 0

39 58 0
2 2 0
23 21 0
17 22 0
20 13 0
39 29 0
14 57 0
24 11 0
