width 67
height 67
@@@@@@@@@@@@@@@@@@@@@@@@@...............@@@@....@@@@@@@.@....@@@@@@
@@@@@@@@@@@@@@@@@@@@@@@@@.........@.....@@@......@@@@@@.....@@@@@@@
@@@@@@@@@@@@@@@@@@@@@@@@...............@@@@.....@@@@@@@.....@@@@@@@
@@@@..@@@@@..@@@@@@..@@@...............@@.@@.....@@@@@@.....@@@@@@@
@@@@..@@@@@.....@@@..@@@............@.....@@.......@@@@......@@@@@@
@@@@...@@@...........@@@..@......@............@.@...@@@......@@@@@@
@@@@.................@@@.........@....................@......@@@@@@
@....................@..........@.....@......................@@@@@@
...........@@@.............@@...@...............@@..@@....@@@@@@@@.
...........@...@........@..@@...@@..................@@.....@....@@.
...............@..@.......@@....@@..............@...@@@............
..@@@............@@.......@@....@@@................@@@@@.........@@
..@@@............@@@......@@....@@.................@@@@@@........@@
......................@.........@@.................@@@@@..........@
.....................@@@.........@.............@.@@@@@@@...........
@....................@@@.....@.................@@@@@@@@......@@...@
@..................@...@.......@.....@@......@.@@@@@@@@@.....@@@.@@
@@.....................@....@..@....@@@......@...@@@@@@@.....@@@@@@
@@@@...@...........@.................@.......@...@@@@@@@@@....@@@@@
@@@@...@@@.........@...........@@@@.........@@....@@@@@@@@@@..@@@@@
@@@@...@@.............@...@....@@@@@@@@...........@@@@@@@@@@...@@@@
@@@@......................@....@@....@@...@.....@@@@@@@@@@........@
@@@@.........@............@...@@.....@@@@........@@@@@@@@@........@
.@@@.@.......@..........@....@@@@............@..@@@@@@@@@.........@
...@...........@............................@@..@@@@@@@@@@.......@@
...@..........................@@..........@.....@@@@@@@@@@@....@.@@
.@.@.....@.................@@@@@................@@@@@@@@@@@...@@@@@
........................@@@@@@@@@...@@...@......@@@@@@@@@@@@...@@@@
...............@....@...@@@@@@@@@@.....@@........@@@@@@@@@@@...@@@@
........@.............@@@@@@@@@@@@@....@@.......@@@@@@@@@@@@@..@@@@
......@@...............@@@@@@@@@@@@....@....@...@@@@@@@@@@@@..@@@@@
.........@.............@@@@@@@@@@@..............@@@@@@@@@@@@@@@@@@@
......@...............@@@@@@@@..@...............@@@@@@@@@@@@@@@@@@@
.....................@@@@@@@@...@................@@@@@@@@@@@@@@@@@@
....................@@@@@@@@@.....@@.........@@@@@@@@@@@@@@@@@@@@@@
@@..........@@.....@@@@@@@@@...@.......@.....@@@@@@@@@@@@@@@@@@@@@@
........@....@@......@@@@@@...................@@@@@@@@@@@@@@@@@@@@@
@....................@@.......................@@@@@@@@@@@@@@@@@@@@@
.....................@....@.........@.@....@..@@@@@@@@@@@@@@@@@@@@@
....................@..@..@@..@.......@@......@@@@@@@@@@@@@@@@@@@@@
....@.............@@@..@..@@..................@@@@@@@@@@@@@@@@@@@@@
......@@@@....@....@@..@..@...@..............@@@@@@@@@@@@@@@@@@@@@@
.......@@@....@..@.@..........@......@.@......@@@@@@@@@@@@@@@@@@@@@
........@@....@....@@................@@@.@...@@@@@@@@@@@@@@@@@@@@@@
...........@@....@@@@....................@....@@@@@@@@@@@@@@@@@@@@@
@@.........@@@.....@@.............@..........@@@@@@@@@@@@@@@@@@@@@@
@@........@@@@.....@...@@..@.....@@..........@@@@@@@@@@@@@@@@@@@@@@
@@.....@..@@@@@.......@@@@.......@@..........@.@@@@@@@@@@@@@@@@@@@@
@......@@.@@@@@@..........@@....................@@@@@@@@@@@@@@@@@@@
.......@@@@@@@@@@@@.......@@.....................@@@@@@@@@@@@@@@@@@
@@.....@@@@@@@@@@@@.......@@.....................@@@@@@@@@@@@@@@@@@
@@@@@@.@@@@@@@@@@@@@@.....@@...@........@@@..@..@@@@@@@@@@@@@@@@@@@
@@@@@@@@@@@@@@@@@@@.......@@............@@......@@.....@@@@@@@@@@@@
@@@@@@@@@@@@@@@@@@......@@..........@....@.@.......@..@..@@@@@@@@@@
@@@@@@@@@@@@@@@@@@@@....@@@........................@@@@....@@@@@@@@
@@@@@@@@@@@@@@@@@@@@..@..@@........................@..@..@@@@@@@@@@
@@@@@@@@@@@@@@@@@@...@@...........@........@.@.......@@@.@@@@@@@@@@
@@@@@@@@@@@@@@@@@@@.@......................@.............@@@@@@@@@@
@@@@@@@@@@@@@@@@@@@...................@..@.....@.........@@@@@@@@@@
@@@@@@@@@@@@@@@@@@@@.................@...@......@........@@@@@@@@@@
@@@@@@@@@@@@@@@@@@@@............@..@@@..........@.@@..@..@@@@@@@@@@
@@@@@@@@@@@@@@@@@@@@...........@@@@@@@@@@.........@...@....@@@@@@@@
@@@@@@@@@@@@@@@@@@@.......@@.@@@@@@@@@@@@@............@....@@@@@@@@
@@@@@@@@@@@@@@@@@@@..........@@@@@@@@@@@@@.....@.......@...@@@@@@@@
@@@@@@@@@@@@@@@@@@@@........@@@@@@@@@@@@@@@....@.......@..@@@@@@@@@
@@@@@@@@@@@@@@@@@@@@@.......@@@@@@@@@@@@@@@@..@@..........@@@@@@@@@
@@@@@@@@@@@@@@@@@@@@@@.......@@@@@@@@@@@@@@@.@@@@.....@...@@@@@@@@@
8
27 18 0
16 14 0
45 20 0
29 60 0
7 13 0
30 46 0
6 16 0
47 8 0

48 55 0
14 31 0
43 20 0
60 21 0
19 28 0
5 32 0
26 23 0
65 21 0
