width 20
height 11
..........@@@@...@.@
@...@.......@@......
.......@.....@......
....................
....................
....@...........@...
............@.......
.........@......@...
...@.@..............
..........@...@....@
..................@@
6
10 7 0
2 0 0
0 9 0
18 5 1
1 1 1
6 0 1

0 0 0
15 8 0
14 0 0
11 7 1
3 5 1
4 0 1
