width 20
height 11
................@@@@
......@..@......@@@@
....@.............@@
..@.....@.....@...@@
.........@.@........
.................@..
.........@....@.....
....@..@.......@....
...........@........
.....@.............@
@@..................
6
4 4 0
12 0 0
3 10 0
6 5 1
2 7 1
16 9 1

11 6 0
13 1 0
8 7 0
18 9 1
10 9 1
0 7 1
