width 20
height 11
...@............@@..
.................@..
....@........@......
.....@...@.....@....
...@....@@@...@.@...
..@.................
.....@....@..@......
................@.@.
......@...@..@......
...@................
...@.....@..........
6
12 6 0
10 1 0
15 7 0
4 6 1
6 2 1
9 6 1

0 7 0
12 9 0
15 7 0
1 5 1
19 5 1
6 3 1
