width 20
height 11
@@@@.....@@@@.......
.........@@@@...@...
@@.......@@@........
.........@.....@....
..............@.....
..@........@.@.....@
....@...@.......@...
....................
....................
.....@..............
.......@.......@@@@.
6
13 6 0
15 4 0
6 4 0
18 0 1
10 5 1
17 1 1

0 1 0
1 1 0
0 6 0
15 1 1
10 5 1
13 1 1
