width 69
height 69
@@@@@@@@@@@@@@@@@@@@@@@@@@@@@@@@@@@@@@@@@@@@@@@@@@@@@@@@...@@@@@.....
@@@@@@@@@@@@@@@@@@@@@@@@@@@@@@@@@@@@@@@@@@@@@@@@@..@@@@@..@..@@@.....
@@@@@@@@@@@@@@@@@@@@@@@@@@@@@@@@@@@@@@@@@@@@@@@@@..@@@@@......@@.....
@@@@@@@@@@@@@@@@@@@@@@@@@@@@@@@@@@@@@@@@@@@@@@@.....@@@...@....@@....
@@@@@@@@@@@@@@@@@@@@@@@@@@@@@@@@@@@@@@@@@@@..@@...@...@...@.@...@....
@@@@@@@@@@@@@@@@@@@@@@@@@@@@@@@@@@@@@@@@@@@..............@@.....@.@..
@@@@@@@@@@@@@@@@@@@@@@@@@@@@@...@@@@@@@@@@@...........@@.@@@....@...@
@@@@@@@@@@@@@@@@@@@@@@@@@@@........@@@@@@@.............@@@@@........@
@@@@@@@@@@@@@@@@@@@@@@@@@@.......@.....@@..............@@@@@.........
@@@@@@@@@@@@@@@@@@@@@@@@@@@............@.......@..........@@........@
@@@@@@@@@@@@@@@@@@@@@@@@@@@@..@@@..@...........@@.@...@.....@..@....@
@@@@@@@@@@@@@@@@@@@@@@@@@@@@@.@@....@..........@@.@.............@..@@
@@@@@@@@@@@@@@@@@@@@@@@@@@@@@@@@.......@@......@@..........@.......@@
@@@@@@@@@@@@@@@@@@@@@@@@@@@@@@@@@...........@..@@..........@....@...@
@@@@@@@@@@@@@@@@@@@@@@@@.@@@@@@@@@@@........@..@......@..@@@....@@@@@
@@@@@@@@@@@@@@@@@@@@@@@@.@@@@@@@@@@@@@...................@........@@.
@@@@@@@@@@@@@@@@@@@@@@@....@@@....@@.......@.......@............@....
@@@@@@@@@@@@@@@@@@@@@@@@..........@.................@@@..............
@@@@@@@@@@@@@@@@@@@@@@@@@@@...................@@@@@..@@@............@
@@@@@@@@@@@@@@@@@@@@@@@@@@@....................@@@...@@@......@....@@
@@@@@@@@@@@@@@@@@@@@@@@@@@@@@..........@@@@...@@@@...............@.@@
@@@@@@@@@@@@@@@@@@@@@@@@@@@............@@@@.....@@............@....@@
@@@@@@@@@@@@@@@@@@@@@@@@@@@.....@......@@@@....@@@@..@..........@@...
@@@@@@@@@@@@@@@@@@@..@@@@@................@@...@@@..@@....@@....@@...
..@@@@.........@@@...@@@@...@......@@.....@@@@..@@@.@@....@@@........
@......................@.........@@@@@..@@@@@@@.@@@@@@@@@@@@@@.....@@
@@............@.................@@@@@@..@@@@@@@@@@@@@@@@@@@@@@.......
@@...........@.........@.....@..@..@@@..@@@@@@@@@@@@@@@@@@@@@......@@
@@...........................@......@@.@@@@@@@@@@@@@@@@@@@@@@......@@
@@.@...................................@@@@@@@@@@@@@@@@@@@@@@......@@
@@..@.............................@....@@@@@@@@@@@@@@@@@@@@@.......@@
@@........@.....@........................@@@@@@@@@@@@@@@@@@@.......@@
@...............@@@..............@.@@@...@@@@@@@@@@@...@@@@.......@@@
@........@......@@...............@..@@@...@@@@@@@@@@@...@.........@@@
..................@............@.@.......@@@@@@@@@@@...............@@
..............@@@..............@...........@@@@@@@@@@......@.......@@
....@......@...@@.......@......@..........@@@.@@@@@@..@@@..@.......@@
...............@@.............................@@@@@@..@@...@......@@@
........................@@@...................@@@@@@.......@........@
.@.......................@@@...............@.........................
@@@............@...@.......@.........................................
@@............@@.@@@@..........................................@.@@..
@@............@@@@@@@...................................@.......@....
@@...........@@@@@@@@...............@......@@...........@.......@...@
@@............@@@@@@@...............@......@...............@...@.....
@@@..........@@...@@@......@.@@..@.........@..........@..........@...
@@@@...@@...@@@...@@@@@......@@.......................@.......@......
@@@@@@.@@@@@@@@...@@@@@.@...........@....@..........@.@.......@@@@...
@@@@@@@@@@@@@@@...@@....@.....................................@@.....
@@@@@@@@..@@@.....@@....@.....................................@......
@@@@@@@@...@@....@@.......................@..........@....@@.........
@@@@@@@@.........@......@........@.........@...............@.........
@@@@@@@@@.....................@@@..............@...........@@....@...
@@@@@@@@..@...............@..@@@@@.......@@..@@.......@....@@@@......
@@@@@.....@...................@......@.....................@@........
@@@@@.................@.............@@@@@@@@........@@.....@........@
@@@@@..........@.......@@.................@@@...@.............@......
@@@.........@..........@....@...@@...@......@@................@......
@@@.........@...................@@..........@.......@@@....@........@
@@@..@@@@...............@.......@@...................@......@......@@
@@@..@@@@.....@...@@@@...........@..@@........................@@....@
@@@@..@@@..@@@@.@@@@@................@......@....@...@.............@@
@@@@.@@@..@@@@@@@@@@.........@..........................@............
@@@@.@@@@.@@@@@@@.................@@@...@.......@.......@..........@.
@@@@.@@@@@@@@@@@@...........@@@..@@@@...@@............@..............
@@@@@@@@@@@@@@@@@...........@@@@@@@@@...@@@...........@..............
@@@@@@@@@@@@@@@@...........@@@@@@@@@@..@@@@........@..@..........@..@
@@@@@@@@@@@@@@@@@..........@@@@@@@@@@@@@@@@......................@@.@
@@@@@@@@@@@@@@@@...........@@@@@@@@@@@@@@@@@.............@@.........@
8
41 33 0
53 32 0
66 34 0
25 68 0
22 61 0
19 63 0
46 10 0
46 63 0

59 48 0
52 34 0
1 34 0
37 62 0
61 16 0
56 4 0
11 56 0
62 15 0
