width 69
height 69
...@@@...@@@@@@@............@@@......@.....@@@@@@@@@@@@@@@@@@@@@@@@@@
........@@@@@@@@............@@@@..@.@.....@@@@@@@@@@@@@@@@@@@@@@@@@@@
........@@@@@@@@............@@@@........@@@@@@@@@@@@@@@@@@@@@@@@@@@@@
........@@@@@@@.........................@@@@@@@@@@@@@@@@@@@@@@@@@@@@@
.....@.....@...........@@@...............@@@@@@@@@@@@@@@@@@@@@@@@@@@@
...............@........@@@@....@@..@@...@@@@@@@@@@@@@@@@@@@@@@@@@@@@
...@..................@.........@@........@@@@@@@@@@@@@@@@@@@@@@@@@@@
@@@@@.....................................@@@@@@@@@@@@@@@@@@@@@@@@@@@
@@@@@.....................................@@@@@@@@@@@@@@@@@@@@@@@@@@@
@.@@@........@@.....................@....@@@@@@@@@@@@@@@@@@@@@@@@@@@@
..@@@........@...........@@....@........@@@@@@@@@@@@@@@@@@@@@@@@@@@@@
..@@@@...@..........@..........@...@....@@@@@@@@@@@@@@@@@@@@@@@@@@@@@
..@@@@..@@@@........@....................@@@@@@@@@@@@@@@@@@@@@@@@@@@@
.@@@....@@@@@.......@...@......@.............@@@@@@@@@@@@@@@@@@@@@@@@
..@@.....@@......@...........................@@@@@@@@@@@@@@@@@@@@@@@@
......@@@@@................@..................@@@@@@@@@@@@@@@@@@@@@@@
......@@@@@@@@@@@@@..@@@.......@..............@@@@@@@@@@@@@@@@@@@@@@@
.....@@@@@@@@@@@@@@.@@@@.....@.@.@..@......@....@@@@@@@@@@@@@@@@@@@@@
..@..@@@@@@@@@@@@@@@@@@@...........@@......@.........@@@@@@@@@@@@@@@@
......@@@@@@@@@@@@@@@@@@...........@@.................@@@@@@@@@@@@@@@
.......@@@@@@@@@@@@@@@@@...........@@@.................@@@@@@@@@@@@@@
......@@@@.@@@@@@...@@@@......@......@.@@@.............@@@@@@@@@@@@@@
............@@@@....@@@@..............@@@@...............@@@@@@@@@@@@
......@@....@@@@....@@@@..............@@@@...@...........@@@@@@@@@@@@
.@@@...........@.............@@@.......@@@....@.@@........@@@@@@@@@@@
@@@@...........@.@.....@.@@..@@@.........@.....@............@@@@@@@@@
@@@..............@...@.......@........@.....@.@@@@@..........@@@@@@@@
@@.............@@@............................@@@@@..@@@.....@@@@@@@@
......@@........@@.@@@......@................@@@.@@@@@@@.....@@@@@@@@
@......@........@@@.@@....@@.....................@@@@@@@@....@@@@@@@@
..............@..........@@@...........@.........@@@@@@@@@......@@@@.
........@.......@........@@............@.......@.@@@@@@@@@@......@...
......@@..................@....................@@@@@@@@@@@@.....@@...
................@@.....@........@..............@@@@@@@@@@@@@.....@...
.........@.........@...@.......@@@.............@@@@@@@@@@@@@..@......
.............@@....@...@......@.......@...@...@@@@@@@@@@@@@@.........
...@@....@............@..............@@...@....@@@@@@@@@@@@.......@@@
.@..@@...........................@@...@........@@@@@@@@@@@@@.....@@@@
...........@@.........................@....@@@.@@@@@@@@@@@@......@...
........@@................@@@..........@...@@..@@@@@@@@@@@@@@........
..................@@.....@@@@..........@@@@@@.@@@@@@@@@@@@@@@........
.@@...............@......@@@........@..@.@@@@@@@@@@@@@@@@@@@@.......@
@@@@@..........@@.........@@.............@@@@@@@@@@@@@@@@@@@@......@@
@@@@@......@.@......@....@....@........@@@@@@@@@@@@@@@@@@@@@@........
@@@@@@@@@..@...@......@..@@.............@@@@@@@@@@@@@@@@@@@@@........
@@@@@@@@@@..@............@@.......@........@@@@@@@@..@@@@@@@@.......@
@@@@@@@@@@.......................@@@......@@@@@@@.@...@@@@@@@@@@....@
@@@@@@@@@......@....................@.....@@.@@@@.....@@@@@@@@@.....@
@@@@@@@@@......@@...@....@..........@@@...@..@@........@@@@@@@@.....@
@@@@@@@@@.......@@..@@.......@@@........@..............@.........@@.@
@@@@@@@@@@@@@@@@@@.@@@........@@........@.......@........@......@@@@@
@@@@@@@@@@@@@@@@@@.@@@......@@@@.......@@@@..............@....@.@@@@@
@@@@@@@@@@@@@@@@@@.@...@...............@@@@................@..@...@@.
@@@@@@@@@@@@@@@@@............@@.........@@@................@.........
@@@@@@@@@@@@@@@@@............@@.........@@...........................
@@@@@@@@@@@@@@@@@@.......................................@@....@.....
@@@@@@@@@@@@@@@@............@@@.....@.@..................@@..........
@@@@@@@@@@@@@@......................@@@................@@@@@@@@@@@@..
@@@@@@@@@@@@@@..........@.............@@.......@@@@@@@.@@@@@@@@@@@@@@
@@@@@@@@@@@@@@@..............................@.@@@@@@@@@@@@@@@@@@@@@@
@@@@@@@@@@@@@@@................................@@@@@@@@@@@@@@@@@@@@@@
@@@@@@@@@@@@@@@.............@......@...........@@@@@@@@@@@@@@@@@@@@@@
@@@@@@@@@@@@@@@...@@................@..........@@@@@@@@@@@@@@@@@@@@@@
@@@@@@@@@@@@@@@@@.@@...........................@@@@@@@@@@@@@@@@@@@@@@
@@@@@@@@@@@@@@@@@@@@..........@..............@...@@@@@@@@@@@@@@@@@@@@
@@@@@@@@@@@@@@@@@@@@@@......@@...............@...@@@@@@@@@@@@@@@@@@@@
@@@@@@@@@@@@@@@@@@@@@@.........................@@@@@@@@@@@@@@@@@@@@@@
@@@@@@@@@@@@@@@@@@@@@@..@.....@...@...........@@@@@@@@@@@@@@@@@@@@@@@
@@@@@@@@@@@@@@@@@@@@@@@....@......@@@.....@@..@@@@@@@@@@@@@@@@@@@@@@@
8
36 30 0
44 55 0
20 2 0
41 39 0
49 55 0
45 51 0
16 46 0
16 5 0

20 63 0
48 18 0
35 6 0
40 45 0
1 11 0
17 8 0
14 15 0
0 2 0
