width 69
height 69
@@@......@..@@@@@@@@@@@.....@@@@@@@@.......@@@@@@...@.......@@@....@@
@@@...........@@@@@@@@@.....@@@@@@..........@@@@.......@...........@@
@@@@.........@@@@@@@@@@........@@@....@.....@@@@.......@@.......@..@@
@@@@@.........@@@@@@@..........@@............@.@.......@.......@@@@@@
@@@@@..........@@@@@@.....@...........................@@@........@@@@
@@@@@.........@@.@@@......@..@....................@@@@@@@...@@@@@@@@@
@@@@.............@@@....@.@.......................@@@.@@@@...@@@@@..@
..@@..@...........@@....@..........@..................@@@@...@@@@....
..................@@...............@@@........@......................
...@....@........@@@...@...........@@@.......@@...................@@@
............@.....@@@.@@@...........@@.@@........................@@@@
........@...@@@@..@@@@@@.....@.......@@@@.......@.......@..........@@
.....@@....@@@@@..@@.@@......@@.......@@@....@..@.......@@@........@@
......@..@.@@.....@..@.......@........@@@...@@..@.......@@...........
............@......@..................@@@@@..@@......................
........@..@@@@@@@...@..@@@.....@............@@.....@................
..........@@@@.@.@........@.@@...@..................@@@..@..@.@......
...@.......@@....@@@........@@......@@...............................
@..@......@@@......@.......@@.@....@@@...@...........@@@......@@@@...
@@.@......@@@@..@...........@.........@@@@........@...@@.....@@@@@@@@
@.........@@@@@.......................@@@@@............@@....@@@@@@@@
@.........@@@@@@@..............@......@@@@@..........@@@@@@@@@@@..@@@
@..........@@@@@@.....................@@@@@@@@.......@@@@@@@@@.....@@
@@.....@...@.@@.@....@@@@@@@@....@@......@..........@@@@@@@@@.......@
@@...................@@@@@@@@@@@.@@@..@..@@.@.......@@@@@@@@.........
@@.................@.@@@@@@.@.@..@@@..@.....@@......@@@@@@@@@........
.......@.......@.....@@@@@@.@......@..@....@@@....@.@.@@@@@..........
......@@@...........@@@@@@@.@..............@@@........@@..@..........
..@@@@@@...@@.......@@@@@..........@........@@..@.....@@...@@........
@@@@@@@@...@@.......@@@@@..........@.......@....@.@..................
@@@@@@@@.@@@@@@......@@@@@........................@.....@............
@@@@@@@@@@@@@@@.............................@.........@..............
@@@@@@@@@@@@@@@@@....@........@.............@......@....@............
@@@@@@@@@@@@@@@..................@....................@..........@...
@@@@@@@@@@@@@@@.....@..........@.....................................
@@@@@@@@@@@@@@@..........................@@.......@@@................
@@@@@@@@@@@@@@@@@..@.............@.................@.................
@@@@@@@@@@@@@@@@@.............@..@@@..@.........@.....@..............
@@@@@@@@@@@@@@@@@................@@@.............@...................
@@@@@@@@@@@@@@@@.....@...........@.@@......@.................@.......
@@@@@@@@@@@@@@@@............@.......@.@...@@..........@@.@..........@
@@@@@@@@@@@@@@@@............@@...........@@@@@.@......@@.@..........@
@@@@@@@@@@@@@@@@@..........@@@.........@...@@@.......@@@.............
@@@@@@@@@@@@@@@@@@@@@@.....@@@...............@@......@@@.........@.@@
@@@@@@@@@@@@@@@@@@@@@.......@................@@@....@@@@...@.....@@@@
@@@@@@@@@@@@@@....@@@....@...........@.........@..@@@@@@...@......@@@
@@@@@@@@@@@@@@...@@@@.@.......@..........@.....@...@..........@...@@@
@@@@@@@@@@@@@.......@.@..................@.......................@@@.
@@@@@@@@@@........@...@..............@@...@....................@..@..
@@@@@@@@@...........................@@@...@...............@...@@.....
@@@@@@@@@@@.......................@@@@.........@@....................
@@@@@@@@@@@..@...............@@...@@@@..........@...........@....@...
@@@@@@@@@.............@......@@@...@@........@@......@........@......
@@@@@@...................@@@@@@@@@@@@@......@@...@..@@...............
@@@@@....................@@@@@@@@@@@@@@..@@...............@..........
@@@@@@......@........@@@.@@@@@@.@.@@@@@..@@...@.....................@
@@@@........@.....@@@@@@....@@.....@@....@....@@.............@@.....@
@@@@........@..@.....@@@....@@...............................@@@@....
@@@@...........................................................@@@...
@@@@@@@...................@@....@.......@@@@..................@@@@@.@
@@@@@@@.......@..@.@......@@@@@..........@@............@@@@@@@@@@@@@@
@@@@@@@@@@@..@@.....@....@@@@@@...........@@@.......@@@@@@@@@@@@@@@@@
@@@@@@@@@.@.@@@.....@.....@@@@@@............@.......@@@@@@@@@@@@@@@@@
@@@@@@@@....@@@...........@@@.@@@@@.............@@@@@@@@@@@@@@@@@@@@@
@@@@@@@@@.....................@@@@..........@@@@@@@@@@@@@@@@@@@@@@@@@
@@@@@@@@@@@.....@...@.........@@@@................@@@@@@@@@@@@@@@@@@@
@@@@@@@@@@@..........@@@@@@...@@@@@@............@@@@@@@@@@@@@@@@@@@@@
@@@@@@@@@@....@@.....@@@@@@...@@@@@@@........@.@@@@@@@@@@@@@@@@@@@@@@
@@@@@@@@@@@...@...@..@@@@@@@...@@@@@@....@......@@@@@@@@@@@@@@@@@@@@@
8
13 18 0
31 48 0
33 13 0
42 25 0
63 13 0
59 47 0
27 31 0
23 58 0

20 31 0
36 22 0
33 12 0
5 57 0
17 52 0
18 21 0
25 41 0
31 18 0
