width 61
height 61
@@@@@@@@@@@@@@@@@@@@@@@@@@@@@@..@.@@@.....@.....@@@..@@.....@
@@@@@@@@@@@@@@@@@@@@@@@@@@@@@@....@.............@..........@@
@@@@@@@@@@@@@@@@@@@@@@@@@@@@@@@...@.@@..@....................
@@@@@@@@@@@@@@@@@@@@@@@@@@@@......@.@@@...@..................
@@@@@@@@@@@@@@@@@@@@@@@@@......@..........@......@..........@
@@@@@@@@@@@@@@@@@@@..@@@@.......................@@.........@@
@@@@@@@@@@@@@@@@@@....@@.....@......@@@@..@................@@
@@@@@@@@@@@@@@@..@@.................@@@@..@..................
@@@@@@@@@@@@@@@..............@@.....@@...@@@@........@.@@....
@@@@@@@@@@@@.@@.........@@..................@..@........@....
@@@@@@@@@@@..........................@.......................
@@@@@@@....................@@@@...@@@@@@...........@...@....@
@@@@@.....@..........@@..@@@@@@@@@@@@@@@@...@@..............@
@@@@@..@...........@@@@@..@@@@@@@@@@@@.@.....................
@@@@@..@@.........@@@@@@@@@@@@@@@@@@@@.......................
@@@@@......@@.....@@@@@@@@@@@@@@@@@@@@..............@...@....
@@@@@......@......@@@@@@@@@@@@@@@@@@@@............@....@.....
@@@@.....@@@.......@@@@@@@@@@@@@@@@@@@.................@....@
@@@@@................@@@@@@@@@@@@@...................@@@@...@
@@@@.......@............@@@.@@...................@...@@@@@@.@
.@@.....................@@@.@@..........................@@@@@
....................@@@.@@@...............@@...........@@@@@@
......@.............@@@@@@@@...............@.........@...@@@@
@@@@.....@..........@..@@@@@..............................@@@
.@.@...................@@@@@.....@.....@....@...@@....@...@.@
...............@.@......@@@@.....@@........@..@.......@......
.................................@@...................@......
.............@...@@.....................@....................
............@@@..@@.........................@......@.........
......@.....@.....@..................@@@.....................
....@@@@@.........................@@.@@@@..............@.....
...@@@@@@@@@@...............@@....@..@....@..................
...@@@@@@@@@@....@........@.@@..@@@..........................
@..@@@@...................@@@..@@@@..........................
@..@@@......@..............@@....@@......@........@@@@@@.....
@..@@@....@@@.............@@.....@....@@.........@@@@@@@@@...
..........@@@..........@@@@@.....@...@@@@@@@.......@@@@@@@...
....@..@...................@............@@@@.....@@@.@@@.@...
@@..@@......@@....@.@...................@@@@....@@@@..@@.....
....@.......@@.@............@............@.......@@..........
...................@@.......@.....................@@@@@..@@..
@.......@@.........@@...@@........................@@@@@..@@@.
.....@@@@@.......@@...................@.......@..@@@@@@...@@@
@...@@@@@@.......@@.@@.........@...@..@..........@@@@@@@@@@@@
@.....@@..........@........@..@@......@..........@@@@@@@@@@@@
@.............................@@.........@.........@@@@@@@@@@
..............................@@.........@.........@@@@@@@@@@
..........................@...@..........@@.@@.....@@@@@@@@@@
.....................@@..................@..@@....@@@@@@@@@@@
.@.............@@.....@...................@@@@@@@@@@@@@@@@@@@
@@.................@.......@@.............@@@@@@@@@@@@@@@@@@@
@@@@......@.............................@@@@@@@@@@@@@@@@@@@@@
@@@@@.....@@............@@.............@@@@@@@@@@@@@@@@@@@@@@
@@@@@@@....@.@.@........@@@@.....@.....@@@@@@@@@@@@@@@@@@@@@@
@@@@@@@.@..@@@...................@@..@@@@@@@@@@@@@@@@@@@@@@@@
@@@@@@@@@@@@@@@.............@@@..@.@@@@@@@@@@@@@@@@@@@@@@@@@@
@@@@@@@@@@@@@..........@.........@..@@@@@@@@@@@@@@@@@@@@@@@@@
@@@@@@@@@@.@....@@@..........@.......@@@@@@@@@@@@@@@@@@@@@@@@
@@@@@@@@@.......@@@.........@@.......@@@@@@@@@@@@@@@@@@@@@@@@
@@@@@@@@@..@....@@@@@@@...........@@@@@@@@@@@@@@@@@@@@@@@@@@@
@@@@@@@@@@@@.@..@@@@@@@@..........@@@@@@@@@@@@@@@@@@@@@@@@@@@
8
6 46 0
25 59 0
34 28 0
15 13 0
6 48 0
36 31 0
20 31 0
48 34 0

47 2 0
58 13 0
35 25 0
58 37 0
54 12 0
16 14 0
40 1 0
46 18 0
