width 61
height 61
@@@@@..@@@.......@@..@.......@@@@@@@@@@@.......@@......@...@@
@@@@@..@@.......@@@..........@@@@@@.@..@...................@@
@............@@@@@@...........@@@@@.......................@@@
@....@...@@@@@@@@@@.......@@@@@@....@..@.................@@@@
.....@...@@@@@@@@@...........@@@...@@....@...............@@@@
@.......@@@@@@@@.@......@@..................@............@@@@
....@@@@@@@@@@@................@@@..........@@...........@@@@
.....@.......@@...................@.@.......@.........@@.@@@@
@..@.......@@@@.@.........@......@@...................@.....@
...@........@@...................@@@@........................
.............@............@........@@@.....................@.
.....................@..@..@@................................
...........@@.............@@@.........@......................
@@..........@@...........@@@@..............@@.....@.........@
@@@..........@............@@@@@.....@@.....@@@@@......@.....@
@@@.......................@@@@@.....@@@.....@.@@...@......@.@
@@@................@@...............@@@...@...............@..
@@...@@.........@...@@..............@@@...........@.......@..
@............@......@@........@....@@@..................@..@@
@@@.........@@@....................@@@@........@........@..@@
@@@.@@........@@@......@............@@@.........@@@.....@@@@@
@@@.@@................@@.....@.......@@.......@@@@@@....@@@@@
@@@@@@@.....@@@....@..........................@@@@......@@@@@
@@@@@@@.....@@@.@@@@.............@.@..........@.........@@@@@
@@@@@@@....@@@@@@@@@...@@..............@......@@........@@@@@
@@@@@@@....@@@@@@@@@...@@@.......@.............@......@@@....
@@@.@@@.....@@@@@@.@.@..@@@.........@..........@@@..@@....@..
@@@..@@....@@@@@@....@..@@@..................................
@@@.........@..................@.........@....@@.....@.......
@@@...........@..@.@.@.........@.......@@@..................@
@@@..@........@....@.@@@..........@@@....@..@....@..........@
@@@................@@@@@.......@..@@@.@.....................@
@@@.@...@......@.......@..................@@...........@.@@@@
@@@@...........@.....................@...................@@..
@@@@.....@.....@@......@...............................@.@@..
@@@@............@........@.............................@.....
@@...@........@@@.............@@...@.........................
@@..........................@@...............................
@@........@.................@................................
@@........@..@.................@.............@.....@@@.......
@@........@.@................@@@@......@@...........@.@......
@.....@@..@@@@.................@@....@................@@@@@..
......@..@@@@@..@...........@@@@@@.....@...............@@@...
.@.@.....@@@@@@@@@......@@....@@@@.....@@........@@@...@.....
....@..@@@@@@@@@@@@@....@@@@@@@@@@.@...@........@@@@@@@......
.......@@@@@@@@@@@.....@@@@@@@@@@@..............@@@@@@@......
.......@@@@@@@@@@@@.....@@@@@@@@@@@.........@.@@@@@@@@@......
..@....@@@@@@@@@@@@.....@@@@@@@@@@...@@..@@@@@@@@@@@@@@.....@
..@...@@@@@@@@@@@@@....@@@@@@@@@@@@@@@@..@@@@@@@@@@@@@@.....@
.....@@@@@@@@@@@@@@@..@@@@@@@@@@@@@@@@@..@@@@@@@@@@@@@......@
.....@@@@@@@@@@@@@@@.@@@@@@@@@@@@@@@@@@@@@@@@@@@@@@@@@..@....
@@....@@@@@@@@@@@@@@..@@@@@@@@@@@@@@@@@@@@@@@@@@@@@@@@......@
@@....@@@@@@@@@@@@@...@@@@@@@@@@@@@@@@@@@@@@@@@@@@@@.........
@@@@.@@@@@@@@@@@@@@....@@@@@@@@@@@@@@@@@@@@@@@@@@@@..........
@@@@@@@@@@@@@@@@@@@@...@@@@@@@@@@@@@@@@@@@@@@@@@@...........@
@@@@@@@@@@@@@@@@@@@@...@@@@@@@@@@@@@@@@@@@@@@@@@......@....@@
@@@@@@@@@@@@@@@@@@@.......@@@@@@@@@@@@@@@@@@@@@@@..........@@
@@@@@@@@@@@@@@@@@@@.....@@@@@@@@@@@@@@@@@@@@@@@@@@.....@....@
@@@@@@@@@@@@@@@@@......@@@@@@@@@@@@@@@@@@@@@@@@@@............
@@@@@@@@@@@@@@@@......@@@@@@@@@@@@@@@@@@@@@@@@@@@............
@@@@@@@@@@@@@@@@@..@@@@@@@@@@@@@@@@@@@@@@@@@@@@@..........@@@
8
6 21 0
55 27 0
55 47 0
43 5 0
41 2 0
53 33 0
8 30 0
57 17 0

52 42 0
39 36 0
59 52 0
18 36 0
26 4 0
9 11 0
44 26 0
35 17 0
