width 61
height 61
@@@@@@@@@@@@@@@@@@@@@@@@@@@@@@@@@@@@@@@@@@@@@@.......@@....@@
@@@@@@@@@@@@@@@@@@@@@@@@@@@@@@@@@@@@@@@@@@@@@@@@......@....@@
@@@@@@@@@@@@@@@@@@@@@@@@@@@@@@@@@@@@@@@@@@@@@@@@..@@......@@@
@@@@@@@@@@@@@@@@@@@@@@@@@@@@@@@@@@@@@@@@@@@@@@@@.............
@@@@@@@@@@@@@@@@@@@@@@@@@@@@@@@@@@@....@@@.@@@@..............
@@@@@@@@@@@@@@@@@@@@@@@@@@@@@@@@@@.........@@@............@@.
@@@@@....@@@@@@@@@@@@@@@@@@@@@@@@@...........@@..............
@.........@@@@@@@@@@@@@@@@@@@@@@@........@@..@@@.............
...@...@.@@@@@@@@@@@@@@@@@@@@@.......@@@.....@.........@@@...
.........@@@@@@@@@@@@@@@@@@@@@.......@@...........@@@.@@@....
@.......@@@@@@@@@@@@@@@@@@@@@@@.....@@@...........@@..@@....@
@......@@@@@@@@@@@@@@@@@@@@@@@......@.@@..............@@@....
@@.....@@@@@@@@@@@@@@@@@@@@@@..........................@@.@..
@@@....@@@@@@@@@@@@@@@@@@@@@@@@..........@...........@.......
@@@@...@@@@@@@@@@@@@@@@@@@@@@@@.....@@.......@.......@......@
@@@@...@.@@@@@@@@@@@@@@@@@@@@@@....@@@.......@@..............
@@@@@@...@@@@@@@@@@@@@@@@@@@@@@..@@@@.........@@......@@@@@..
@@@@@@@..@@@@@@@@@@@@@@@@@@@..@..@@@@@.......@@@@..@@.@@@....
@@@@@@@...@@@@@@@@@@@@@@@@@@.....@@@@@.........@@..@@...@....
@@.........@@@@@@.@@@@@@@@@@@.....@@@@@@@.......@............
@@@.........@@@@@.@@@@@@@@@@@.....@@@@@@@@....@..........@...
@.@......@.....@...@@@@@@@@@...@..@@@@..............@@@..@...
@......@@......@....@@@@@@........@@@@........@.....@@@..@..@
@......@@....@@@@..@@@...@........@.......@.........@....@..@
@@@.......................................@..@@...@.........@
@@@@.......................@..@.....@.....@@@@@@......@...@@@
@@@@.@..........@.............................@@..........@..
..@.....@.....@........@.......................@..@..........
......@@@@...............................@@....@.............
......@..@@..........................@@......................
..........@................................@@....@@..........
................@@.@..........@.................@@..@........
...............@@@.......................@........@..........
...............@@@.@@...@.......@@...........@...............
......@@..@.....@@@@@@@.@..................@@@@..............
..................@@@@@....................@@@.....@.........
..........@.......@@@@@@....................@@.........@.....
..........@...@@@.@@@@@.......@.@.....@...@.......@@.........
...@..........@@@..@@.....................@......@@@..@......
@......@....@............@.@..............@.....@@@@........@
@@....................@........@.......@..@@.....@@..@....@.@
@@@...........@..........@@@....................@.........@@@
@@...........@@....@....@@.......@.....@.................@@@@
.@.......@...@@............................@@..............@@
.........@@..@@.@@...@.............@@@....@@@.........@..@.@@
.....@@@@@@@.@@@@@@@...............@@@.@..@@@@..........@@.@@
@@...@@@@@@@@@@@@@@@....@@..........@@.@@@@@@@@..@@.....@@.@@
@@@@@@@@@@@@@@@@..@@....@@...........@@@@@@@@@@...@.....@@@@@
@@@@@@@@@@@@@@@@.........@...............@@@@@@@@@@..@@@@@@@@
@@@@@@@@@@@@@@@@.........................@@@@@@@@@@.@@@@@@@@@
@@@@@@@@@@@@@@@@@...................@.....@@@@@@@@@@@@@@@@@@@
@@@@@@@@@@@@@@@@@@@@@@.......@............@@@@@@@@@@@@@@@@@@@
@@@@@@@@@@@@@@@@@@@@@@.........................@@@@@@@@@@@@@@
@@@@@@@@@@@@@@@@@@@@@@..................@......@@@@@@@@@@@@@@
@@@@@@@@@@@@@@@@@@@@@@@....@@@.@.............@@@@@@@@@@@@@@@@
@@@@@@@@@@@@@@@@@@@@.........@..............@@@@@@@@@@@@@@@@@
@@@@@@@@@@@@@@@@@@......@...................@@@@@@@@@@@@@@@@@
@@@@@@@@@@@@@@@@@@....................@@....@@@@@@@@@@@@@@@@@
@@@@@@@@@@@@@@@@@@...@.........@@..........@@@@@@@@@@@@@@@@@@
@@@@@@@@@@@@@@@@@@.......@..@...........@@@@@@@@@@@@@@@@@@@@@
@@@@@@@@@@@@@@@@@@.@......................@@@@@@@@@@@@@@@@@@@
8
46 13 0
8 25 0
22 58 0
8 35 0
15 44 0
51 40 0
12 22 0
23 26 0

25 32 0
48 5 0
58 18 0
11 36 0
5 19 0
22 45 0
57 5 0
0 36 0
