width 61
height 61
@@@.......@..........@..........@..@@@@@.....@@@@@@@@@@@@@@@@
@@@...............................@@@@@@......@@@@@@@@@@@@@@@
@@@...............................@@@@......@@@.@@@@@@@@@@@@@
@@@@..............................@@@@.......@@.@@@@@@@@@@@@@
@........@@....@....@..............@@@.......@@.@@@@@@@@@@@@@
@@......@@@..........................@...@..@@@....@@@@@@@.@@
@@@.....@@........@@....................@..........@@@@@@@..@
@@@............@......@.....@@.....................@@@@@@@...
@@............@.......@..........@...........@@......@.@@@...
@@...........................................@@........@.....
@..........@..........@......@@@......@.....@@@..@...........
@........@@..@........@......@@@....@.@@@@@@@@@..............
.............@@@..@..........@@@...@...@@@@@@@@..............
.........@....@.......................@@@@@@@@@..............
@..........@@@.........................@@@@@@................
@@..........@@.........................@@@@@@@..............@
@@..@@@@.....................@.........@@@@@@@.............@@
@@.@@@@@@..@@............@@..@.........@@@@@@@@@@..........@@
@@@@@@@@...@@..@@@@....................@@@@@@@@@@..@......@@@
@@@@@@@@@........@...................@.@@@@@@@@@@.....@....@@
@@@@@@@@@@.@.........................@@@@@@@@@@@.....@.....@@
@@@@@@@@@@..................@@@......@@@@@@@@@@..@..........@
@@@@@@@@@....................@@......@@@@@@@@@@..@.........@@
@@@@@@@@@@.......@.......@@.....@..@@@@@@@@@@@@............@@
@@@@@@@@@@.........@............@...@@@@@@@@@@@............@@
@@@@@@@@@@..@......@..............@..@@@@@@.......@........@@
@@@@@@@@@@.@@.....@@@...........@@@...@@@@@......@..........@
@@@@@@@@@@.....................@@......@@@......@......@@..@@
@@@@@@@@@@...@....@@@......@...@@......@.....@..........@..@@
@@@@@@@@@@........@@@......@@.........@@...................@@
@@@@@@@@@@@.......@@@@@.................................@.@..
@@@@@@@@@@@....@@@@@@@@.....................@@@.@............
@@@@@@@@@@@..@@@@@@@@@@.....................@@.@@............
@@@@@@@@@@@@@@@@@@@@@@@..@...................................
@@@@@@@@@@@@@@@@@@@@@@@@.....@..@............................
@@@@@@@@@@@@@@@@@@@@@@@@......@@.....@.......................
@@@@@@@@@@@@@@@@@@@@@@@...........@@....@...@@.@.............
@@@@@@@@@@@@@@@@@@@@@@@.................@@@@@@@.......@....@.
@@@@@@@@@@@@@@@@@@@@@@@@@@..@..........@@@@@@@@.....@........
@@@@@@@@@@@@@@@@@@@@@@@@@@..........@..@@@@@@@@@....@......@.
@@@@@@@@@@@@@@@@@@@@@@@@@@.......@......@@@@@@@@.............
@@@@@@@@@@@@@@@@@@@@@@@@@@@@............@@@@@@....@..@@......
@@@@@@@@@@@@@@@@@@@@@@@@@@@@............@@..........@@@......
@@@@@@@@@@@@@@@@@@@@@@@@@@@@@@..@@...@...@@.....@..@@@..@....
@@@@@@@@@@@@@@@@@@@@@@@@@@@@@@@.........@@@@.................
@@@@@@@@@@@@@@@@@@@@@@@@@@@@.@..............................@
@@@@@@@@@@@@@@@@@@@@@@@@@@@@.................@..@............
@@@@@@@@@@@@@@@@@@@@@@@@@@@@...@.......................@@@...
@@@@@@@@@@@@@@@@@@@@@@@@@@@....@..@.........@@@........@@@@@@
@@@@@@@@@@@@@@@@@@@@@@@@@@@...@..@@.........@@@....@@...@@@@@
@@@@@@@@@@@@@@@@@@@@@@@@@@@...@@@@@..........@@@....@@..@@@@@
@@@@@@@@@@@@@@@@@@@@@@@@@@@@@@@@@@@@@.......@..@....@...@@@@@
@@@@@@@@@@@@@@@@@@@@@@@@@@@@@@@@@@@@@@@@@......@....@...@@@@@
@@@@@@@@@@@@@@@@@@@@@@@@@@@@@@@@@@@@@@@@@@@............@@@@@@
@@@@@@@@@@@@@@@@@@@@@@@@@@@@@@@@@@@@@@@@@@@@.......@....@@@@@
@@@@@@@@@@@@@@@@@@@@@@@@@@@@@@@@@@@@@@@@@@@@@.@@@@.....@@@@@@
@@@@@@@@@@@@@@@@@@@@@@@@@@@@@@@@@@@@@@@@@@@@@..@@@..@.....@@@
@@@@@@@@@@@@@@@@@@@@@@@@@@@@@@@@@@@@@@@@@@............@..@@@@
@@@@@@@@@@@@@@@@@@@@@@@@@@@@@@@@@@@@@@@@@@@@@..@.........@@@@
@@@@@@@@@@@@@@@@@@@@@@@@@@@@@@@@@@@@@@@@@@@@@............@@@@
@@@@@@@@@@@@@@@@@@@@@@@@@@@@@@@@@@@@@@@@@@@@@@@.@.........@@@
8
37 39 0
50 36 0
46 15 0
18 9 0
9 2 0
58 41 0
48 57 0
3 16 0

51 22 0
53 18 0
34 0 0
53 27 0
54 35 0
39 48 0
8 7 0
34 29 0
