width 61
height 61
@@@@@@@@@@@@@@@@@@@@@@@@@@@@@@@@@@@@@@@@@@@@@@@@@@@@@@@@@@@@@
@@@@@@@@@@@@@@@@@@@@@@@@@@@@@@@@@@@@@@@@@@@@@@@@@@@@@@@@@@@@@
@@@@@@@@@@@@@@@@@@@@@@@@@@@@@@@@@@@@@@@@@@@@@@@@@@@@@@@@@@@@@
@@@@@@@@@@@@@@@@@@@@@@@@@@@@@@@@@@@@@@@@@@@@@@@@@..@@@@@@@@@@
@@@@@@@@@@@@@@@@@@@@@@@@@@@@@@@@@@@@@@@@@@@@@@@@@..@@@...@@@@
@@@@@@@@@@@@@@@@@@@@@@@@@@@@@@@@@@@@@@@@@@@@@@.@@.@@........@
@@@@@@@@@@@@@@@@@@@@@@@@@@@@@@@@@@@@@@@@@@@@@@.....@.........
@@@@@@@@@@@@@@@@@@@@@@@@@@@@@@@@@@@@@@@@@@@@@@........@...@..
@@@.@@@@@@@@@@@@@@@@@@@@@@@@@@@@@@@@@@@@@@@@@@...............
@...@@@@@@@@@@@@@@@@@@@@@@@@@@@@@@@@@@@@@@@@@@@..............
@...@@@@@@@@@@@@@@@@@@@@@@@@@@@@@@@@@@@@@@@@@@@.@@...@@......
@.....@@@@@@@@@@@@@@@@@@@@@@@@@@@@@@@@@@@@..@@@@..@@@@.......
@@.@..@...@@@@@@@@@@@@@@@@@@@@@@@@@@@@@@.......@..@@@@.......
@.....@....@@@@@@@.@@@@@@@@@@@@@@@@@@@@.............@........
....@...........@@...@@@@@@@@@@@@.............@..............
................@@...@.@@@@@@@..@..@.......@....@......@....@
.....@.................@@@@..................................
....@@..................@@@......@@@@...................@....
@..........@@@@........................@@@...................
@.....................................@@@@...................
@...................@.............@@..@...@.................@
@...@......@.......@................@........................
@@@@@......@......@@......................@..................
@@@@@..............@@..@@@.@...@..........@..................
@@@@...@...........@@.@@@@@@........@...@..@.@@@.............
@..........@@..........@@@@@@.@........@@.@@@@@..............
@......................@@@...@...@.@@..@@@@@.................
@.......@@...................@...@@@@......@.................
@.......@@.....................@........@.........@..........
..@@....@@@@........@@@..@................@.@@....@......@...
.........@.........@..@..@..@.........@...@@@@@..........@...
....@......................@@.............@@..@.@.@@.......@@
..........@................@.........@.@..................@@@
..@..........................@.......@........@..........@@@.
..........@.....................................@@.......@@..
...................@...........................@.........@@..
...@@.........@....@.........................@.@....@..@.....
...............@@..@@@...........@.............@@.....@@...@@
.....@.........@...@@@@.......................@@@@....@@..@@@
...................@@@@........@...@..........@@@@...@@..@@@@
.............@................@..@..@................@..@@@@@
........@.....................@@@@..@....................@@@@
........@.....................@@@@.@@..@.............@..@@@@@
........@...........@.........@@@.....@@@@@..........@@@@@@@@
......@@.......@....@.@.........@..@@@@@@@............@@@@@@@
...............@....................@@@@@@..........@.@@@@@@@
........@......@...@..................@@@.@.@...@@@...@@@@@@@
.@........@@@......@@@........@......@@.....@...@@@...@@@@@@@
@.........@..........@@........@@....@@.....@....@....@@@@@@@
.........@@..........@@....@...@@.....................@@@@@@@
....@.@......@......@@@@@@@@@@@@@......@@....@..........@@@@@
@...............@....@@@@@@@@@@@.......@@...@@..............@
.....................@..@@@@@@@........@@@@.................@
..@....@@@@@@..@@@...@..@@@@@@@@@@@@....@@@@.........@.......
..@......@@@.....@......@@@@@@@@@@@@@..@@@@@@.....@@@@.......
...........@@..@...........@@@.@@@@@@@.@@@@@@@...@@@@@@......
.......@@.....@@...........@@@.....@@@.@@@@@@@...@@@@@@@.....
@@..@@@@@......@.............@....@@@@@@@@@@@@@@@@@@@@@.....@
@@@@@@@@@......@..@@@....@@......@@@@@@@@@@@@@@@@@@@@@@@....@
@@@@@@@@@.........@@@@...@@......@@@@@@@@@@@@@@@@@@@@@@@.@@@@
@@@@@@@@@@......@@@@........@..@@@@@@@@@@@@@@@@@@@@@@@@@@@@@@
8
11 33 0
51 7 0
44 14 0
41 35 0
57 52 0
24 48 0
14 22 0
31 18 0

48 32 0
33 56 0
3 8 0
3 13 0
40 38 0
49 4 0
55 11 0
37 22 0
