width 61
height 61
@@@@@@..@...........@@@@.............@..@@@@@@@@@@@@@@@@@@@@@
@@@@@@...............................@.@@@@@@@@@@@@@@@@@@@@@@
@@@@@@...........@......................@@@@@@@@@@@@@@@@@@@@@
@@@@@........@............@.............@@@@@@@@@@@@@@@@@@@@@
@@@.@.......@@.....@..................@@@@@@@@@@@@@@@@@@@@@@@
@@@..........@@@@@...@............@...@@@@@@@@@@@@@@@@@@@@@@@
@@@..................................@@@@@@@@@@@@@@@@@@@@@@@@
....@................@...............@...@@@@@@@@@@@@@@@@@@@@
...@@@@@.@...@.......@@....@@...........@@@@@@@@@@@@@@@@@@@@@
...@.................@@@...@............@@@@@@@@@@@@@@@@@@@@@
@......................@................@@@@@@@@@@@@@@@@@@@@@
@.......@..............@..................@@@@@@@@@@@@@@@@@@@
.@.....@@......@@..@......@@@.......@.........@@@@@@@@@@@@@@@
....@@@@@@.................@@.....@@@@.......@.@@@@@@@@@@@@@@
.....@@@@@@................@@.....@@@@.........@@@@@@@@@@@@@@
.....@@@@@.................@@.....@@@..@.......@@@@@@@@@@@@@@
@.@@...@@@........@.......@@@.@................@@@@@@@@@@@@@@
@.................@..@....@@@.@@@...............@@@@@@@@@@@@@
....................@@.@.@@@..@@@.......@@......@...@@@@@@@@@
...........@..........@@.@@....@....................@@@@@@@@@
..@.......@@.......................@@........@@.@.@@@@@@@@@@@
...........@@@..............@......@@@........@......@@@@@@@@
..@@....@..@..@................@...@.@@...@........@@@@@@@@@@
........@@.........................................@@@@@@@@@@
@..........................@@.......................@@@@@@@@@
@@................@.@@...........@@..@@@............@.....@@@
..................@@@@..........@@@@@@@@..@...@............@@
....@.....@....@@@@@@@.....@...@@@@@@@@@...................@@
..............@@@@@@@@..@.@...@@@@@@@@@@........@............
@.................@@@@..@.....@@@@@@@@@@@.................@@@
@@..@@............@@@...........@@@@@@@@@.................@@@
@@@@@@...@.........................@@@@@@@....@@@..@@@.....@@
@@@@@......@....@@@................@@@@@@@..@..@@@..@......@@
@@@@@.....@@....@@@...@@..........@@@@@@....................@
@@@@@.....@@@.@@@@@...@..........@@@@@@....@@@@.......@@@@..@
@@@@@@.....@@..@@@@.........@...@@@@@.......@@@@....@@@@@...@
@@@@@.....@@@..@@@@@.......@..@@@@...........@@.....@@@@@@..@
@@@...........@@@@@@....@...............@...........@@@@@@@.@
@@@@@@@.........@@@@.......................@.......@@@@@@@@..
@@@@@@@............................@@....@............@@@@@.@
@@@@@........@.........................@@@...........@@@@@@@@
@@@@....@@..............@..@.............@..........@.@@@@@@@
@@@@.....@@............@@.........@............@....@....@@@@
@@@@..@...........@@@..@..........@@...@..........@@@....@@@@
@@@@@.@@..........@@........@@@@@@@@...@@@........@@@....@@@@
@@@@@@@@..........@@........@@@@@@@@........@................
@@@@@@@...@@@@@@@.@@.@.....@@@@@@@@@@@...@...................
@@@@@@......@@@@@..........@@@@@@@@@@@.....................@@
@@@@@@@......@@@@..........@@@@@@@@@@@@@@.......@.@.@........
@@.........@...............@@@@@@@@@@@@@@.....@@@..@@@.......
@...........................@@@@@@@@@@@@@@....@@....@........
@.....@.....................@@.@@@@@@@@@@@...............@@@.
@.....@@.....@........@.....@...@@@@@@@@@@@.........@....@@..
.....@...@...@..........@@@...@@@@@@@@@@@@@@@................
@@@..@....................@..@@@@@@@@@@@@@@@@.....@..........
@@@...........@@@..@........@@@@@@@@@@@@@@@@@@@..............
@.........@...@........@..@@@@@@@@@@@@@@@@@@@@@...........@..
.....@...@@...@............@@@@@@@@@@@@@@@@@@@..@.....@......
.@......@@@.............@...@@@@@@@@@@@@@@@@@@...............
.@......@@@........@.@@@@@@@@@@@@@@@@@@@@@@@@@@@....@.@@.....
@@@@@@.@@@@...........@@@@@@@@@@@@@@@@@@@@@@@@@@......@@....@
8
34 40 0
42 41 0
43 25 0
59 48 0
11 12 0
22 53 0
56 57 0
28 22 0

26 0 0
39 10 0
43 26 0
17 1 0
11 12 0
16 2 0
15 14 0
2 7 0
