width 40
height 40
..@...........@...@@@.@@@@@@@@@@@@@@@@@@
...................@..@@@@@@@@@@@@@@@@@@
..........@@..........@@@@@@@@@@@@@@@@@@
...........@@...........@@@@@@@@@@@@@@@@
...........@@...........@@@@@@@@@@@@@@@@
.@......@@.................@@@@@@@@@@@@@
..@.....@@.............@@......@@@@@@@@@
..@.......@@@@.........@.......@@@@@@@@@
...........@@.................@@@@@@@@@@
..............@......@........@@@@@@@@@@
...@@.........@@..............@@@@@@@@@@
@..@...@......@@@.............@@@@@@@@@@
.............@@@.............@@@@@@@@@@@
....@.....@@...@.............@@@@@@@@@@@
......@@............@.@....@.@@@@@@@@@@@
......@......................@@@@@@@@@@@
......@.........@@.......@....@@@@@@@@@@
.........@.....@@.....@@......@@@@@@@@@@
................@......@........@@@@@@@@
......@@............@......@....@.@@@@@@
...........................@..@@@.@@@@@@
@.............................@@@....@@@
@@@...........................@@@...@@@@
@@@@..........................@.@...@@@@
@@@@............@...................@@@@
@@@@...@@..@@..@.......................@
@@@...@@...@...@......@.........@....@@@
@@@...........@@@...@@@@@.@..........@@@
@@@..@...@@...@@@...@@@@@@@@............
@@@..@....@.........@@@@@@@@@@....@@@...
@@@.....@.@....@....@@@@@@@@@@...@@@@@..
...................@@@@@@@@@@@@@@@@@@...
@.......@.............@@@@@@@@@@@@@@@@@@
.....@@.................@@@@@@@@@@@@@@@@
@@@...@............@....@@@@@@@@@@@@@@@@
@@............@@...@@..@@@@@@@@@@@@@@@@@
@@............@@@@@@@@@@@@@@@@@@@@@@@@@@
@......@@....@@@@@@@@@@@@@@@@@@@@@@@@@@@
@@@...@@@@...@@@@@@@@@@@@@@@@@@@@@@@@@@@
@@@...@@@@...@@@@@@@@@@@@@@@@@@@@@@@@@@@
8
3 26 0
14 33 0
7 0 0
5 34 0
21 0 0
12 34 0
10 0 0
17 19 0

13 16 0
5 22 0
7 34 0
10 9 0
5 36 0
3 0 0
7 7 0
19 19 0
