width 40
height 40
@@@@@@........@@@@@@.@@..@@..@.....@@@@@
...@@........@@@@@@.............@..@@@@@
.........@.@.@@.@.....@................@
..@........@..@.......@.....@..........@
............................@@....@@...@
@@.......................@..@....@@@@...
@@...................@............@@@...
@@...............@@...........@...@.@...
@..........@@@...@@........@..@.........
@@..@.......@@.@.......@......@.........
...........@.@.......@@@.@@@@@@......@@.
.....................@@@@@@@..@......@@@
...................@@@@@@@..............
@......@@..........@@@@@................
.......@@....@......@@@@@...............
@@.....@@@..............@...............
......@@@..............@................
........@...........@...............@..@
....................@..........@.@..@@@@
@....@@@@...........@....@.....@@@@@@@@@
@.......................@........@@@@@@@
@@@...@.......@@........@@.......@@@@@@@
@@@...@@..............@@@.......@@@@@@@@
@@@..@@....@@..........@@@@@@...@@@@@@@@
@@@..@@....@@..........@@@@@@...@@@@@@@@
@...@@....@@@@.........@@@@.....@@@@@@@@
@....@....@@@....@@....@@@.....@@@@@@@@@
.....@@@.@@@@@.........@@......@@@@@@@@@
.....@@@@@...@................@..@@@@@@@
..@@.........@...................@@@@@@@
...@..........@@..........@....@@@@@@@@@
@..@....@...............@........@@@@@@@
@..@@......@@......@....@.......@@@@@@@@
@@..........@@@....@............@@@@@@@@
@@@..........@@@................@@@@@@@@
@@...........@@@@.................@@@@@@
@@............@@@.@@@@............@@@@@@
@@.........@...@@@@@@@...@.......@@@@@@@
@@.............@@@@@@@...@......@@@@@@@@
@@@@.............@@@@@@@@@......@@@@@@@@
8
30 31 0
10 1 0
38 2 0
22 25 0
18 3 0
30 19 0
16 34 0
3 20 0

3 8 0
17 33 0
10 39 0
14 25 0
18 14 0
4 14 0
32 20 0
4 20 0
