width 40
height 40
@@......@..@.......@@@...............@@@
@@...............@...@...........@@@@@@@
@...@...............@@.........@@..@@@@@
@...@.@.............@@..@......@....@@@@
...................@@........@.........@
............@.............@............@
....@......@@....@.................@...@
.........@..............................
.....@...@@..........@..................
.........@@.........@@@........@.......@
......@@@@@@@............@@@.@@@.......@
......@@@@@@@@...@........@@@@@@.....@..
.......@@@@@@@@.............@@@@........
............@@.............@@@.....@.@..
..........@.@..............@@@@.........
@.........@......@..............@.......
@..@......@.......@@@@..........@.......
...@..............@...............@..@@@
...@@.@.@@......@@.........@..........@.
...@...............@....................
.............................@..........
..@.......@...@.........................
.........@@............@..@@.@..........
......@@@@@..................@@.........
......@@..........@@....@....@@@..@.....
@......@........@@@@..@......@@@.@@.....
@...@@.@........@@@@.@@.............@@@.
@...@@.@@..@@@@@@@@@.@@......@..........
@.......@@@@@@@@@@@@..@......@..........
..@.....@@@@@@@@@@@@@.@.................
..@.@.@@@@@@@@@@@@@@@...............@...
..@.@.@@@@@@@@@@@@@@................@@..
@.....@@@@@@@@@@.@@@...@.............@..
@@.....@@@@@@@@@.......................@
@@.....@@@@@@@@....@............@@.....@
@@...@@@@@@@@@@..........@..............
@@.@.@@@@@@@@@@....@@@.........@@.......
@@@@@@@@@@@@@@@..@.@@@....@@@@.@@.......
@@@@@@@@@@@@@@@.@.........@@@@@@@@......
@@@@@@@@@@@@@@@@@@@...@....@@@@@@.......
8
6 2 0
20 6 0
20 1 0
36 17 0
14 7 0
37 5 0
37 18 0
3 24 0

27 35 0
0 18 0
38 38 0
4 36 0
35 33 0
32 25 0
36 17 0
19 39 0
