width 40
height 40
@@@@@@@@@@@@@@@@@@@@@@@@@..............@
@@@@@@@@@@@@@@@@@@@@@@@@@.............@@
@@@@@@@@@@@@@@@@@@@@@@@@..............@@
@@@@@@@@@@@@@@@@@@@@@@@@@..............@
@@@@@@@@@@@@@@@@@@@@@@@@...........@...@
@@@@@@@@@@@@@@@@@@@@@@@............@..@@
@@@@@@@@@@@@@@@@@..@@@@@@............@@@
@@@@@@@@@@@@@@@@......@@@@...@.......@..
....@@@@@@@@@@@......@@@@.......@@...@.@
..@@@@@@@@@@@@@@....@..@@...@....@@.@..@
..@@@@@@@@@@@@@@@@@.................@..@
...@@@@@@@@@@@@@@@@................@....
...@@@@@@@@@@@@@@@@..@...@.....@@.......
..@@@@@@@@@@@@@@.@......................
..@@@@@@@@@@@.........................@@
......@@@@@...@........@@..........@....
@@......@.........@.....................
.@@....@@.....................@..@@.....
.......@@..........@....@.........@@....
..............@...................@@@@@@
@@.........@..@...................@@@@@@
@...@@.....@..@...@..............@@@@@@@
@@..@...........................@@@@@@@@
@..@@....................@.......@@@@@@@
@..@@...........................@@@@@@@@
@..@@...@.....@..............@@@@@@@@@@@
@..@@@@@@......@....@............@@@@@@@
@@@@@@@@@.........@...@......@...@@@@@@@
@@@@@@@..............@@.........@@@@@@@@
@@@@@@@@......@....................@@@@@
@@@@@@@@@..................@@....@@@@@@@
@@@@@@@@@@.....@.@@..@.@........@@@@@@@@
@@@@@@@@@@.@...........@........@@@@@@@@
@@@@@@@@@@........................@@@@@@
@@@@@@@@@@@...........@.@@...@......@@@@
@@@@@@@@@@@......@......@...........@@@@
@@@@@@@@@@@........@.............@@@@@@@
@@@@@@@@@@@...@..@@@..@@@@........@@@@@@
@@@@@@@@@@@@@....@@@@.@@@@........@@@@@@
@@@@@@@@@@@@.....@@@@@@@@@.@.....@@@@@@@
8
31 33 0
3 18 0
16 29 0
19 28 0
22 29 0
26 35 0
34 34 0
19 16 0

38 12 0
34 3 0
2 23 0
2 18 0
25 29 0
1 13 0
28 32 0
12 37 0
