width 40
height 40
@@@@@@@@@@..@@@@..@@@@@@@@@@@@@@@@@@@@@.
@@@@@@@@.@..@@@@..@@@@@@@@@@@.@@@@@@@...
@@@@@@@@.....@@...@@..@@@@@@....@@@@@...
@@@@@@@@..........@@..@@@@@......@@@....
@@@@@@@@@.............@@@@@.............
@@@@@@@@................@@@.............
@@@@@@@...........@@.....@..............
@@@@@@@.........@........@.@............
@@@@@@.....@@@@.@.........@.............
@@@@@@......@@..@...@@@............@....
@@@@@.............@.....................
@@@@@@........@..........@.@..@.........
..@........................@@@@.........
.........@....@@............@@@@...@....
....@.......@.@@@@@...........@......@..
....@..........@@@@.....................
...............@@@@...........@.........
..@.....@@....@@@@@..........@@.........
..@....@@@.....@@@...........@..........
@..........@....@.......................
@@@@@......@@.......@...................
@@@@@.......@@.@........@@..............
@@@@@@......@@@@........@@.........@....
@@@@@@@@....@@@.........@@..............
@@@@@@@@....@@@.@........@..............
@@.@........@@..@........@.....@@.......
...@............@.............@@@@......
.........@......@...........@@@@@@......
............@..@@...........@@@@@@@@@@@.
..@............@@...........@@@@@@@@@@@.
........@......@@......@...@@@@@@@@@@@@.
@......@.......@....@.......@@@@@@@@@@@@
@@..@.....@................@@@@@@@@@@@@@
@@@@...................@@@@@@@@@@@@@@@@@
@@@@@.......@@@@...@.@.@@@@@@@@@@@@@@@@@
@@@.@.......@@@@@.......@@@@@@@@@@@@@@@@
@@@.............@....@..@@@@@@@@@@@@@@@@
@@@.....................@@@@@@@@@@@@@@@@
@@@..............@@@@..@@@@@@@@@@@@@@@@@
@@@.............@@@@@@@@@@@@@@@@@@@@@@@@
8
18 5 0
5 39 0
8 29 0
23 31 0
8 37 0
20 11 0
13 15 0
12 32 0

36 5 0
39 25 0
38 8 0
28 8 0
33 25 0
27 22 0
15 11 0
38 12 0
