width 40
height 40
@@@@....@......@...@.@@@@@@@@@@@@@@@@@@@
@@@..@...............@@@@@@@@@@@@@@@@@@@
.....@..............@@@@@@@@@@@@@@@@@@@@
@.@..@.......@.....@@.@@@@@@@@@@@@@@@@@@
..@..........@.....@@.@@@@@@@@@@@@@@@@@@
.......@.@@.@.....@@...@@@@@@@@@@@@@@@@@
.........................@@@@@@@@@@@@@@@
.....@.......@..........@@@@@@@@@@@@@@@@
..........@......@......@@@@@@@@@@@@@@@@
@.........................@@@@@@@@@@@@@@
..@@@.......................@@@@@@@@@@@@
..@@@....................@@.@@@@@@@@@@@@
...@@..................@@@@@@@@@@@@@@@@@
...................@..@@@@@@@@@@@@@@@@@@
....@...@.........@@@@@@@@@@@@@@@@@@@@@@
....@@.@........@@@@@@@@@@@@@@@@@@@@@@@@
.......@....@@....@@.@@@@@@@@@@@@@@@@@@@
............@.........@@@@@@@@@@@@@@@@@@
.......@..............@@@@@@@@@@@@@@@@@@
....@........@..@@....@@@@@@@@@@@@@@@@@@
...............@@@......@@@@@@@@@@@@@@@@
.....@.....................@@@@@@@@@@@@@
..........................@@@@@@@@@@@@@@
........@..........@@......@@@@@@@@@@@@@
.....@......................@@@@@@@@@@@@
.............................@@@@@@@@@@@
........@@.....@@...@.......@@@@@@@@@@@@
........@@.....@@............@@@@@@@@@@@
..@@....@@@..................@@@@@@@@@@@
..@@@@....@@............@@@@.....@@@@@@@
@.@@.....................@@@@....@@@@@@@
......@@..@@.............@@@@@@@@@@@@@@@
......@@..@@.............@@@@@@@@@@@@@@@
..@@..@@.............@....@.@@@@@@@@@@@@
@@@@@@@...@....@............@@@@@@@@@@@@
@@@@@@@.....@...............@@@@@@@@@@@@
@@@@@@@...............@@....@@@@@@@@@@@@
@@@@@@@@.....................@@@@@@@@@@@
@@@@@@@@@@@..@...............@@@@@@@@@@@
@@@@@@@@@@@@...@.........@@..@@@@@@@@@@@
8
17 22 0
1 32 0
1 27 0
9 12 0
13 29 0
22 37 0
7 12 0
24 6 0

26 23 0
32 30 0
4 1 0
8 29 0
16 18 0
10 35 0
6 21 0
24 38 0
