width 40
height 40
@..@@@@@@@.........@@@@......@@@@@@@@@@@
....@@@@@@............@........@@@@@@@@@
......@@.@.......@@.....@.@....@@@@@@@@@
.................@@..........@@@@@@@@@@@
......@............@.....@@.@@@@@@@@@@@@
.........@.........@@.....@@@@@@@@@@@@@@
..............@@...@@.....@@@@@@@@@@@@@@
.............@@@............@@@@@@@@@@@@
...........@..@..............@@@@@@@@@@@
@@@..........................@@@@@@@@@@@
@@......@.................@@@@@@@@@@@@@@
@.................@@......@@@@@@@@@@@@@@
....@@@.@.......@@@..@....@@@@@@@@@@@@@@
..@.@@@.....@@@@@@@@..@....@@@@@@@@@@@@@
..@@@@@......@@@@@@@........@@@@@@@@@@@.
..@@@@........@@@@@@.....@..@@@@@@@@@@..
..@.@.........@@@@@@.........@@@.@@.....
............@@@@@@@@.............@@....@
...........@@@.@@@...............@.....@
.......@...............................@
@..@.......................@......@.....
@........@.................@@...........
@@.........@..............@@........@...
.........................@.@@...........
.@...@...@@@........@...................
@@@.....@@@...........@.............@...
@@@@.@@@@@@.................@........@@.
@@@@@@@@@@@.....@@..........@@...@...@..
@@@@@@@@@@@.....@@@@@........@@.........
@@@@@@@@@@@.....@@@@@.@.......@@@.......
@@@@@@@@@@........@@@@@.....@@@@@.......
@@@@@@@@@....@....@@@@@.....@@@@..@.@@..
@@@@@@@@@....@@...@@@@@.....@@@@..@@@@..
@@@@@@@@@.......@@@@@@@..@@@@@@@@@@@@@..
@@@@@@@@@..........@@@@@@@@@@@@@@@@@@@..
@@@@@@@@@............@@@@@@@@@@@@@@@@@..
@@@@@@@@@@.......@...@@@@@@@@@@@@@@@@@@@
@@@@@@@@.@..........@@@@@@@@@@@@@@@@@@@@
@@@@@@@..@.........@@@@@@@@@@@@@@@@@@@@@
@@@@@@@............@@@@@@@@@@@@@@@@@@@@@
8
12 14 0
25 9 0
27 28 0
24 6 0
6 19 0
15 34 0
9 15 0
27 0 0

4 19 0
14 9 0
39 14 0
17 37 0
21 25 0
25 3 0
21 13 0
8 38 0
