width 40
height 40
@.......@@@@@@@@..@@@@@@@@@@@@.@@@@@@@.@
@@...........@@@.......@@@@@.....@@@@@..
@............@........@@@@@......@..@@@.
@@..................@...............@@..
@.....@..@..........@...................
@...............@@...............@......
@@..............@@....@....@.....@..@...
@@.@....................................
@@@@..@....@.............@.........@@@..
@@.....@.@..............................
@@@@.....@@@......................@.....
@@@@.....@@...................@..@@@..@@
@....@@............................@....
.......................@@...............
@........@......................@...@...
....@...@@@......................@..@...
.......@@@@.............@...@@@..@...@@@
.........@@..........................@.@
........................@@@@...........@
..@@..........@@...........@@@@@@......@
@.@@@........@@@...@.......@@@@@.......@
@.@@@......@...@...........@@@@@........
...@.....@.......@@@.........@..........
.........@.......@@@....................
............@@.....@@@@................@
............@.....@@@@@.....@.......@...
......@@.........@@@@@..@.....@@........
.................@@@@@........@@.....@@@
................@@@@@@@..@@..@@@@@@.@@@@
............@@.@@@@@@@@........@@@@@@@@@
................@@@@@@........@@@@@@@@@@
..@@@@...@....@.@@@@@.........@@@@@@@@@@
.@@@@@@@......@..............@@@@@@@@@@@
@@@@@@.....@@@@.............@@@@@@@@@@@@
@@@@@@..@@@@@@@@@......@..@@@@@@@@@@@@@@
.@.@....@@@@@@@@@.............@@@@@@@@@@
...@.......@@@@@@.............@@@@@@@@@@
.....@.....@@@@@@.......@......@@@@@@@@@
........@..@@@@@@.......@.....@@@@@@@@@@
........@..@@@@@@@............@@@@@@@@@@
8
8 5 0
6 27 0
3 38 0
10 32 0
23 33 0
10 7 0
17 1 0
5 26 0

14 16 0
3 25 0
19 7 0
17 15 0
6 20 0
33 4 0
25 31 0
8 37 0
