width 40
height 40
@@@@@@@@@.....@@@............@...@@@@@@@
.@@@@@@@@...@@@@@............@.....@@@@@
.@@@.@@@......@@........@...@@......@@@@
...............@@@@.............@..@@@@.
...............@@@@.....................
.........@.....@@@@@...@................
....@.@@@......@@@@@..@@.@@.............
......@@@@.......@@@@@@@......@.........
......@@@@....@..@@@@@@....@..@@.......@
......@...........@@@@@@@..@............
.@................@@@@@@@@........@.....
@@.@@@...@@.@.....@@@@@@..........@@@...
@@................@@@@@..............@.@
@@@@.................@@....@.....@...@@@
@@@@@.......@..@......................@@
@@@@@...@@..............@.............@@
@@@@@@@.@@@@............@.........@@@@@@
@@@@@@@@@@@@@@@............@@.....@@@@@@
@@@@@@@@@@@@@@@.@...@.......@.....@@@..@
@@.@@@@@@.@@@@@@@@@@@...........@@@@@...
...........@@@@@@@@@@@..........@.@@....
.....@..@..@@@@@@@@..@..................
.....@..@......@@.........@.............
.@@@@...@@.@....@.@...@..@@@............
.@@@....@..@....@.@......@@@.......@....
.@@@....@@@@@.@.@........@@@@@@....@....
@@@@..@.@@@@..@....@.....@@@@@@.........
@@@......@@@..@....@.....@@.@@..........
@@@...........@.........................
.........@....@@.....@..............@...
....@....@@.............................
....@.....@.................@@@@@.......
....@..........@@@@....@@...............
..@..@@...@....@@@@@..@@@...............
...@@@@..@......@@@@@@@@@.....@.........
...@@@@.....@.@@@@@@@@@@@@@..@@........@
@..@@@........@@@@@@@@@@@@@............@
@.........@@@..@@@@@@@@@@@@......@@.....
...........@@.@@@@@@@@@@.......@........
.....@.@....@.@@@@@@@@@@.......@@......@
8
37 4 0
10 4 0
31 34 0
36 4 0
33 7 0
12 10 0
12 4 0
38 21 0

0 31 0
15 31 0
13 0 0
31 3 0
8 28 0
35 30 0
1 7 0
1 39 0
