width 60
height 60
......@.@@....@@@@@@@..@@@@@@@@@@@.....@@@@@@@@..@..........
.........@....@@.......@@@@@@@..........@@@@................
.........@.....@@@......@@....@@..........@@...@............
....@.........@@@@............@@@@............@@..@.........
@.............@@.............@@@@@.@..........@............@
@.............@@............@@@@@@...........@@..........@.@
@.............@@........@....@@@@@.@..@......@@.............
.....@........@@@.@@....@......@@@..........................
...@..........@@@.............@@@@@..................@@.....
..........@....................@@@@.......................@@
@.......@.@@....................@@.......................@@@
.........@...................@.@@@@....................@..@@
....@.............................@..@.................@.@@@
.......@.....................................@.@@@@.......@@
@.....@@@............................@........@@@@@@........
@....@@@@.........@.@@@....@...........@......@@@@@@@@@@@@..
@.....@.......@@.....@@@.@@@...........@.......@@@@@@@@@@@..
@.....@........@.....@@@@@@@@@..........@......@@@@@@@@@@@.@
@@..............@@...@@.@@......@@.............@@@@@@@@@@@@@
@............@..@@............@.@@............@@@@@@@@@@@@@@
............@@@@@@@..........@@...............@@@@@@@@@@@@@@
...@..@.....@@@@........................@.....@@@@@@.@@@@@@@
....................@..@@.......@............@@@@@@@.@@@@@@@
@........@.........@@..@...........@@....@@..@@@@@@..@@@@@@@
@@..................@@.......@.........@@.....@@@@....@..@@@
@@.@..................@.@..@.........@.@@@@..@@@@@.......@@@
@@@@..@@..@........@@.@@@..............@@@@...@@@@........@@
@@@......@............@@@...@...@@....@@@@@@@@@@@@@.......@@
@@.......@............@@....@...@....@@@@@@@@@@@@@@@........
...@...@..............@@......@........@@@@@@@@@@@@@........
...@......@@................@...........@@@@@@@@@@@@........
...@......@.................@...........@@@@@@@@@@@.........
..............@............@@...........@...@@@@@@..........
.....@@.......@............@..@@@...........@@@@@@..........
@....@..........@@...........................@@@@@.@........
@.........@.....@@@...@.................@@@....@...........@
@.........@@@..@@@@@..................@@@@@.................
@.........@@@@@@@@@@@@@@.......@..@....@@@..................
@.@...@...@@@@@@@@@@@@@.....@...@.......@@......@...........
..........@@@@@@......................@................@....
@@........@@@.@.............@@...........@@.@.......@@@@....
@@.@.....@@@@....@..@......@@@...........@..@@@@....@@@@....
@@.........@@@......@......@@@@...@.......@....@.....@@@....
@@.........@@..............@@@@.......@.......@@.....@......
@@.........@.............@@@@@@.......@...@.................
........@.@...............@@....@.................@.........
.............@........@...................@....@.........@..
........@......@............................................
........@............................@......................
....@@.....................@@.......@@......................
@...@@..........@..........@@...........@...................
@@.........................@@...........@...................
@@............@@.......@@@.@..............@.................
@@@..........@........@@@@@@...........................@...@
@......@@@....@....@..@@@@@@.@@@..............@......@.....@
@....@..@@@...........@@@@@@@@..................@@@..@@....@
@..@@@.@@............@@@@@@@@@...............@..@@@......@@@
@@@@@@@@@............@@@@@@@@@...............@@@@@.......@@@
@@@@@@@@@@@..........@@@@@@@@@@...........@..@@@@@@...@..@@@
@@@@@@@@@@@@@..@@....@@@@@@@@@@@...@@...@.@..@@@@@......@@@@
8
53 9 0
29 14 0
40 23 0
14 13 0
17 45 0
28 12 0
54 26 0
26 11 0

40 7 0
27 11 0
12 54 0
17 5 0
13 45 0
25 22 0
10 4 0
36 32 0
