width 60
height 60
@@@@@@@@@@@@@@@@@@@@@@@@@.@@@@...@@@...@@@@@@@@@@@@@@@@@@@@@
@@@@@@.@@@@@@@@@@@@@@@@...@@@....@@@....@@@@@@@@@@@@@@@@@@@@
@@@@@@..@@@@@@@@@@@@@@....@@............@@@@@@@@@@@@@@@@@@@@
@@@@@@..@@@@@@@@.@@@@@...................@@@@@.@@@@@@@@@@@@@
@@@@@@......@@@@....@@.................@@@..@@..@@@@@@@@@@@@
@@@@@@....@.@@@......@.................@.@........@@@@@@@@@@
@@@@.......@@@.......................@.@.........@@@@@@@@@@@
.......@...@@@..................................@@@@@@@@@@@@
.......@...@.....@.........@@@.@......@.........@@@@@@@@@@@@
................@..........@@@..................@@@@@@@@@@@@
............................@....@....@@..@.....@@@@@@@@@@@@
...............................................@@@@@@@@@@@@@
@@....@.............@.......................@..@@@@@@@@@@@@@
.@....@..@@...........@..@............@........@@@@@@@@@@@@@
......@.@@@.............@@......@@...@.........@@@@@@@@@@@@@
....@..@@@@@.@.........@......@@@@...@@........@@@@@@@@@@@@@
.@....@@@@@..@.........@@@@...@@@@@@.@@@....@@@@@@@@@@.....@
........@...@@...@.....@@@@@@@@@@@@@@@@....@@@@@@@@@@......@
..................@...@@@@@@@@@@@@@@@@....@@@@@@@@@@@@.....@
.............@........@@@@@@@@@@@@@@@@@@.@@@@@@@@@@@@......@
..................@@@@@@@@@@@@@@@@@@@@@@.@@@@@@@@@@@@@......
........@@.........@@@@@@@@@@@@@@@@@@@@@.@@..@@@@@@@........
@@.....@@..........@@@@@@@@@@@@@@@@@@@@@@@@..@@@@@@@........
@@......@.........@@@@@@@@@@@@@@@@@@@@....@...@@@@@@........
@@..............@...@@@@@@@@@@@@@@@@@@........@@@@@..@......
@@........@.....@...@@@@@@@@@@@@@@@@............@.......@...
@@@......@@@..@.....@@@@@@@@@@@@@@@@.................@......
@@@......@...........@@@@@@@@@@@@@@@.........@.........@@..@
@@@...................@@@@@@@@@@@@@@.........@@.........@...
@@@...................@@@@@@@@@@@@@@................@..@....
@@@@@@...........@@@..@...@@@@@@@@@...........@....@@.......
@@@@@@....................@@@@@@@@@...........@.............
@@@@@@.......@........@@..@@@@@@@@....@@@...@@@.......@....@
@@@@@.......@@..@.....@@@@@@@@@@@@....@@.............@@....@
@@@@@@.@..@@@@...@@..@@@@@@@@@@@@......@.............@@...@@
@@.@...@..@@@@...@@.@@@@@@@@@@@@@@....................@@..@@
.......@............@@@@@@@@@@@@@@...............@@@...@..@@
......@.................@@@@@.........@...................@@
.@...@@@@...............@@@@@.@.....@@@@....@@............@@
.....@@@@.....@.@......@@@@@..@@..@@@@@@.....@.....@......@@
..@.@@@...................@...@@..@@@@@...................@@
....@@@..........@............@@....@@@.....................
@...@@@......@...@@@..@.............@@......................
@...@@.............@..@@............@...................@...
....@......................@.@@.....@................@@@@@..
......@@............................@@.................@....
..............................@...........................@@
.......@..........@.........@@@..............@............@@
@@@@...........@@.................@..........@........@@..@@
@@.....................................@..............@@@.@.
@....................................@@@...........@@.......
@@......@...........@@..............@@@@...@...........@..@.
@@@@@..................@@@@........@@@@....................@
@@@@@@@@.@....@.....................@@@...@@...@............
@@@@@@@@............................@@@@@.@@@@@@............
@@@@@@@@............@.@..@@.........@@@@@@@@@@@@....@.@.....
@@@@@@@@@.............@@@@@.........@@@@@@@@@@@@..@.......@@
@@@@@@@@@.....@.................@@@@@@@@@@@@@@@@@@@@......@@
@@@@@@@@@@....@.............@@@@@@@@@@@@@@@@@@@@@.@..@....@@
@@@@@@@@@@..................@@@@@@@@@@@@@@@@@@@@@.........@@
8
35 49 0
52 36 0
23 7 0
23 55 0
49 34 0
38 42 0
3 26 0
15 52 0

53 49 0
32 7 0
40 7 0
31 48 0
26 3 0
3 42 0
44 48 0
19 8 0
