width 60
height 60
@@@@@@@@@@@@@@...........@@@@.@@@@@@@@.......@@...@....@....
@@@@@@@@@@@@@@...........@@@@..@@@@@@@...@....@.............
@@@@@@@@@@@@@@...........@@....@@@@@@@......................
@@@@@@@@@@@@@@......@@.@@.....@@@@..@.......@........@@@....
@@@@@@@@@@@@@@......@...@.......@@..........@.@............@
@@@@@@@@@@@@@@@...............................@@@..........@
@@@@@@@@@@@@.......@........................@@@@@@.........@
@@@@@@@@@@@@@.........@@..@................@@@@@@@@...@@....
@@@@@@@@@@@@@...........@................@@@@@@@@@@....@@...
@@@@@@@@@@@@@.....@@......................@@@@@@@@@....@....
@@@@@@@@@@@@@@@.........@.................@@@@@@@@@@........
@@@@@@@@@@@@@@@@....@..@@@....................@@@@@.......@.
@@@@@@@@@@@@@@@@.................@..........@.@@@@@.........
@@@@@@@@@@@@@@@@@@@@@............@............@@@@.....@....
@@@@@@@@@@@@@@@@@@@@@.....@.....@...........@@@@@......@@@..
@@@@@@@@@@@@@@@@@@@@@...........@@.........@@@@@@.....@@@@..
@@@@@@@@@@@@@@@@@@@@@................@.......@@@.....@@@@@@.
@@@@@@@@@@@@@@@@@@@@@@@@.....@@@.....@.....@.@@........@@@@.
@@@@@@@@@@@@@@@@@@@@@@@.....@@@@.............@@...@.........
@@@@@@@@@@@@@@@@@@@@@@@......@@@@@..........@@@..@........@.
@@@@@@@@@@@@@@@@@@@@@@@........@@@........................@@
@@@@@@@@@@@@@@@@@@@........@...@@@.....@..........@.......@@
@@@@@@@@@@@@@..@@@@....@..............@@........@@........@@
@@@@@@@@@@@@...@.....@......@.......@...........@@@........@
@@@@@@@@@@@..........@....@......@@......................@@@
@@@@@@@@@@@...............@.....@@@.@..@@@....@...........@@
@@@@@@@@@@@.................@...@......@......@@@@@.@....@@@
@@@@@@@@@@@..........@..............@..@.....@@@@@@@@.@...@@
@@@@@@@@@@@..........@..........@@@..........@@@.@@@@.@..@@@
@@@@@@@@@@@...........@...........@..........@....@...@.@@@@
@@@@@@@@@@@@@@@...@.@.@................@....@...........@@@@
@@@@@@@@@@@@@...........@....................@@..........@@@
@@@@@@@@@@@@@..@@................@....................@..@@@
@@@@@@@@@@@@@@.@......@@@.......@@.@......@@.@........@@@@@@
@@@@@@@@@@@@@@@@.....@@@...........@@.....@@.@........@@@@@@
@@@@@@@@@@@@@@@@.....@........@....@.......@@@@@......@@@@@@
@@@@@@@@@@@@@@@@..@..@.@.....................@..@...@@@@@@@@
@@@@@@@@@@@@@@@@@...................................@@@@@@@@
@@@@@@@@@@@@@@@@@...............................@@....@@@@@@
@@@@@@@@@@@@@@@@....@..@@.......................@@....@@@@@@
@@@@@@@@@@@@@@@@....@@@@@......@@..............@.@..@@@@@@@@
@@@@@@@@@@@@@@@@@@.@@@@@@.@@..@............@@@.......@@@@@@@
@@@@@@@@@@@@@@@@@@@@@@@...................@@@@@@@....@@@@@@@
@@@@@@@@@@@@@@@@@@@@@@@........@@.....@........@.......@@@@@
@@@@@@@@@@@@@@@@@@@@@@@.@.......@@....@.......@........@@@@@
@@@@@@@@@@@@@@@@@@@@@@@@..@........@...................@@@@@
@@@@@@@@@@@@@@@@@@@@@@@@@.@.......................@..@@@@@@@
@@@@@@@@@@@@@@@@@@@@@@@@@.@@.........................@@@@@@@
@@@@@@@@@@@@@@@@@@@@@@@@@@@...........................@@@@@@
@@@@@@@@@@@@@@@@@@@@@@@@@@......................@@....@@@@@@
@@@@@@@@@@@@@@@@@@@@@@@@@@....@..@..@.................@@@@@@
@@@@@@@@@@@@@@@@@@@@@@@.........@@@@@...@..........@.@..@@@@
@@@@@@@@@@@@@@@@@@@@@...........@@@@@................@..@@@@
@@@@@@@@@@@@@@@@@@@@.............@@@@...@......@@.........@.
@@@@@@@@@@@@@@@@@@@@@..@.........@@@@.@@@@..@@...@.@@@......
@@@@@@@@@@@@@@@@...@...@@@@@@@@@@@@@@@@@@...........@.......
@@@@@@@@@@@@@@@@@.....@@@@@@@@@@@@@@@@@@@@@.................
@@@@@@@@@@@@@@@@@....@@@@@@@@@@@@@@@@@@@@@@@........@@....@@
@@@@@@@@@@@@@@@@@@@@@@@@@@@@@@@@@@@@@@@@@@@@@@......@@...@@@
@@@@@@@@@@@@@@@@@@@@@@@@@@@@@@@@@@@@@@@@@@@@@@.......@...@@@
8
39 44 0
38 17 0
42 53 0
39 48 0
31 29 0
28 27 0
32 38 0
28 4 0

18 25 0
34 10 0
57 0 0
56 2 0
29 44 0
24 29 0
26 3 0
25 6 0
