width 60
height 60
.@...@@@@.....@.....@........@@@..@@....@@@@@...@...@......@
.....@@@@@.............@@............@..@@@@...@@...........
..@@@@@...........@....@.....@@@...............@@...........
..@@@@.......................@.@.....@...........@..........
.....@.................@@..@................................
@.......................@.....@................@............
@@@...........................@......................@@@....
@@@.....@@.......................@.....................@....
@@@........@@...............................................
@@@@............................@...................@.......
@@@@@@@........@............@@..@@....@..................@..
@@@@...........@......@.@...@@..@@@@@@@.....@............@@@
@@@.....@@@.............@@.....@@@@@@@@@....@.............@@
@@@.......@...@@@........@....@@@@@@@.....................@@
@.............@@@@@......@..@.@@@@@@@@@...@.............@@@@
@.............@.@@.............@@@@@@@@.................@@@@
@...@...@.......@@..............@@@@@@@..........@......@...
@...@...........@@..............@@@@@@@@@.......@@..........
@@..@........@@@@@...............@@@@@@@..................@.
@............@@@@@...............@@@@@@.....................
@..@@........@@@@@...............@..@......................@
@@@@@@@@@....@@@@@........................@@..........@@....
@@@@@@@@@....@@@@@...........@............@@..........@@....
.@@@@@@@@.....@@@@.....................@.@@@@@@@............
.@@@@@@@@....@@@@@........@........@...@.@@@@@..............
..............@@@@.....@@..........@...@@@@@@@.....@........
.............@@@@@.....@@..@.........@...@@@..@@.@..........
.............@..@@......@...@..............@@...@@..........
.......................@@.......@..@...@..................@.
............@..@..@....@........@@@@@.....................@@
@@......................@@@...@@@@@@@@.........@@.........@@
@@.......................@@....@@@@@@@@.........@.......@@@@
@.................@............@@@@@@@@.................@@@@
........@....@........@........@@@@...@@....@.....@@@@.@@@@@
............@....................@@.@@.@@@........@@@@@@@@@@
.......................@@........@@....@@@.........@@@@@@@@@
...........@@..........@@@@@@..........@....@......@@@@@@@@@
............@.....@....@@@@................@.......@@@@@@@@@
.......................@@@........................@@@@@@@@@@
@.......@@..............@@..@...............@@.....@@@@@@@@@
@.............................@............@@@@....@@@@@@@@@
@@@@...............@.@......................@....@@@@@@@@@@@
@@@@..............@@@@@@..............@...@@@@@..@@...@@@@@@
@@...............@@@@@@...............@@@@@@@@@.......@@@@@@
@@..@.....@......@@@@@@.....@@..@.......@@@@@@........@@@@@@
...................@@@@@@.@@@@..@.........@............@@@@@
...................@@@@@@.@@...............@...@@.......@@@@
...................@@@@@@.........@............@@@@.....@@@@
...................@@@@@.....@....@....@.......@@@...@....@@
......@@@@...........@@@.......@@@@....@@.....@@........@@@@
........@..@..........@@.......@..............@@........@@@@
............@@.....@.@@@.......@.........@.....@........@@@@
...@................@@...@......@@.....@@@@............@@@@@
.........@@......@@.@@@@@@.....@@@..@..@...............@@@@@
@..............@.@@.@@@@@@@@.@@@@@..................@...@@@@
.................@@@@@@@@@@@@@@@@@@.....................@@@@
.................@@@@@@@@@@@@@@@@@@@..@@.........@@.....@@@@
....@.@.........@@@@@@@@@@@@@@@@@@@@@@@@.........@@.@.@.@@@@
..@@@@@.........@@@@@@@@@@@@@@@@@@@@@@@@@....@@@@@@..@@@@@@@
@@@@@@@.@.......@@@@@@@@@@@@@@@@@@@@@@@@@...@@@@@@...@@@@@@@
8
50 19 0
59 22 0
27 19 0
42 37 0
22 37 0
20 2 0
44 28 0
13 45 0

11 52 0
7 56 0
36 44 0
27 13 0
50 32 0
3 19 0
48 20 0
16 35 0
