width 60
height 60
@@@@@@@@@@@@@............@@@...@...@@@@....@@@@@@@@@@@@@@@@@
@@@@@@@@@@@@@.................@......@@.........@@@@@@@@@@@@
@@@@@@@@@@@@@.......................@@@..........@@@@@@@@@@@
@@@@@@@@@@@@@@@......@...........@..@@.........@@@@@@@@@@@@@
@@@@@@@@@@@@@@@@@............@.....@.....@......@@@@@@@@@@@@
@@@@@@@@@@@@@@@@@..@...............@..............@@.@@@@@@@
@@@@@@@@@@@@@@@@...@@..@....@...@.................@..@@@@@@@
@@@@@@@@@@@@@@@....@@@............................@....@@@@@
@@@@@@@@@@@@@@@..@@@@@............................@..@@@@@@@
@@@@@@@@@@@@@@@@..@@@@....@.@............@@..........@@@@@@@
@@@@@@@@@@@@@@@@@..@@@@.@................@..@@..........@@@@
@@@@@@@@@@@@@@@@@@.@@@@@@...@............@@.......@....@@@@@
@@@@@@@@@@@@@@@@@@@@@@@@@@.....@.....................@@@@@@@
@@@@@@@@@@@@@@@@@@@@@@@@@@@.@@@@@.........@.@........@@@@@@@
@@@@@@@@@@@@@@@@@@@@@@@@@@@@@@@@............@.@@.....@@@@@@@
@@@@@@@@@@@@@@@@@@@@@@@@@@@@@@@.............@.........@@.@@@
@@@@@@@@@@@@@@@@@@@@@@@@@@@@@@@@@@@@...@..................@@
@@@@@@@@@@@@@@@@@@@@@@@@@@@@@@@@@.........................@@
@@@@@@@@@@@@@@@@@@@@@@@@@@@@...@@........................@@@
@@@@@@@@@@@@@@@@@@.@@..@@@.....@..@.............@........@@@
@@@@@@@@@@@@@@@@@@.....@@@............@@..................@@
@@@@@@@@@@@@@@@@@@@..@.@@@............@@@.....@...........@@
@@@@@@@@@.@@.@@..@@....@@...@@@.........@@...@@.............
.@@@@@@@@..@.@...@@.@.......@@@.............................
....@@@@@@.......@@@@.................@....................@
...............@@@@@@...........@@....@...@@......@.........
@@.@@........@@@@@@@@................@@@@@@.........@.......
.@.....@.............................@@@@@..................
..@...@@............@.......@...@@@@@@@@@.@.................
..@....@@.....@.....@.......@@@.@@@@@@@@.................@..
..@@.........@@@....@.....@@@....@@@@@@@..........@@........
.......@@.....@......................@@@.............@..@...
................@.@..................@@@.........@......@@@.
@...........@.....@..................@@@............@.......
@......@.......@@@@@...@.............@@@@...........@......@
@@@@.@.........@.@@@................@@@@....@...@..........@
@@@@.................@.@@...........@@@@@@@@@..@@..........@
@@@........@@@@.....@@.@@@.@...@......@@@@@@@@@@@..........@
@@.@.......@@@@........@@@.....@.@....@@@@@@@@@@...........@
...........@@@@.@.....@@@..............@@@@@@@@@...@.......@
............@@..@@@....@@..............@@@@@@@@@..@.........
....@@@.........@@.......@...............@@@@@@@............
.......@..@................@.............@@.......@.........
...........................@......................@.....@..@
...........................@..@...@............@............
...........................@................................
..........@................@@...........................@...
.......@....................................................
........@............................@...............@@.....
...........@..............................@...............@@
@...............@@...@@@...........@....@........@........@@
...@@...........@@@@@@@@@@.........@.......@.@............@@
.............@.@@@@@@@@@@@.................@.@@@............
.......@....@@@@@@@@@@@@@@@...............@@@@@@@...........
..@@.@...@..@@@@@@@@@@@@@@@@@..........@@.@@@@@@@@@@........
@..@@@......@@@@@@@@@@@..@..........@..@@@@@@@@@@@@@@@......
@........@@@@@@@@@@@@@@....@.....@.....@@@@@@@@@@@@@@@...@..
@......@@@@@@@@@@@@@@@@@.............@@@@@@@@@@@@@@@@@@.....
@......@@@@@@@@@@@@@@@@@@...........@@@@@@@@@@@@@@@@@@@@....
@......@@@@@@@@@@@@@@@@@@..........@@@@@@@@@@@@@@@@@@@@.....
8
29 56 0
6 55 0
37 38 0
43 34 0
56 28 0
49 53 0
26 34 0
48 42 0

34 27 0
49 26 0
32 41 0
8 38 0
3 34 0
50 53 0
56 50 0
29 19 0
