width 60
height 60
.......@....@@....@@@@..@.@@...@.@@@.@@@..........@.@@@@@@..
....@.......@..............@.....@@@..@..............@@@....
@@..@......................@....@@@................@@@@@....
.............................@...........@@.................
....................@............@@.....@................@..
.............@@@@.............@@.......@@@..................
.....@.......@@..............@@@....@.@@@.................@@
.....@.....@.@@@...@......@....@....@@@@@.................@@
@@@@@@...............................................@@@@@@@
@@@@@@.......................@.......@......@@@......@@@@@@@
@@@@.@.@..............................@@....@@........@@@@@@
@@@@...@..@@@...@....@......................@@..........@@@@
@......@..@@@.....................@.........@...........@@@@
............@...........................@...................
..............@.........@.....@.............................
..............................@@.....@......................
.....................@......@@@@@@@................@@.......
@......@....................@@@@@@.................@@@...@.@
@..@@@.@....................@@@............@@......@@....@@@
@@@@@@...@.................@@@@@..@................@@.@..@@@
@@@@@@@@@........@.@...@......@@..@@@.....@.@@@....@..@@@@@@
@@@@@@@@@..........@@.........@@@@.@@.....@@@@@.......@@@@@@
@@@@@@@@@..........@..........@@@@..............@..@...@@@@@
@@@@@@@@@.......@..@..........@@@.......@........@...@@@@@@@
@@@@@@@@...@..................@.....@.....@.....@@@...@@@@@@
@@@@@@@@...@..............@@@...........@@@..........@@@@@@@
@@@@@@@@....@@.......@@@@@@@@@.....................@@@@@@@@@
@@@@@@@@@.............@@@.@@@@.....................@@@@@@@@@
@@@@@@@@@@..@.........@@...@@@.........@........@@..@@@@@@@@
@@@@@@@@@@@.@...............@@...@.....@...@........@@@@@@@@
@@@@@@@@@@@@@@@............@@@@...@....@.@........@.@@@@@@@@
@@@@@@@@@@@@@@@...............@...................@.@@@@@@@@
@@@@@@@@@@@@@@..............@.....@.......@..@....@..@@@@@@@
@@@@@@@@@@@@@@.......@............................@..@@@@@@@
@@@@@@@@@@@@@@......@@.............@......@.......@@@@@@@@@@
@@@@@@@@@@@@........@@@...........................@@@@@@@@@@
@@@@@@@@@@@@@@...@@@@@@................@.....@@@..@@@@@@@@@@
@@@@@@@@@@@@@..@@@@@@@@...@............@.......@.....@@@@@@@
@@@@@@@@@@@@@.@@@@@@@@@@@@...................@@@..@.@@@@@@@@
@@@@@@@@@@@@@@@@@@@@@@@@@...................@@......@@@@@@@@
@@@@@@@@@@@@@@@@@@@@@@@@@@........................@@@@@.@@@@
@@@@@@@@@@@@@@@@@@@@@@@@@...............@.............@..@@@
@@@@@@@@@@@@@@@@@@@@@@@@@@@..............................@@@
@@@@@@@@@@@@@@@@@@@@@@@@@@@......@...@@...@...............@@
@@@@@@@@@@@@@@@@@@@@@@@@@@@............@.......@@@@.........
@@@@@@@@@@@@@@@@@@@@@@@@@@@@...................@@...........
@@@@@@@@@@@@@@@@@@@@@@@@@@@@...@@@@...@.....................
@@@@@@@@@@@@@@@@@@@@@@@@@@@@.......................@@@@.....
@@@@@@@@@@@@@@@@@@@@@@@@@@@.@.................@...@@@.......
@@@@@@@@@@@@@@@@@@@@@@@@@...@@................@@@@@.....@...
@@@@@@@@@@@@@@@@@@@@@@@@@...@@....@......@@...@@@@@....@@..@
@@@@@@@@@@@@@@@@@@@@@@@@@@..@.................@@@@@......@..
@@@@@@@@@@@@@@@@@@@@@@@@@@.....................@@@@@........
@@@@@@@@@@@@@@@@@@@@@@@@@@@..@..@...............@@@.....@...
@@@@@@@@@@@@@@@@@@@@@@@@@@@.....@...........@...@@.....@@@..
@@@@@@@@@@@@@@@@@@@@@@@@@@@...............@.@...@@...@@@@@@@
@@@@@@@@@@@@@@@@@@@@@@@@@@@@@@@..@.....@@......@@@....@@@@@@
@@@@@@@@@@@@@@@@@@@@@@@@@@@@@@@.....@..@@@@....@@.....@@@@@@
@@@@@@@@@@@@@@@@@@@@@@@@@@@@@@@..@@@@.@@@@@@@@.@@.....@@@@@@
@@@@@@@@@@@@@@@@@@@@@@@@@@@@@@@.@@@@@@@@@@@....@..@..@@@@@@@
8
11 0 0
4 5 0
16 27 0
28 15 0
33 51 0
33 52 0
26 22 0
23 24 0

37 31 0
45 56 0
39 8 0
41 49 0
33 13 0
6 10 0
21 25 0
39 51 0
