width 60
height 60
@@@.....@.....@@@@@@@@@@@@@@@@@@@@@@@@@@@@@@@@@@@@@@@@@@@@@@
@.@...........@@@..@@@@@@@@@@@@@@@@@@@@@@@@@@@@@@@@@@@@@@@@@
@...........@...@...@@@@@@@@@@@@@@@@@@@@@@@@@@@@@@@@@@@@@@@@
@....@.@@@...........@@@@@@@@@@@@@@@@@@@@@@@@@@@@@@@@@@@@@@@
@......@...@@............@@@@@@@@@@@@@@@@@@@@@@@@@@@@@@@@@@@
@@@..@@...@...............@@@@@@@@@@@@@@@@@@@@@@@@@@@@@@@@@@
@@@@@@@...................@@@@@@@@@@@@@@@@@@@@@@@@@@@@@@@@@@
@@@@@@@.......@@..........@@@@@@@@@@@@@@@@@@@@@@@@@@@@@@@@@@
..@@@@@....................@@@@@@@@@@@@@@@@@@@@@@@@@@@@@@@@@
............@.....@........@@@@@@@@@@@@@@@@@@@@@@@@@@@@..@@@
.@@.........................@@@@@@@@...@@@@@@@@@@@@@@@....@@
...........................@@@@@@@@@...@@@@@@@@@@@@@@@.....@
.....................@@@...@@@@@@@@@@....@@.@@@@@@@@@.....@@
......................@....@@@@@@@@@........@@@@@@@........@
....................@........@@@@@@@........@@@@@...........
.......................@....@@@@............@@@@............
..@.@@......@...............@@.....@@........@@@............
@@@@@.......@..........@@@..................@@@.............
@@@@@..@...........@...@....................@@............@.
@@@@@@@@........@.......@@......@........@..................
@@@@@@.@.....@...@.......@.....@@.................@.........
@@@@@@...........@...@@..............@.@..........@@@.......
@@@@@@@.......@@............................@.@@...@@......@
@@@@@@@.......@@....@.........................@@...@@....@@@
@@@@@@@....@..@..@@.@.........................@@.@@@@..@@@@@
@@@@@@@.......@.....@.......@@@...............@@.@@@@.@@@@@@
@@@@@@@............@@.......@...........@@.@.....@@.@...@@@@
@@@@@.............@.@...................@@..............@@@@
@@@@@@..................@@@...........@.@....@@@.........@@@
....@..@@.........@....@@@..@...@.@.........@@............@@
...@@.@@...............@@@....@...........................@@
@@....@........@......@.......@@@..........................@
@@....@....................@................@@............@@
@...@.......@..........@@.@@.........@..........@.........@@
....@............@........@@...........@........@........@@@
.......@..................@......@.......................@..
.@..............@..........................................@
@@................@.........@....................@..........
@@.......@.................@@..@@..............@............
@....@......@.....@....@...@@@..@@@........................@
@...@@....................@@@@.@@@@..........@.............@
@................@......@@@@@..........@@@@...............@@
................@@...@..@@@@@....@.....@@@@@.......@@.....@@
..........@@@@..@....@..@@@@.....@.....@@@@@........@....@@@
@......@@..............@@@@@@.........@@.@..............@@@@
@........@....@.......@@@@@@.......@...@.....@@...........@@
@.........@........@@@@@@.@@..@@.......@....@....@........@@
............@@@@.......@@..................@@......@..@.....
.............@@@@.............@@..@......................@..
............@@@.........@..@..@......@...........@@..@......
.............@@@..............@...........@@@@......@.......
....@@.................................@@@@@@@@.............
............@..@.....................@@@@@@@@@@.............
.........@..@.......@@..............@@@@@@@@@@@@@@..........
@@.....@....@@....@@................@@@@@@@@@@@@@@@@@.......
.......@@....@.....@................@@@@@@@@@@@@@@@@@.......
@...@..@@....@@......@..@............@@@@@@@@@@@@@@@@@.@.@..
@@..@@@@@....@@@...@......@@@@@......@@@@@@@@@@@@@@@@@@@@...
@@...@@@@.@@@@@@@@.@@..@@.@........@@@@@@@@@@@@@@@@@@@@@....
@@@..@@@@@@@@@@@@@@@@.@@@.....@@@..@@@@@@@@@@@@@@@@@@@@@@@..
8
55 37 0
48 45 0
17 33 0
19 10 0
5 14 0
31 47 0
25 53 0
11 32 0

37 39 0
16 37 0
20 47 0
55 54 0
57 41 0
7 2 0
30 45 0
52 34 0
