width 20
height 46
....................
....@...............
..@..........@...@..
......@........@....
.....@.@.@..........
...........@........
....@..........@....
.......@...@........
@@............@.....
.............@...@..
....................
..@..@..@........@@.
..............@.....
..@.......@..@......
....................
....................
@@..@......@...@.@..
............@.@.....
....@...............
.....@...@....@.....
............@.......
......@.@.@.......@.
....................
...@......@.....@..@
........@......@....
....@...............
...@....@..@.@....@.
...........@...@....
....................
.......@.@..@.......
.....@........@.....
...@.......@........
.............@.....@
.......@..@....@....
....@.........@.....
.......@..@.........
.....@..............
..@.....@..@@.......
....................
...@...........@..@.
....................
...........@.@......
.....@..@.@.........
.......@....@......@
...................@
............@.......
6
2 27 0
0 18 0
19 16 0
11 1 1
8 28 1
17 26 1

0 26 0
19 45 0
8 43 0
11 1 1
1 31 1
3 1 1
