width 20
height 46
....................
.........@..@....@..
....@.........@.....
...@........@.......
@@.............@.@..
.......@..@.........
....................
@...................
..........@......@..
@.....@.............
@...@....@..@.......
@.@........@........
.@.............@@...
.........@.@...@@...
.....@.@............
....................
.........@..@.......
@...@..@.........@..
....................
.@..............@@..
......@.........@@@@
....................
............@.......
......@.......@.....
....@..@.@..........
.................@..
.@.........@........
.........@..........
........@.......@...
@..@................
......@........@.@..
..@.....@.@.........
...@...@...@........
...............@@@@.
....@..........@@@@@
.............@....@@
........@...@......@
@....@........@.@@..
....................
......@....@@.......
...................@
.@.@..@..@..........
........@....@......
...@.@..............
....................
@...................
6
15 45 0
4 23 0
17 12 0
8 15 1
13 26 1
0 26 1

0 0 0
19 5 0
3 33 0
10 38 1
1 3 1
19 31 1
