width 20
height 46
....................
....................
...@......@.@.....@.
@............@......
@...................
.....@....@.........
....................
@@...@...........@..
@@.........@........
@@...........@......
@@..@...@.......@.@.
.........@..........
.........@..........
.....@....@....@....
.........@....@.....
........@...........
.....@.............@
.............@.@..@@
....@.....@.......@@
.......@...........@
...........@........
..@.................
........@....@......
......@.@@.@......@.
........@@...@......
....................
....................
.@.@.@....@....@..@.
....................
..@............@....
........@..@.......@
....@..@....@......@
....................
..........@..@..@...
@@@.................
@.................@.
@.......@..@........
....@.......@.@.....
.@..............@...
....@...............
.....@......@.@.....
@......@.@..@.......
@@....@.............
@@@...............@@
@@@.....@.......@..@
@@@@@......@........
6
2 7 0
18 8 0
11 3 0
10 7 1
2 41 1
2 14 1

7 0 0
11 44 0
15 12 0
0 15 1
15 4 1
14 39 1
