width 20
height 46
....................
....................
....@...@...........
.........@...@.@....
....@..@.........@..
@............@......
........@.@......@..
....................
.....@....@.........
...............@....
@.........@.........
@..@..@...........@.
@.........@.........
................@...
....@......@.@......
..............@.@...
..@.................
.........@..........
........@.....@.....
.....@..............
....@...............
.......@.....@......
.............@@.....
....@..@.@..........
@...........@...@...
.@..................
......@....@.@...@..
..@............@....
.....@..............
....@.........@.....
..........@.........
....@...........@...
.@......@.@...@.....
....@....@..........
...@....@...........
....................
............@.......
.........@.......@..
......@....@.@......
.....@........@.....
....................
........@...@.....@.
...............@....
.................@..
.@......@.....@.....
.@..@...............
6
18 15 0
11 6 0
4 38 0
14 11 1
2 35 1
8 14 1

17 32 0
8 28 0
15 39 0
19 29 1
2 35 1
1 24 1
