width 20
height 46
.@............@.....
...@................
.............@......
.......@........@...
......@..@..@.......
....................
..........@...@.....
................@...
..@...@.......@.....
.........@..@.......
.......@............
............@.......
@..............@....
.....@....@.........
...............@..@.
.......@..@.@.......
.....@.....@........
...............@....
.....@..............
.........@..........
.......@......@.@.@.
..........@.@.......
..@.................
....@.@.@.@....@....
............@.......
....................
.......@.@..@......@
....@@..............
....................
.@..............@...
@........@..........
...@......@....@....
..@.................
.@...@.@............
......@......@......
...........@.....@..
.@..................
.............@...@..
.........@....@.....
.....@..@...........
......@.........@...
.....@...@..........
.....@..@....@.@..@.
.....@.............@
..@.................
....................
6
8 21 0
0 31 0
7 21 0
17 7 1
10 19 1
6 14 1

0 23 0
13 14 0
6 36 0
13 32 1
7 22 1
15 11 1
