width 20
height 46
........@....@@.....
............@.@.....
.@..................
....@....@..........
...@...............@
....@...@...........
...............@....
....................
.@..@....@..........
......@.............
...@...........@....
.......@...@......@.
..@...............@.
...@@....@...@......
.....@.....@...@...@
...................@
.........@......@..@
............@..@....
@.....@.............
@........@..........
........@......@....
...@.....@..........
....................
@..@.......@........
......@...@.........
.........@..@.......
.......@............
.....@@.......@.....
......@.............
..........@....@....
......@.............
.....@.......@.@....
......@.........@...
.......@............
....................
...............@....
...........@........
.....@..............
........@...........
....................
...@..@....@.@...@..
............@.@.....
....................
.@@...@........@....
.@.....@...@.....@..
...........@....@@..
6
4 29 0
2 32 0
6 36 0
14 28 1
3 0 1
8 32 1

17 21 0
18 2 0
10 17 0
16 33 1
6 20 1
3 43 1
