width 20
height 46
........@@@@@.......
......@.............
..@....@.........@..
...@...........@...@
..........@.........
............@.......
....@....@...@...@..
....................
....@...@..@......@@
...................@
..@.........@.......
.........@..@.......
..@...@.............
....@..........@....
....................
....@.............@@
...@...@.....@.....@
...................@
....................
..@...@.............
.........@..........
.....@..........@...
......@.............
...........@..@.@.@.
....................
.............@....@.
...@..........@.....
.....@..@.@......@..
......@.............
..........@...@.@...
....................
@.@.@......@........
...@@.....@.......@.
.................@..
...........@........
...@..@.............
........@.....@..@..
.....@..............
....................
.........@..........
.............@......
....................
..@.................
.@...........@......
...........@........
....@@@@.@@@........
6
7 9 0
1 34 0
10 18 0
1 44 1
15 36 1
18 16 1

11 30 0
18 11 0
10 18 0
12 18 1
12 2 1
1 32 1
