width 77
height 77
@@@@@@@@@@@@@@@@@...........@@@.........@@@@@@@@@@@@@@@@@@@@@@@@@@@@@@@@@@@@@
@@@@@@@@@@@@@@@@@@.........@@@@@........@@@@@@@@@@@@@@@@@@@@@@@@@@@@@@@@@@@@@
@@@@@@@@@@@@@@@@@@.@.......@@@@@@@..........@@@@@@@@@@@@@@@@@@@@@@@@@@@@@@@@@
@@@@@@@@@@@@@..........@..@@@@@@@@@.........@@@@@@@@@@@@@@@@@@@@@@@@@@@@@@@@@
@@@@@@@@@@@@@..........@..@@@@@@.@.....@@...@@@@@@@@@@@@@@@@@@@@@@@@@@@@@@@@@
@@@@@@@@@@@@@..........@..@@@@@@............@@@@@@@@@@@@@@@@@@@@@@@@@@@@@@@@@
@@@@@@@@@@@@@@@@............@.@@..@@...@......@@@@@@@@@@@@@@@@@@@@@@@@@@@@@@@
@@@@@@@@@@@@@@@@@.@...............@@..........@@@@@@@@@@@@@@@@@@@@@@@@@@@@@@@
@@@@@@@@@...@.....@........@..@..@@@.........@@@@@@@@@@@@@@@@@@@@@@@@@@@@@@@@
@@@@@@@@@.........@.......@@@...@@.......@@@@@@@@@@@@@@@@@@@@@@@@@@@@@@@@@@@@
@@@@@..............@....@.@@....@@...@...@@@@@@@@@@@@@@@@@@@@@@@@@@@@@@@@@@@@
@@@@@....@@..........@..@......@@@.@........@@@@@@@@@@@@@@@@@@@@@@@@@@@@@@@@@
@@@@@....@@@@........@..@@.....@@.............@@@@@@@@@@@@@@@@@@@@@@@@@@@@@@@
@@@@@@...@@@@..@@......@@@.....@@.............@@@@@@@@@@@@@@@@@@@@@@@@@@@@@@@
@@@@@@...@@@@..@@....................@...@...@@@@@.@@@@@@@@@@@@@@@@@@@@@@@@@@
@@@@@....@@@@...@@..........@.@@.........@....@@@@..@....@@@@@@@@@@@@@@@@@@@@
@@@@@....@@@@..@@@...........@@@@.............@@@@....@.@@@@@@@@@@@@@@@@@@@@@
@@@@@@...@@@@@@@....@.@......@@@...............@@@........@@@@@@@@@@@@@@@@@@@
@@@@@@...@@@@@......@...@.......................@..........@@.........@@@@@@@
..@@@.....@@@@.@...................@@@..............@.......@.........@@@@@@@
..@.......@.......@.........@.....@@@@@.@.....................@........@.....
..........@.......@...............@@@@@.@...............@@...............@@@@
.................................@@@@@@@@..........@@......@@.........@..@@@@
@.......@........@...@..@........@@@@@@@@@@........@@....@........@@.....@@@@
@.......................@..........@@@@.@@@@...................@@@@@.@....@@@
@@@.................@@@.@...@@@@.....@@...@@............................@....
@@...............@@@@@@.....@@@@@@...@@..........................@...........
@@@@@@@.........@@...@@....@@@@@@@@@@@@@........@.................@...@......
@@@@@@.....@.........@.....@@@@..@@@@@....................................@..
@@@.......@.........@@..@..@@@@..@@@@@..................@.................@..
@@.....@......@...@.@@...@.@@@....@@@@..................@...................@
@@@@@.@@@.@@........@....@..........@@@@..@@@@...........................@@@@
@@@@@@@@..........@@@...............@@@@.@@..@...........................@@@@
@@@@@@@.............@...........@@....@@....@@@@.@..............@.......@@@@@
@@@@@.......................@...@.......@...@@@@@@.@......@@@.........@@@@@@@
@@@@@@....................@............@@@..@@@@@@....@.@@@@......@...@@@@@@@
@@@@@@@@.............@...@@............@@.....@@@@@@@@@@..@@@.....@@...@@@@@@
@@@@@@@@@.........@............@.......@.........@@@@@@....@@...@@@@.@@@@@@@@
@@@@@@@@@@............@@@...........@..@.....@...@@@@@......@...@@@@@@@@@@@@@
@@@@@@@@@@@@...........................@........@@.@@...........@@@@@@@@@@@@@
@@@@@@@@@@@@@.............................................@.....@@@@@@@@@@@@.
@@@@@@@@@@@@..........................@@.@........@...@.@@@.@...@..@.....@@@.
@@@@@@@@@@@........@..................@.....@.....@..@@@@@@.@.....@@.........
@@@@@@@@@@@............@@..........@.......@@...@.@..@@@@@@@@@.....@.@.......
@@@@@@@@@@@...@@......@..........@........@..........@@@@@@@@@...............
@@@@@@@@@.....@@.....@@..............................@@@@....................
@@@@@@@@@.....@............@.@...............................................
@@@@@@@@@..................@.@...............................................
@@@@@@@@@@...................................@...........@@@.@......@@......@
@@@@@@@@@@.......@........................@.......@........@@@.......@.......
@@@@@@@@@..@@@@..@@@...............@...........@............@@.......@@@@....
@@@@@@@@....@@@@..............@@@@.@...................@@...@....@...@@@.....
@@@@@@......@@@@@...........@@@@@@..@@............@...@@@......@......@@@....
@@@@@@......@@@@@@@@.......@@@@@@@....................@@@.....@@@@.....@@....
..@@@@.......@@@@@..........@@@@@@@@@..@@..............@......@@@@...........
................@@@.........@@@@@@@@@@@@.....................................
@................@@.........@@.@@@@@.......@@............@...................
..................@@.........@..@@@........@@...@@........................@@@
@...........................@@...........@@@@@@@.................@@.......@@@
........................................@@@@@@@@.....@@.......@.......@.@@@@@
....................@.@................@@@@@@@@.....@@................@..@@@@
......@@@........@.@@................@.....@@@@@...@@..........@@....@...@@@@
...................@@.........................@@................@...@@@@@@@@@
...@@.................@............@...........@....................@@@@@@@@@
@.@@@@..........@.....@............@...........@@@..@..............@@@@@@@@@@
@@@@@@..........@..................@..........@@@..................@@@@@@@@@@
@@@@@@@@..@@.................................@@@..........@.....@@@@@@@@@@@@@
@@@@@@....@@..@.......................@.@@....@@................@@@@@@@@@@@@@
@@@@@@...@@...@..................@@@@@@@@@....@@@.@@.........@@@@@@@@@@@@@@@@
@@@@...@.@@......@@..............@@@@@@@@@...........@.......@@@@@@@@@@@@@@@@
@@........@......................@@.@@@@@@@@@...@...@@.....@@@@@@@@@@@@@@@@@@
@........................@...@@.......@@@@@@@@.@@@.@.........@@@@@@@@@@@@@@@@
..@..................@@.............@@@@@@@@@@@@@@@@@......@@@@@@@@@@@@@@@@@@
..@@@.....@@......@.................@@@@@@@@@@@@@@@@@@.....@@@@@@@@@@@@@@@@@@
@@@@@@...@@@........................@@@@@@@@@@@@@@@@@@.@....@@@@@@@@@@@@@@@@@
@@@@@@...@@@@@@......@@@.....@......@@@@@@@@@@@@@@@@@@.@@@.@@@@@@@@@@@@@@@@@@
@@@@....@@@@@@@.........@....@..@.@.@@@@@@@@@@@@@@@@@@@@@@.@@@@@@@@@@@@@@@@@@
8
14 31 0
58 74 0
74 46 0
71 41 0
17 9 0
69 46 0
41 8 0
16 59 0

18 61 0
63 36 0
57 50 0
73 43 0
52 55 0
30 41 0
58 67 0
14 65 0
