width 77
height 77
@@@@........@@@@@.......@@@@@@@@@@@@@@@@@@@@@@@@@@@@@@@@@@@@@@@@@@@@@@@@@@@@@
.............@@.@@......@@@@@@@@@@@@@@@@@@@@@@@@@@@@@@@@@@@@@@@@@@@@@@@@@@@@@
............@@@.@@.....@@@@@@@@@@@@@@@@@@@@@@@@@@@@@@@@@@@@@@@@@@@@@@@@@@@@@@
............@.........@@@@@@@@@@@@@@@@@@@@@@@@@@@@@@@@@@@@@@@@@@@@@@@@@@@@@@@
............@.@@......@@@@@@@@@@@@@@@@@@@@@@@@@@@@@@@@@@@@@@@@@@@@@@@@@@@@@@@
...........@@......@.@@@@@@@@@@@@@@@@@@@@@@@@@@@@@@@@@@@@@@@@@@@@@@@@@@@@@@@@
.........@@@@.........@@@@@@@@@@@@@@@@@@@@@@@@@@@@@@@@@@@@@@@@@@@@@@@@@@@@@@@
.........@@............@@@@@@@@@@@@@@@@@@@@@@@@@@@@@@@@@@@@@@@@@@@@@@@@@@@@@@
@........@@@...........@@@@@@@@@@@@@@@@@@@@.@@.@@@@@@@@@@@@@@@@@@@@@@@@@@@@@@
.@.@.....@@...........@@@@@@@@@@@@@@@@@@@......@@@@@@@@@@@@@@@@@@@@@@@@@@@@@@
.......@.@..............@@@@@@@@@@@@@@......@..@@@@@@@@@@@@@@@@@@@@@@@@@@@@@@
..............@.....@...@@@@@@@@@@@@.........@.@@@@@@@@@@@@@@@@@@@@@@@@@@@@@@
..@............@.........@@@@@@@@@@@...........@@@@@@@@@@@@@@@@@@@@@@@@@@@@@@
.......@@................@@@@@@@@@@@..........@@@@@@@@@@@@@@@@@@@@@@@@@@@@@@@
....@..@..................@@@.@@@@@@..@..@@..@@@@@@@@@@@@@@@@@@@@@@@@@@@@@@@@
..................@@.......@@.@@.@@@..@.@@...@@@@@@@@@@@@@@@@@@@@@@@@@@@@@@@@
.........................@..@.@...@@..@.@@.....@@@@@@@@@@@@@@@@@@@@@@@@@@@@@@
@@........@.....@.@@@@@.@........@@@..@.@@.....@.@@@@@@@@@@@@@@@@@@@@@@@@@@@@
@@@@............@@@@..@@@..........@.............@@@@@@@@@@@@@.@@@@@@@@@@@@@@
@@@....@@....@...@@@...@..........@@...............@@@@@@@@@@@..@@@@@@@@@@@@@
@@@.......................@..@...@@.@..........@..........@@@@..@@@@@@@@@@@@@
@@@.........@@@..............@@..@..@@.........@...@.....@@@@@@....@@@@@@@@@@
@@.....@..@@@@@@@@@@................@@.@@@....@@@........@@@@@@@...@@@@@@@@@@
@@@@...@@@@@@@@@@@@....................@@@@@.@@@@@.......@@@@@@@...@@@@@@@@@@
@@@@...@@@@@@.@@@@.......@@............@@@@@@@@@@@....@....@@.......@@@@@@@@@
@@@@.@@@@@@@@.@.@@......@@@............@@@@@@@@@@@..................@@@@@@@@@
@@@@@@@@@.@@@...@@@..@..@..............@@@@@@@@@@@@@......@...@.......@@@@@@@
@@@@@@@...@@@...@.....@@...............@@@@@@@@@@@.....@@@@@@@........@@@@@@@
@@@@.@@..@@@..........@.............@.@@@@@@@@@@@@@@@..@@@@@@@......@@@@@@@@@
@@.......@@@........@.........@..........@@@@@@@@@@@...@@@@.@@@......@@@@@@@@
@......@.@@@......@...........@..........@@@@@@@@...........@..........@@@@@@
.........@@@..................@........@......@@......................@@@@@@@
...........................................@.................@........@@@@@@@
.....@....@......@...@..........@..@......@@.................@......@.@@@@@@@
@....@....@@.@.........@.@@@....@.....@....@...........................@@@@@@
@........@...@..........@@@@..........@.................................@@@@@
....@..@@@..............@@...............................@@.@..........@@@@@@
.......@@..............@@........@....@...................@............@@@@@@
.........@@.....@.@@...@@.@@..................@.....@@....@......@@@...@@@@@@
@@..@@@.........@.@@..@@@..@..................@.............@...@@@....@@@@@@
@@@@@@@......@........@@@............@.@....@@@@@@..............@@@....@@@@@@
@@@@@@.........................................@@...............@@....@@@@@@@
@@@@@@@....................................@@@.@@@@@@..........@@@@.@.@@@@@@@
@@@@@@.............................@@........@@@@@@@@@@....@.@@@@@@.....@@@@@
@@@@@@....@..................@@@@@@..........@@@@@@@@.....@@@@@@@@@.....@@@@@
@@@@@....@.....@.............@@@@@@..........@@@@@@@@@....@@@@@@........@@@@@
@@@......@@.@..........@..@@@@.@@@@@@@@.....@@@@@@@@@@@...@@@@@@@.......@@@@@
@@@.......@......@@....@...@@@...@@@@@@.....@@@@@@@@@.@@..@@@@@@@.......@@@@@
@@@@......@..............@.......@@.@@@@....@@@@@@@@.....@@@@@@@@@......@@@@@
@@@@@...@.......................@@.....@....@@@@@@@@......@@@@@@@.......@@@@@
@.......................@.......@..............@@@@...@@@@@@@@@@...@......@@@
@........@@@...................@......................@@@@@@@@@@..@@.......@@
@@@@.....@@@........................@..........@........@@@@@@@@..........@@@
@@@@@....@@@..@..................@@.@..............@....@@@@@@@@..........@@@
..@@@......@..@.........@........@@..@...........@.....@@@@@@@@@..........@@@
.@@....@...@.@..@@@..............@...@@..@...@...@@@@@@@@@@@@@@@@@@.....@@@@@
.......@...@....@@@................................@@@@@@@@@@@@@@@@.@@..@@@@@
.....@....@@.....@@...@@..@.........@.............@@@@@@@@@@@@@@@...@@@..@@@@
...........@..@......@@@..........................@@@@@@@@@@@@@@@...@@@@@@@@@
.........@..............................@.........@@@@@@@@@@@@@@@...@@@@@@@@@
.@@@@....@.........@@@@.................@.........@@@@@@@@@@@@@@@..@@@@@@@@@@
.@@@@..............@@@@.......@.........@...........@@@@@@@@@@@@@..@@@@@@@@@@
...................@@@....@...@........@@@..........@@@@@@@@@@@@@@@@@@@@@@@@@
@@.................@@.......@@@.........@........@@..@@@@@@@@@@@@@@@@@@@@@@@@
@.....@.@...................@@@.........@........@..@.@@@@@@@@@@@@@@@@@@@@@@@
@.....@........@...................@@@......@................@@@@@@@@@@@@@@@@
.....@@.......@@....................@@@.....................@@@@@@@@@@@@@@@@@
.....@........@.......@@@@.........................@@@.....@@@@@@@@@@@@@@@@@@
...................@....@@@@.........@.@.....@...@.@@........@@@@@@@@@@@@@@@@
....@...................@@@@.........@.@......@..@@@.......@@@@@@@@@@@@@@@@@@
....@.............@@@..@@@@@..@...............@...@@.....@@@@@@@@@@@@@@@@@@@@
@.....@...@..@...@@@@@@@@@@@@.................@.......@@@@@@@@@@@@@@@@@@@@@@@
........@......@.@@@@@@@@@@@@@.......@....@...........@@@@@@@@@@@@@@@@@@@@@@@
......@@@@...@@..@@@@@@@@@@@....@..@@@.@@@@@.......@@@@@@@@@@@@@@@@@@@@@@@@@@
..@...@@@@@@@@@..@.@..@@@@@@.@@....@@@@@@@@@@@......@@@@@@@@@@@@@@@@@@@@@@@@@
.@@@@@@@@@@@@@.......@@@@@@@.@...@@@@@@@@@@@@@......@@@@@@@@@@@@@@@@@@@@@@@@@
.@@@@@@@@@@@@@@......@@@@@@@@@@....@@@@@@@@@@.......@@@@@@@@@@@@@@@@@@@@@@@@@
8
12 10 0
40 43 0
30 53 0
27 61 0
26 63 0
23 1 0
26 43 0
6 13 0

4 58 0
20 31 0
24 49 0
65 61 0
3 29 0
54 48 0
45 64 0
48 37 0
