width 77
height 77
@@@@@@@@@@@@@@@@@@@@.......@..................@@.@.........@@@@@@@@@@@@@@@@..
@@@@@....@@@@@@@@@@......................@..@@............@@@@@@@@@@@@@@@@@..
@@@@.....@@@@@@@@.@..........@.@.....................@....@@@@@@@@@@@@@@@@...
@@..........@@@@@......@@.................@.....@....@....@@@@....@@@@@.@@@..
............@@@@.................@..@..............@.@.............@@@@.@@..@
......@@.....@@@@..................................@@@.........@@@...@@.@@...
.........@@..@@@@.......@@..........................@@.........@.........@...
..............@@.@@@............................@....@.......@.@...@.........
.........@.......@@@......@..........@........@...@......@....@@............@
.........@.......@@@...@@.........@........................@..@@.............
.........@@....@...............@.@@@....@.....................@.@............
................@...@@@...............................@@......@..............
.......@@@......@.....................................@@@@....@@...@@@@......
.....@.@@@..........................@..@...@..........................@....@@
@@...@@@@@.............@@...........@@@@.........@.....@@........@.........@@
@@@@....@@.............@...........@@@@................@@....................
@@@@@......@@.....@@......@@.......@@@@......@.........@@@@@@...............@
@@@@@........@....................@@@@@........@.....@.@@@@@@@.........@..@..
@@@@@........@@............@......@@...................@@@@@@@@@.............
@@@@......@.@@@.@@................@@..................@.@@@@@@@@.............
@@@@@...@@@.@@@..@.............@............@............@@@@@@@.............
@@@@@...@@..@@@@@@@@@..@@......@@...........@............@@@@@@@.....@.@@....
@@@@@...@....@@@.@@@..@@@......@@..@@.@..@@..............@@@@@@@.....@@@@....
@@@.@@...........@@@.......@@......@...................@@@@@@@@@.......@@....
@@@.@@@..........@@.......@@........@.....................@@@@@@@@@@...@@....
..@.............@@@........@......................@@.......@..@.....@..@@....
.......@@@.@..@@@@@@@...............@@.............@.........................
...............@@@@@@.............................................@..........
............@..@@@@@@.......@....@@.......................@@....@@@.@@.......
..............@..@@@....@........@......@@@@.@............@@..@@@@@@@@.......
@.............@..@@@....@.@........@@....@@@..................@@@@@@@@@@.....
@............@@..@.................@@.@@.@@@....@..........@..@@@@@@@........
@............@@....................@.....@...@..@@.......@@....@@@@@@........
....@........@....................@@............@@@@@@@@..@@..@@@@@@.........
..@....@...........@...........................@@@@@@@@@@@@@..@@@@@@...@.....
..@@...@...........@..@.@........@..............@@@@@@@@...@....@@@@...@....@
.......@@@........@@..@@........................@@@@@@@@....@@@.@.@....@@..@@
@@.....@@@......@@@@............................@@@@@@.@.....@@...........@@@
@@...@@@@.........@........................@...@@@@@@........@@...........@@@
@@....@@@..................................@...@@@.@@....@..@@...........@@@@
@@....@....................@.........@...@@@....@@.......@..@@...@........@@@
@@............@....................@@@...@@@..............@....@....@@@...@@@
@..................@...@..@@.@@@@@@@@@@..@.................@......@@@@....@@@
..@.@.@@......@@....@....@....@@@@@@@@@..@@................@.....@@@@@.....@.
@@@@@@@@@...............@......@.@@...........................@.@@@@@@@......
@@@@@@@@@............@.@@........@@.............@.......@.....@..@@@@@@.....@
@@@@@@@@@@@...@....@@@@.@@@@@.@...........................@...........@@@...@
@@@@@@@@@@@...@@...@@@....@@@...........................@@@...........@@@....
@@@@@@@@@@@@.......@@.....@@@.............@.......@@.....@@.@@.....@@@@@@....
@@@@@@@@@@@@@...@@...@....@@...............@......@.....@@.@@@......@@@@@..@.
@@@@@@@@@@@@@@..@@@.....@..@..@............................@@@@......@@@@....
@@@@@@@@@@@@@@@.@@@.....@.@@.................@.............@@@@........@@....
@@@@@@@@@@@@@@@........@@@@@................................@@@..........@.@.
@@@@@@@@@@@@@@@.........@............@@@@........@.............@.....@.......
@@@@@@@@@@@@@@@..........@.........@...@@.@..@.@@@.@@..........@..@@@@.....@@
@@@@@@@@@@@@@@@@.@...@.......@.........@@.....@............@......@@@@....@@@
@@@@@@@@@@@@@@@@@@...........@@........@@..................@......@@@@@....@@
@@@@@@@@@@@@@@@@@@...........@@........@@..................@..@....@@@......@
@@@@@@@@@@@@@@@@@@..@.........@...............................@....@@.......@
@@@@@@@@@@@@..@@@@..@@@.......@.......................@....@................@
@@@@@@@@@@@@..@@@@..@@@.......................@......@@@.........@.........@@
@@@@@@@@.@@...@@@@.....................@@............@.@@@..........@@@...@..
@@@@@@@...@....@@........................@......@......@@.................@..
@@@@@@...........@...................@....@..................................
@@@@.....................@@....@...........@..........@................@.....
@@@@...........@.......@@@@@@........@.@@....................................
@@@@...........@.......@@@@@@........@.@@@......@.......@.....@@....@........
.@@....................@@@@@@.......@@@@@@@@.......................@.......@@
.........@@............@@@@@@.......@@@@@@@@@.....@.............@..........@@
....................@@@@@@@@@@..@@@..@@@@@@@@@@...@.......@......@.@.....@@@@
@@@..................@@@@@@..............@@@@@@@...........@..@.@.....@.@@@@@
@@@@@....@@............@............@..@....@@@............@...........@@@@@@
@@@@@...........................@...@..@....@@......@..@...............@@@@@@
@@@@@@@........@...@..@@@@@...............................@.....@.@@.@.@@@@@@
@@@@@@...........@.@@@@@@@@@.........@.......@@....@...........@@.@@....@@@@@
@@@@@@...........@@@@@@@@@@........@.........................@@@@.@@.....@@@@
@@@@@@........@@@@@@@@@@@@@@@@@....@@@..@@.................@@@@@@@@@@...@@@@@
8
25 22 0
23 46 0
29 64 0
29 37 0
1 25 0
21 8 0
6 10 0
24 63 0

70 60 0
70 7 0
29 23 0
52 58 0
26 12 0
71 54 0
17 10 0
55 32 0
