width 77
height 77
@@@@@@@@@@@@@@@@@@@@.....@@..@@@@@@@@..@@............@@@@@@..@@@@@@@..@@.@..@
@@@@@@@@@@@@@@@@@@.@..........@@@@@@@..................@@@@....@@@@.........@
@@@@@@@@@@@@@@@@@@......@.....@@@@@@@.....@...........@@@@@..................
@@@@@@@@@@@@@@@@@@......@.@...@@@...........@.@@@.....@@@@................@..
@@@@@@@@@@@@@@@@..............@@@.............@@@@....@@@@...@......@@...@@@@
@@@@@@@@@@@@@@@@@.......@.......................@@@...@@...@@@....@@....@@@@@
@@@@@@@@@@@@@@@@@.......@.......................@@....@@@..............@@@@@@
@@@@@@@@@@@@@.@@@.......@................@@....@@...................@...@@@@@
@@@@@@@@@@@@..@@@@......................@.................@@.@@.........@@@@@
@@@@@@@@@.....@@@@.......@@......@@@..........@@.........@@@.............@@@@
@@@@@@@@.................@@......@@@@...........@.......@@@@@...........@@@@@
@@@@@@@@@@.......................@@@@............@......................@@@@@
@@@@@@@@@@@@.................@...@@@.............@@...@........@@@....@@@@@@@
@@@@@@@@@@@@........@..........@.....................@@@.....@@@@@@@@@@@@@@@@
@@@@@@@@@@@@@........................@@.............@@@@.....@@@@@@@@@@@@@@@@
@@@@@@@@@@@@@@@...............@....@.................@@@.....@@@@@@@@@@@@@@@@
@@@@@@@@@@@@@@@@@@..@......@.........................@.....@.@@@@@@@@@@@@@@@@
@@@@@@@@@@.@@@@@@@.......................@...@.....@@@..........@@@@@@@@@@@@@
@@@@@@@........@.@@.........@....@.................@............@@@@@@@@@@@@@
@@@@@@@.........................................................@@@@@@@@@@@@@
@@@@@@@@@@.................@@.................................@@@@@@@@@@@@@@@
@@@@@@@@@@.......@..@.@.....@.....................@@..........@@@@@@@@@@@@@@@
@@@@@@@@@@@.........@@@...@.@@.............................@...@@@@@@@@@@@@@@
@@@@@@@@@@................@..................@................@@@@@...@@@@@@@
@@@@@@@@@@............@.......@..@.........@@@..........@......@@@@...@@@@@@@
@@@@@@@@@@@@@@@@......@....................@@...........@..@..........@@@@@@@
@@@@@@@@@@@@@.......@....................@............@.@.....@.......@..@@@@
@@@@@@@@@@@@@...........@@@.....@@.........................@@.............@@@
@@@@@@@@@@@@@............@@@...@@@.....@.....@@..@.........@...............@@
@@@@@@@@@@.............@.........@.....@.........@.........................@@
@@@@@@@@@@.............@........@..................@..........@@@...........@
@@@@@@@@@@...........@@@......@.@.........@@@........................@..@..@@
@@@@@@@@@@@...............................@@@...............................@
@@@@@@@@@@@...............@@...@.@@@@........................................
@@@@@@@@@@@....................@@@@@.@...............................@@......
@@@@@@@@@@@.........@.............@...................@@@................@@..
@@@@@@@@@@@......@..@........................................................
@@@@@@@@@@@...............@.........................@.......@...........@.@.@
@@@@@@@@@@@........................@..@.................@@@@@.@.....@@@.@@@@@
@@@@@@@@@@....@....@............@.....@.@................@@.........@@..@@@@@
@@@@@@@@@@........@...............@@@.@@@@.@.............@@.........@@....@@@
@@@@@@@@@@........@@@...@...........@@@@@@@@@....@......@@@......@...@....@@@
@@@@@@@@................@..........@@@@@@@@@..@@@@.@....@@.......@@.......@@@
@@@@@@@@............@@@@@@....@.........@@@@....@@@........................@@
@@@@@@@@............@@@.@@.@.......@@...@@@@@...@..@....@...................@
@@@@@@@@@............@.............@......@@@@.........@@@......@...........@
@@@@@@@@@@@.........@@...........................@@...@@@...................@
@@@@@@@@@@@...@@@..@@............@@...................@@@.............@@@...@
@@@@@@@@@@@@@.@@@@@@..................................@................@@...@
@@@@@@@@@@@@@@@@@@@..........@......................@.............@....@@@.@@
@@@@@@@@@@@@@@@@@@@@@@@@...............................@.............@@@....@
@@@@@@@@@@@@@@@@@@@@@@@@......................@..........@...................
@@@@@@@@@@@@@@@@@@@@@@@@..@@..@@............@........@@@@@...................
@@@@@@@@@@@@@@@@@@@@@@@@.........@......................@@@..................
@@@@@@@@@@@@@@@@@@@@@@@@@@@@........@.@..................@@@..........@......
@@@@@@@@@@@@@@@@@@@@@@@@@@@........@@@@..............@@......................
@@@@@@@@@@@@@@@@@@@@@@@@@@@......@.@@@@............@@@@@...............@.....
@@@@@@@@@@@@@@@@@@@@@@@@@@.......@..@@@@......@@@@.@@@@.........@............
@@@@@@@@@@@@@@@@@@@@@@@@@@......@...@@@@@...@@@@@@@@@@.@...........@..@..@.@.
@@@@@@@@@@@@@@@@@@@@@@@@@.....@...........@@@@@@@@@@@@.....@....@.....@...@..
@@@@@@@@@@@@@@@@@@@@@@@@@.@...@...@......@@@@@@@@@@@@@...@@@@...@.........@@.
@@@@@@@@@@@@@@@@@@@@@@@@@................@@@@@@@@@@@@@@@@@@@@...........@.@@@
@@@@@@@@@@@@@@@@@@@@@@@@@@................@@@@@@@@@@@@@@@@@@@...@.........@@@
@@@@@@@@@@@@@@@@@@@@@@@@@@@@..................@@..@@@@@@@@@@..............@@@
@@@@@@@@@@@@@@@@@@@@@@@@@@@@....@.................@@@@..@.................@@@
@@@@@@@@@@@@@@@@@@@@@@@@...@....@...................@@....................@@@
@@@@@@@@@@@@@@@@@@@@@@@@..........................@.@@.......................
@@@@@@@@@@@@@@@@@@@@@@@@@.....@@@@.........................@@@.........@....@
@@@@@@@@@@@@@@@@@@@@@@@@@@@@.@@@@@.....@....@@....@@.......@@@.@@@...@@@...@@
@@@@@@@@@@@@@@@@@@@@@@@@@@@@@@@@@@...@@.....@....@@@......@@@@@@@@@@@@@@.....
@@@@@@@@@@@@@@@@@@@@@@@@@@@@@@@@@................@@@...@@@@@@@@@@@@@@@@@@....
@@@@@@@@@@@@@@@@@@@@@@@@@@@@@..@@.......@........@@@...@@@@@@@@@@@@@@@@......
@@@@@@@@@@@@@@@@@@@@@@@@@@@@@....................@@@...@@@@@@@@@@@@@@@@@.....
@@@@@@@@@@@@@@@@@@@@@@@@@@@@@.......@...@@@@@...@@@@...@@@@@@@@@@@@@@@.....@@
@@@@@@@@@@@@@@@@@@@@@@@@@@@@@............@@@@@@@@@@@@@@@@@@@@@@@@@@@@@....@@@
@@@@@@@@@@@@@@@@@@@@@@@@@@@@@............@@@@@@@@@@@@@@@@@@@@@@@@@@@@@.....@@
@@@@@@@@@@@@@@@@@@@@@@@@@@@@@@.@@.....@@@@@@@@@@@@@@@@@@@@@@@@@@@@@@@......@@
8
51 22 0
74 76 0
73 76 0
60 56 0
44 10 0
46 52 0
75 47 0
17 44 0

34 32 0
74 45 0
40 53 0
59 20 0
70 76 0
34 25 0
33 35 0
71 73 0
