width 77
height 77
@@@@@@@@@@@@@@@..........@@@..........@@.......@.......@@@@@@@@@@@@@@@.....@@
@@@@@@@@@@@@@@@........................@......@@.@.....@@@@.@@.@..........@@@
@@@@@@@@@.@@@@@..................@@...........@..@@@@..@@@..@............@@@@
@@@@@@@@......@..@..............@......................@................@@@@@
@@@@@@@..........@...@......@@@...................@.......................@@@
@@@@@..............@...................@@....@............................@@@
@@@@@..@@.........@@.................@@@@....@................@..@..@..@.....
@@....@@@..........@...................................@..@...@@.@...........
@@@..@.@@@@.........................@..................@......@.....@......@@
@@@.....@..............@@.............................@@....................@
@................@......@@@...............@@...@.............................
..........@...........@@@@@....................@.............................
.........@@...........@@@@@....................................@@............
......................@@@@@.......................................@@@@@......
..@@....@.................@.....................@@@...@.@@@@....@@@@@@.......
..............@.......................@@....@@@@@@.......@@......@@@@........
............@......@................@@@@...@@@@@@@.......@@......@@@@@...@...
....@.....@@@.@@......@@.....@@@.@@@@@@@@.@@@@@@@@@.....@@@@@@..@@@@@@.......
@...@.....@@@.@@..............@@@@@@@@@@@@@@@@@@@@......@@@@@@...............
....@......@@@......@.........@@@@@@@@@@@@@@@@@..@......@@@@@................
....@@...@.@@...............@.@@@@@@@@@@@@@@@@@...........@@@...............@
..@@@@.....................@@.@@@@@@@@@..@@@....@........@@@@@....@....@....@
@@@@@@...................@@@@..@@@..@@@....@.............@@@@.....@@.@.......
@@@@@@@........@@.......@@@......@..@@...................@@@@@@...@@.........
@@@@@@@@@......@........@@.........@@@.........@..................@@@........
@@@@@@@@@......@@...@.@@@@.........@.............@@@@........................
@@@@@@@@@@.....@@.......@@........................@@@@..........@...........@
@@@@@......@.@@@@@.............@..................@@@@......@@@@@.........@@@
@@@@............@..............@@@@..........@@@.@@@@@......@@@@@@........@@@
@@@@............@...............@@@.@........@@@@@@@.@@......@@@@...........@
@@@@....................@......@@@@..@@.....@@@@@@@@......@.@@@@...........@@
@@@.............@@@..........@@@@@@.........@@@@@@@@......@@@@@............@@
@@@.......@......@@.........@@@@@..........@@@@@@@@@......@@@@@@............@
@@@@......@......@@.........@@@@@@@@....@..@@@@@@@@@@....@@@.................
@@@@@....@....@...@@@@.@@..@@@@@@@@@......@@@@@@@@@@@@@@@@@..............@...
@@@@@@.............@@@@@..........@........@@@@@@@@@@@@@@@.........@@.@.@...@
@@@@@@..@..........@@@@@@..................@@@@@@@@@@@@@@@.......@@@@......@.
...@@@@@@..........@@@@@....@................@@@@@@@..@@@@@....@.............
.....@@@..........@...@@..@@@..........@.......@@@......@.@................@@
.................@.....@@@@@@......@...@@...@...@@.............@...........@@
@@..............@@.....@@@@@@..@...@.........................................
..@......@.............@@@@@@@@@.@.@.@.......@................@@.............
........@@@@@....@.....@@@@@@..@..@@..................................@.....@
........@@@@@.............@@@............@...........@@@@@@@...........@....@
........@@@@@@..............@...........@@............@@@@@...@@....@@.@.....
.......................@...............@@@..............@...@@@@..@@@........
....@................@@@@..............@@@..@................@....@@@........
@.@@@@..................@@.@@@@.........@@@@.................................
@..@@@@@.......@@@@....@.....@@@.......@@@@@@@@@..@.@...................@....
@@@@@@@@......@@@..........@.@..@......@@@@@@@@@@........@...................
@@@@@@@.......@@@.........@@...........@@@@@@@@@@....................@.......
@@@@@@@.......@...........@.............@@@@@@@@@.@@@.....@..@..@.@......@...
@@@@@@@.............................@...@@@@@@@@@.@@.........................
@@@@@...............................@.@@@@@@.@@@@.@@.........................
@@@@@@.........@...........@.......@@.............@@....@.........@..........
@@@@@@@....................@.......@@..@@...@................@....@@.........
@@@@@@....@...................@@..@@@....@......@............................
@@@@@@@@@.......@@............................@@.......@...@.................
@@@@@@@@@.....@@@..........................@..@@.............................
@@@@@@@@@@.@@..@@...@...................@@.....@...............@@............
@@@@@@@@@@@@@..@.........................@@....................@.............
@@@@@@@@@@@@............@.......@..@...........@@.....................@......
..@.@.....@@...................................@@@@......@.@...........@@@...
............@........................@......@...@@@....@@@@@.@..@........@...
.........@..........@...@..........@@@...........@@.@...@@@@@@@..............
...@@@..............@............................@@@@...@@@@@@...............
@@..@@...@...................@.@@@@@............@@@@@@@@@@@@@@..@............
@@..@.............@..........@@@@@@........@@@...@@@@@@@@@.@................@
@@.........@..................@@@@.....@@@.......@@@@@@@@.....@@.........@...
.......................@@@@...@@......@@@...@@@@@@@@@@@@@.....@@......@.@....
@@@..................@@@@@@@@@@.......@.@..@@@@@@@@@@@@@@..@@@@@@.....@@@@...
@@@..........@@......@@@@@@@@@@@.@..........@@@@@@@@@@@@@@@@@@@@@@.....@@@@.@
@@@..................@@@@@@@@@@@@...........@@@@@@@@@@@@@@@@@@@@@@@@@.@@@@@@@
@@@...@....@@@........@@@@@@@@@@@@...........@@@@@@@@@@@@@@@@@@@@@@@@@@@@@@@@
@@@@.@@@..............@@@@@@@@@@@@@..........@@@@@@@@@@@@@@@@@@@@@@@@@@@@@@@@
@@@@@@................@@@@@@@@@@@@@....@.....@@@@@@@@@@@@@@@@@@@@@@@@@@@@@@@@
@@@@@@...........@@@@@@@@@@@@@@@@@@..@@.....@@@@@@@@@@@@@@@@@@@@@@@@@@@@@@@@@
8
69 35 0
33 50 0
31 70 0
72 31 0
23 68 0
68 50 0
17 26 0
12 37 0

58 35 0
61 38 0
38 59 0
20 45 0
66 10 0
53 1 0
75 71 0
40 31 0
