width 20
height 39
........@...........
...@.@..............
........@...........
@.............@.@...
@@...@....@.........
@@..................
@...@.......@..@....
..@..@..............
.........@..@.......
...@......@....@.@.@
....@...@.......@...
....................
............@..@....
.........@.@..@.....
......@........@....
.@..........@.....@.
....................
......@....@.@...@..
.....@..@...........
....@..............@
...............@...@
....................
..@..........@......
......@.......@.....
...............@....
...@@...........@...
........@..@......@.
....................
..........@..@.@....
....................
...........@.....@..
@...@..@@...........
........@...........
....@.......@.......
...............@....
......@...@.........
.................@..
@@........@.........
@...................
6
9 1 0
2 25 0
0 17 0
6 16 1
3 6 1
8 5 1

7 23 0
0 27 0
11 24 0
16 1 1
19 38 1
5 5 1
