width 20
height 39
..@.................
.......@............
...@......@.........
.........@..........
.....@..............
.............@......
.......@..@......@@@
.....@..........@@@@
..@.........@..@.@@@
@........@....@....@
....................
......@.............
.@.......@.......@..
.............@......
...@................
....................
.......@.......@....
....................
.....@.........@....
....................
..@@......@.........
..@.........@.......
....@...............
..........@.........
....@....@..........
.......@...........@
..............@.....
@..@........@.......
............@.@.....
............@.......
...@.......@........
...........@........
@.....@...@@..@.....
@@@..@.....@@.......
@@@...............@@
@@@......@........@@
..................@@
.......@.....@.@@.@@
..........@@@@@@@@@@
6
6 26 0
15 20 0
7 30 0
13 7 1
3 36 1
5 10 1

7 34 0
14 14 0
13 32 0
3 11 1
13 22 1
9 31 1
