width 20
height 39
..............@@@@.@
..........@.@.......
...........@........
..@..@.@......@.....
.@@.................
.@@.................
........@........@.@
...@................
............@.@....@
...........@.......@
............@...@@..
....................
...........@...@....
............@.......
....................
....................
..............@.....
....@............@..
....................
......@......@.....@
....................
............@..@....
....@..........@....
.....@..............
.........@....@@@...
........@.@...@@@...
............@.@@....
.....@..............
....................
......@.@...........
.............@......
...........@........
....@........@......
..@....@......@.....
....................
...........@...@.@..
..........@.........
..@.................
.....@@.............
6
0 27 0
7 26 0
6 22 0
9 33 1
7 34 1
7 4 1

16 1 0
8 8 0
19 16 0
8 36 1
10 34 1
10 11 1
