width 20
height 39
.........@@@@@@@@@..
..........@..@@@@...
..........@.........
.......@........@...
...............@....
...@...@........@...
....@.....@.........
....................
....................
.......@............
....@.@...@..@.@....
.........@.......@.@
..@................@
.....@...@..@......@
..................@.
.@@.....@.@.@.......
.........@..........
..............@..@..
.........@..@.......
..@.@...............
...........@..@..@@.
.......@.........@..
...@.......@........
........@....@......
..........@...@...@.
.......@............
...@............@...
.......@.@.........@
....@............@..
........@....@......
@......@...@..@.....
...@..@........@....
................@...
............@.....@.
.................@..
..............@.....
.................@..
..@.....@....@......
....................
6
7 7 0
18 27 0
1 21 0
19 35 1
1 12 1
1 11 1

9 31 0
11 17 0
18 0 0
1 8 1
14 11 1
17 29 1
