width 18
height 18
........@@@.....@.
..........@.......
..@@......@......@
..@...............
..................
..................
.........@..@.....
.....@............
.@...@............
...@......@.......
.....@............
@...........@@@@@@
@...........@@@@@@
@.......@.@@@@@@@@
@@@...@.....@@@@@@
@@@.....@@..@@@@@@
@@@.....@@....@@@@
@@......@@@@..@@@@
8
11 3 0
2 9 0
5 0 0
5 17 0
17 8 0
17 3 0
10 7 0
13 4 0

15 6 0
5 17 0
2 10 0
4 13 0
4 7 0
5 13 0
2 12 0
4 0 0
