width 18
height 18
@.......@..@@@@..@
@...........@@....
@........@..@@....
@.................
@.....@...........
@@@.......@@@@....
@@@@@@@...@@@@@...
@@@@@@..@@@@@@@@@@
@@@@@...@@@@@@@@@@
@@@@....@@.@@@@@@@
@@@@........@@@@@@
@@@@.....@....@..@
@@@......@.......@
@@.@.....@......@@
@@.............@@@
@@....@.........@@
@@....@.........@@
@@....@@........@@
8
6 8 0
13 4 0
3 2 0
6 5 0
12 11 0
13 14 0
5 8 0
4 3 0

7 7 0
8 6 0
5 9 0
8 16 0
13 12 0
14 2 0
7 9 0
1 2 0
