width 18
height 18
@@@@@@@@...@@.....
@@@@@@@@..........
@@@...........@@.@
........@........@
...@............@@
...............@@@
..........@....@@@
..........@....@@@
..@@...@@......@@@
...@...........@@@
..@.............@@
..................
..................
...@..............
...@..@@..@...@..@
@.....@..........@
@.....@@.........@
...@.......@@@@..@
8
2 6 0
13 14 0
3 11 0
10 9 0
1 9 0
3 16 0
1 12 0
8 14 0

9 6 0
2 7 0
15 3 0
12 5 0
16 1 0
4 9 0
13 6 0
8 15 0
