width 18
height 18
@@@@@@@@@@@@@@@@@@
@.@@@@@@@@@@@@@@@@
....@@@@@@@@@@@@@@
@.@.@@@@@@@@..@@..
@....@@@@@@...@@@.
@@..@@@@@@@...@.@.
....@@@@@@@.......
....@.@.@@@.......
..................
@..@...@@@.....@..
@@@@@...........@@
@@@@..............
@.......@......@@@
@...@@.@@....@@@@@
@...@@@@@...@@@@@@
@.....@@@...@@@@@@
...............@@@
..@.@..........@@@
8
12 10 0
0 6 0
1 7 0
9 16 0
11 13 0
10 12 0
11 5 0
13 7 0

2 5 0
12 7 0
3 6 0
5 9 0
7 12 0
10 12 0
12 3 0
2 12 0
