width 18
height 18
@@@@@@@@..........
@@@@@@@@..........
@@@@@@@...........
@@@@@@@...........
@@@@@@@.........@@
@@@@@@@@.........@
@@@@@@.......@@.@@
@@@@@@...@@@....@@
@@@@@@..@@@@@.....
@@@@@@@@@@@@@....@
@@@@@@@@@@@......@
..@@.@@@@@.......@
...............@..
...@..............
...........@@.....
..........@@@.....
..........@@@.....
.......@@@@@@.....
8
1 11 0
6 14 0
7 15 0
14 3 0
9 14 0
17 0 0
9 12 0
4 12 0

13 17 0
8 14 0
16 16 0
16 0 0
17 17 0
6 14 0
8 12 0
4 12 0
