width 18
height 18
@@..@@@@.@@@@..@..
@@................
@@......@@........
@@@.....@@.......@
@@....@...........
@@....@...........
@@................
@@............@...
@@...........@@...
@@................
@.................
@@@@........@@....
@@@@@.@.@@...@@...
@@@@@@@@@@@..@@@@@
@@@@@@@@@@....@@@@
@@@@@@@@@@@...@@@@
@@@@@@@@@@@.....@.
@@@@@@@@@@........
8
15 11 0
6 2 0
13 5 0
13 3 0
15 6 0
4 10 0
5 11 0
10 2 0

5 6 0
11 12 0
8 4 0
14 17 0
14 5 0
5 5 0
9 6 0
4 1 0
