width 18
height 18
@........@........
@.@...............
..................
..................
........@@@.......
..................
..................
..................
..@..@............
.....@............
@...........@@....
@@................
@@@@..@@@.......@.
@@@@@@@@@.......@@
@@@@@@@@@@@@.@.@@@
@@@@@@@@@@@@.@@@@@
@@@@@@@@@@@..@@@@@
@@@@@@@@@@...@@@@@
8
13 12 0
16 5 0
12 14 0
1 9 0
1 4 0
14 8 0
15 12 0
7 8 0

3 0 0
8 6 0
13 11 0
3 7 0
0 2 0
2 5 0
1 0 0
3 10 0
