width 18
height 18
@@.............@@@
@@................
@.................
@.................
@........@@.......
.........@@.......
............@..@@@
........@......@@@
.......@@......@@@
.......@@@......@@
.............@..@@
............@@....
...........@@@....
.....@.....@@.....
@@......@...@@....
@@@@@...@.........
@@@@@@@@@@........
@@@@@@@@@@....@...
8
5 12 0
5 3 0
10 10 0
6 2 0
9 1 0
5 5 0
1 12 0
6 7 0

2 12 0
7 3 0
10 13 0
14 15 0
1 7 0
15 16 0
17 1 0
11 6 0
