width 18
height 18
...@@@@@@@@@...@@@
..@@@@@@@@@@...@@@
....@@@@@@@..@@@@@
@@..@@@@...@.@@@@@
..............@@@@
@.......@.......@@
..@.......@......@
@.........@@......
@.................
@@@@..............
@@................
................@@
............@....@
................@@
.................@
.............@...@
@..@.....@@@.@@@@@
@@@@.@@@.@@...@@@@
8
8 15 0
11 11 0
0 15 0
8 7 0
6 14 0
9 15 0
9 8 0
13 12 0

1 7 0
1 5 0
5 6 0
8 10 0
15 15 0
15 8 0
1 16 0
10 9 0
