width 99
height 99
@.@@@@@@@@@@@@@@@@@@@@@@@@@@@@@@@@@@@@@@@@@@@@@@@@........@@@.@@@......@@.@@@@@@@....@@@@@@@@@@@@@@
@.@@@@@@@@@@@@@@@@@@@@@@@@@@@@@@@@@@@@@@@@@@@@@@@@........@@.......@...@@..@@@@@@...@@@@@@@@@@@@@@@
.........@@@@@@@@@@@@@@@@@@@@@@@@@@@@@@@@@@@@@@@@@.....................@...@@@@@@....@@@@@@@@@@@@@@
.........@@@@@@@@@@@@@@@@@@@@@@@@@@@@@@@@@@@@@@@@@.....@..................@@@@........@@@@@@@@@@@@@
......@...@@@@@@@@@@@@@@@@@@@@@@@@@@@@@@@@@@@@@@@......@.......@@@...@.....@@...@....@@@@@@@@@@@@@@
......@...@@@@@@@@@@@@@@@@@@@@@@@@@@@@@@@@@@@@@@@@.....@....@@....................@.......@@@@@@@@@
@.........@@@@@@@@@@@@@@@@@@@@@@@@@@@@@@@@@@@@@@@@.....@@.................................@.@@@@@@@
@@..@....@@@@@@@@@@@@@@@@@@@@@@@@@@@@@@@@@@@@@@@@@@........@..........@@@...................@@@@@@@
@........@.@@@@@@@@@@@@@@@@@@@@@@@@@@@@@@@@@@@@@@@@....................@@............@@.....@@@@@@@
...........@@@@@@@@@@@@@@@@@@@@@@@@@@@@@@@@@@@@@@@.......................................@@@@@@@@@@
.....@@@@.....@@@@@@@@@@@@@@@@@@@@@@@@@@@@@@@@@@@@.......@@@..............@....@.........@@@.@.@@@@
........@@....@@@@@@@@@@@@@@@@@@@@@@@@@@@@@@@@@@@@@@.............@..@@@.@@@....@...............@@@@
.@@@.....@......@@@@@@@@@@@@@@@@@@@@@@@@@@@..@@@@@@@@....@.......@..@@@.@@@@...@..............@@@@@
@@@@@............@@@@@@@@@@@@@@@@@@@@@........@@@@@@..@..@.......@......@@@@@..........@......@@@@@
@@@@@@@@..........@@@@@@@@@@@@@@@@@@@........@@@@@@........................@@@@@..........@...@@@@@
@@@@@@@@.....@@...@@@.@@@@@@@@@@@@@@@..@.....@@@@@....................@....@@@@@..........@@.@@@@@@
....@@@.....@@@....@@..@@.@@@@@.@@@.......@..@.@..................@.......@@@@@@@@......@.....@@@@@
....@@@.....@@@@...@..@@@.@@@@@...........@..@.............@......@@...........@@@............@@@@@
....@@@@....@@@@..@@....@.@@..............@@...@..............@@........@@................@..@@@@@@
.....@@@......@..@@@....@.............@...@@.....@@.@.........@@.........@.......................@@
@..@.....@......@@@@@@.........@@@.......@@@...@@@@.@..............................@@.......@......
@@.....@........@@@@@@........@@....@@...@@@...@@@............@.........@...............@...@......
...@...@.........@@@@@........@.....@@....@@...@@@..@@@............@.......@................@.@....
...........@.....@@@@@...............@....@@.....@.................@...............@........@......
.................@@@........................@...@@@@@@@............@........@......................
....@..............@@.......................@....@@@@........@...................@.................
@..........@....@@@@@@............@......@@.@....@@..........@...@@........@.....@......@........@.
@...............@@@..@......@..@@...@@@..@.....@.@@.....@............@....@@..........@..@...@..@@.
@..............@@..............@@.....@............................@......@@..................@@@@@
.........................@@....@......................@..............@@...@@...............@@@@@@@@
....................@........................................@@..........@@@@...@...........@@@@@@@
...................@@....@.....................@@@@@...@...............@@@@@@@.@@@@.......@.@@@@@@@
@@.......................@......@@@..@...@.....@@@@...@@...@......@.....@@@@@@.@@@@.......@.@@@@@@@
@@...........@.....@..........@@@@@...@................@...@@@...........@@@@@@@@@@@..@@.....@@@@@@
@.................@@...........@@@@.....@..............@@..@@@..@@......@@@@@@@@@@@@@@.......@@@@@@
....@..........................@@@@......@.............@@@@@@@@.........@@@@@@@@@@@@@@......@@@@@@@
.@@.@...............@@@@..@..@@.@@....................@@@@@@.........@@..@@@@@@@@@@@@@.@@@..@@@@@@@
.@@.........@.......@@@............@@.................@@@@@..........@....@@@@@@@@@@@@@@@@...@@@@@@
...........@@.......@@@..........@.@.................@@@@@@...............@@@@@@@@@@@@@@@@@@@@@@@@@
............@..@....@@.......@.@@@........@@.........@@@.......@......@@..@@@@@@@@@@@@@@@@@@@@@@@@@
............@@...@...........@@@@@........@........@@@@@..@.@.@@..........@@@@@@@@@@@@@@@@@@@@@@@@@
......@...@..............@@..@@@@@............................@...........@@@@@@@@@@@@@@@@@@@@@@@@@
..........................@...@@@........@....@.@...@....................@@@@@@@@@@@@@@@@@@@@@@@@@@
@....@........@................@..........@..............................@@@@@@@@@@@@@@@@@@@@@@@@@@
@..............................@.@@@@@....@........@......................@@@@@@@@@@@@@@@@@@@@@@@@@
..................................@@@@.................@................@.@@@@@@@@@@@@@@@@@@@@@@@@@
......@@.....@......@.............@@@@....................................@@@@@@@@@@@@@@@@@@@@@@@@@
.............@......@@@...........@@@@...................................@@@@@@@@@@@@@@@@@@@@@@@@@@
@.@.......................@@@@@@@@@@@.......@..@....@...............@.@..@@@@@@@@@@@@@@@@..@@@@@@@@
....................@.@.@@@@@@@@@@@@@@@.......@@...........@...@@.@@@@@@@@@@@@@@@@@@@@@@@....@@@@@@
.......@............@.@@@@@@@@@@@@@@@@@@@@@@@@@................@@@@@@@@@@@@@@@@@@@@@@@@@@.......@@@
.@@@..@@...........@@@@@@@@@@@@@@@@@@@@@@@@@@@@@@@@@..@@.......@@@@@@@@@@@@@@@@@@@@@@@@@@@.....@@@@
.@@...@@@............@@@@@@@@@@@@@@@@@@@@@@@@@@@@@@@............@@@@@@@@@@@@@@@@@@@@@@@@.......@@@@
@@@@....@.......@...@@@@@@@@@@@@@@@@@@@@@@@@@@@.....................@@@@@@@@@@@@@@@@@@@...........@
@@@@@......@....@@..@@@@@@@@@@@@@@@@@@@@@@@@@@@........................@@@@@@@@@..@@@@..@@@....@.@@
@@@@@@........@@@@..@@@@.@@@@@@@@@@@@@@@@@@@@@@.....@.....@.........@..@@@@@@@@@.@@@@@.........@@@@
@@@@@@@........@.@@@..@....@@@@@@@@@@@@@@@@@@@@......@..@@@....@@...@..@@@@@@@......@@.........@@@.
@@@@@@......@....@.......@@@@@@@@@@@@.@@@@@@@.@......@......@.@........@@@@@@@.......@.@.......@@..
@@@@@@...................@@@@@@....@@.@@@@@@............................@@@@@@............@@@......
@@@@@@......@...........@@@@@@.....@@....................@.....@.......@@@@@@@.....................
@@@@@@@.....................@@..................@........@.....@.......@@@@@@@....@.............@..
@@@@@@@@............@.................@.........@.....@...............@@@@@@...........@..@........
@@@@@@@@..@@......@@@...............@@........@...........@...........@@@@@@..............@.......@
@@@@@@@@............@..............@@@.............................@@@@@@@@..@.....................
@@@@@@@.@........................@.@@@@@.....@@...........@..@@....@@@@@@@@..@...............@...@@
@@@@@@@............@@.......@@@@@@.@@@@@..@@.@............@@.@@...@@@@@@@@...@...................@@
@@@@@@.......@.....@@@...@.@@@@@@@@@@@@@@@@@@.............@@.@@.....@@.@@@.........................
@@@@@@@......@...........@@@@@@@@@@@@@@@@@@@@@@@......@....@@@@@.......@@@........................@
@@@@@@@@...@.......@........@@@@@@@@@@@@@@@@@@@@@..........@@@@@......@.@@@.......................@
@@@@@@@@...@................@@@@@@@@@@@@@@@@@@@@@@.........@@@@@......@.............@@@@@@@.......@
.@@@@@@@.....................@@@@@@@@@@@@@@@@@@@@.........@.@@@@......@.............@@@@@@@@@...@.@
..@@@@@@.............@........@@@@@@@@@@@@@@@@..............@@@@......................@@@@@@@@@@@@@
..@@@@@............@..........@@@@@@@@@@@@@@@@............@....................@.......@@@@@@@@@@@@
........@@...............@....@@@@@@@@@@@@@@@@@@@@@.......@...@.@...@..............@@@@@@@@@@@@@@@@
.......@@.....@........@....@....@@@@@@@@@@@@@@@@@@...@@..........................@@@@@@@@@@@@@@@@@
..............@........@@...@....@@@@@@@@@@@@@@@@@@..@...................@.......@@@@@@.@@@@@@@@@@@
@.@@..........@@.......@@.........@@@@@@@..@@@@@@@@@@@.............................@@@...@@@@@@@@@@
@@@@.@@.@.....@@@......@..........@@........@@@...@@@..............................@@....@@@@@@@@@@
@@@@...................@..........@@.......@@@....@@...................@@................@@@@@@@@@@
...............................@@.@..............................@..........@...............@@@@@@@
@..............@................@..@@............@...............................@@.......@@@@@@@@@
.............@@.........................@............................@@@@@................@@@@@@@@@
........@.......@.......................@@@.....@.............@....@@@@@@@.........@@@..@@@@@@@@@@@
........@@......@........................@@@..........@@.@..........@@@@@@.....@.......@@@@@@@@@@@@
.@.......................................@@..........@@..@.........@@@@@@@...........@@@@@@@@@@@@@@
@@..@.......@@..........@.....@@........@@@@..........@...........@@@@@@@@...........@@@@@@@@@@@@@@
@...........................@.@@@@...@.@@@@@..........@...............@@@@@@@........@@@@@@@@@@@@@@
@..........@@@.............@@@@@........@@@@............................@@@@@@@......@@@@@@@@@@@@@@
@............@@.......@@.@@@@@@@..@.....@@@@@.@..........@@@@@...@...@@..@@@@@.......@@@@@@@@@@@@@@
@..........@.....@.@@..@..@@..@@..@.......@@@@@@@@....@.@@@@@@.......@@....@@@.......@@@@@@@@@@@@@@
@@@.................@..@.@@@..@@.........@@@@@@@@@......@@@@@...............@.....@...@@@@@@@@@@@@@
@@@......@.@.............................@@@@@@@@@........@@....@@................@...@@@@@@@@@@@@@
@@@........@...@@@@..@....@.....@.....@@@@@@@@@@@@........@@....@@......@@@@.........@@@@@@@@@@@@@@
@@@......@@@....@@@@..............@...@@@@@@@@@@@@@....@...@@..........@@@@@......@..@@@@@@@@@@@@@@
@@@.....@@@@..@.............@...........@@@@@@@@@.....................@@@@@.......@..@@@@@@@@@@@@@@
@@@...@@@@@@@@......@@@@...........@....@@@@@@@@@................@.@@@@@@@@@.........@@@@@@@@@@@@@@
@@....@@@@@@@@.....@@@@@@...............@@@@@@@@@..............@@@@@@@@@@@@@@........@@@@@@@@@@@@@@
@@@@@@@@@@@@@@...@@@@@@@@..@@...........@@@@@@@@@@@.........@@@@@@@@@@@@@@@@@@@......@@@@@@@@@@@@@@
@@@@@@@@@@@@@...@@@@@@@@@@.@@@@....@@@@@@@@@@@@@@@@..@...@@.@@@@@@@@@@@@@@@@@@@......@@@@@@@@@@@@@@
8
67 41 0
14 12 0
69 74 0
91 31 0
60 41 0
57 17 0
71 6 0
51 83 0

11 59 0
9 64 0
7 16 0
44 27 0
1 40 0
81 89 0
82 72 0
51 87 0
