width 99
height 99
@@@@@@@@@@@@@@@@@@@@@@@@@@@@@@@@@@@@@@@@@@@@@@@@@@@@@@@@@@@@@@@@@@@@@@@@@@@@@@@......@@@@@@....@@@@
@@@@@@@@@@@@@@@@@@@@@@@@@@@@@@@@@@@@@@@@@@@@@@@@@@@@@@@@@@@@@@@@@@@@@@@@@@@@@@@.......@@.......@@@@
@@@@@@@@@@@@@@@@@@@@@@@@@@@@@@@@@@@@@@@@@@@@@@@@@@@@@@@@@@@@@@@@@@@@@@@@@@@@@@@@...@...........@@@@
@@@@@@@@@@@@@@@@@@@@@@@@@@@@@@@@@@@@@@@@@@@@@@@@@@@@@@@@@@@@@@@@@@@@@@@@@@@@@..@...@..........@@@@@
@@@@@@@@@@@@@@@@@@@@@@@@@@@@@@@@@@@@@@@@@@@@@@@@@@@@@@@@@@@@@@@@@@@@@@@@@@@@@........@.........@@@@
@@@@@@@@@@@@@@@@@@@@@@@@@@@@@@@@@@@@@@@@@@@@@@@@@@@@@@@@@@@@@@@@@@@@@@@@@@@@@..@@@..........@@@@@@@
@@@@@@@@@@@@@@@@@@@@@@@@@@@@@@@@@@@@@@@@@@@@@@@@@@@@@@@@@@@@@@@@@@@@@@@@@@@@@@@@@@.......@.@@@@@@@@
@@@@@@@@@@@@@@@@@@@@@@@@@@@@@@@@@@@@@@@@@@@@@@@@@@@@@@@@@@@@@@@@@@@@@@@@@@@@@@@@@@......@..@@@@@@@@
@@@@@@@@@@@@@@@@@@@@@@@@@@@@@@@@@@@@@@@@@@@@@@@@@@@@@@@@@@@@@@@@@@@@@@@@@@@@@@@..@@..........@@@@@@
@@@@@@@@@@@@@@@@@@@@@@@@@@@@@@@@@@@@@@@@@@@@@@@@@@@@@@@@@@@@@@@@@@@@@@@@@@@@@@...@@...........@@@@@
@@@@@@@@@@@@@@@@@@@@@@@@@@@@@@@@@@@@@@@@@@@@@@@@@@@@@@@@@@@@@@@@@@@@@@@.@@@@@@...@@........@@@...@@
@@@@@@@@@@@@@@@@@@@@@@@@@@@@@@@@@@@@@@@@@@@@@@@@@@@@@@@@@@@@@@@@@@@@@@@......@...@@.@...@..@@@..@@@
@@@@@@@@@@@@@@@@@@@@@@@@@@@@@@@@@@@@@@@@@@@@@@@@@@@@@@@@@@@@@@@@@@@@@@..............@@...@@@@@...@@
@@@@@@@@@@@@@@@@@@@@@@@@@@@@@@@@@@@@@@@@@@@@@@@@@@@@@@@@@@@@@@@@@@@@@@@..............@..@..@.....@@
@@@@@@@@@@@@@@@@@@@@@@@@@@@@@@@@@@@@@@@@@@@@@@@@@@@@@@@@@@@@@@@@@@@................@.@.....@.....@@
@@@@@@@@@@@@@@@@@@@@@@@@@@@@@@@@@@@@@@@@@@@@@@@@@@@@@@@@@@@@@@@@@@@................@@@...........@@
@@@@@@@@@@@@@@@@@@@@@@@@@@@@@@@@@@@@@@@@@@@@@@@@@@@@@@@@@@@@@@@@@@@@@@....@.@..@.......@.....@@..@@
@@@@@@@@@@@@@@@@@@@@@@@@@@@@@@@@@@@@@@@@@@@@@@@@@@@@@@@@@@....@@@@.@@....@@...................@....
@@@@@@@@@@@@@@@@@@@@@@@@@@@@@@@@@@@@@@@@@@@@@@@@@@@@@...@................@@..............@@........
@@@@@@@@@@@@@@@@@@@@@@@@@@@@@@@@@@@@@@@@@@@@@@@@@@@@.....................................@.........
@@@@@@@@@@@@@@@@@@@@@@@@@@@@@@@@@@@@@@@@@@@@@@@@@@@@.........................@@@@..................
@@@@@@@@@@@@@@@@@@@@@@@@@@@@@@@@@@@@@@@@@@@@@@@@@@@@@...@......@.............@@@@.@................
@@@@@@@@@@@@@@@@@@@@@@@@@@@@@@@.@@@@@@@@@@@@@....@@..@@.@@@..........@@@@@..@@@@..........@........
@@@@@@@@@@@@@@@@@@@@@@@@@@@@@@@...@@@@@@@@@@....@@@@.....@@....@...@.@@@@@..@@@@........@.@........
@@@@@@@@@@@@@@@@@@@@@@@@@@@@@@@....@@@@@@@.....@@@@@......@.@........@@@@@.@@@@@..................@
@@@@@@@@@@@@@@@@@@@@@@@@@@@@@@.....@@@@.....@@@@@@@@@@....@.@.........@@@@@@@@.@............@......
@@@@@@@@@@@@@@@@@@@@@@@@@@@@@@.....@@@@......@.@@@@@@@....@............@@@@@@.....@.@............@@
@@@@@@@@@@@@@@@@@@@@@@@@@@@@@....@........@.........@@@@@.............@@@@@@@@@.....@.............@
@@@@@@@@@@@@@@@@@@@@@@@@@@@@..................................@...@@@.....@@@@@@@..................
@@@@@@@@@@@@@@@@@@@@@@@@@@@..................@@..@...........@..@.@........@@@@@@..................
@@@@@@@@@@@@@@@@@@@@@@@@@@@..................@@@.....@.......@....@@@......@@@@@@@@................
@@@@@@@@@@@@@@@@@@@@@@@@@@@......@@..........@@@@.................@@@.......@@@@@..................
@@@@@@@@@@@@@@@@@@@@@@@@@@@....@@.............@@@...............@@@@@.......@@@@@...@@@@...........
@@@@@@@@@@@@@@@@@@@@@@@@@@@@....@@.....@........@....@..........@@@@@........@@@@@@@@@@@@..........
@@@@@@@@@@@@@@@@@@@@@@@@@@@@..@.@@..@@..............@@...@.......@@..@.......@@@@@@@..............@
@@@@@@@@@@@@@@@@@@@@@@@@@@@@..@@@@..........@.@.....@...@@@......@@@........@@@@@@@@.............@@
@@@@@@@@@@@@@@@@@@@@@@@@@@@@@@@@@@@@....@......................@@.@..........@@@@.@@@@@...........@
@@@@@@@@@@@@@@@@@@@@@@@@@@@@@@@@@@@.........@.......@@.@.............@@............@@@.........@..@
@@@@@@@@@@@@@@@@@@@@@@@@@@@@@@@@@....@.@...@@........................@@@........@@@@@@@@..........@
@@@@@@@@@@@@@@@@@@@@@@@@@@@@@@@@.......@...@@....@.@.....@......@..............@@@@@@@@@@......@@@@
@@@@@@@@@@@@@@@@@@@@@@@@@@@@@@@@@@....@@@..........@.....@......................@.@@@@@@.@.....@@@@
@@@@@@@@@@@@@@@@@@@@@@@@@@@@@@@@@@@.................@....@.......@@...............@@@.........@@@@@
@@@@@@@@@@@@@@@@@@@@@@@@@@@@@@@@@@@.....................@.....@@@@..............@.@@@@@........@@@@
@@@@@@@@@@@@@@@@@@@@@@@@@@@@@@@@@@.................@..........@.@.@................@@@@.....@@.@@@@
@@@@@@@@@@@@@@@@@@@@@@@@@@@@@@@@@@.................@@.............@.@.@@...................@@..@@@@
@@@@@@@@@@@@@@@@@@@@@@@@@...@.@@@@..................@@....@@......@@@....@..................@.@@@@@
@@@@@@@@@@@@@@@@@@@@@@@.......@@@@..........@......@@.....@@@......@@@@.@@......@.@..........@.@...
@@@@@@@@@@@@@@@@@@@@@@@.......@@@@................@@......@@@.......@@@.@@..........@..............
@@@@@@@@@@@@@@@@@@@@@@@..........@@.....@...@.............@@@.......@@...@..@......................
@@@@@@@@@@@@@@@@@@@@....@........@...............@........@@......@.@......@@......................
@@@@@@@@@@@@@@@@@@@.......................@@@....@...@............@@@......@@.@.......@...@@.....@@
@@@@@@@@@@@@@@@@@@@........@......@......@@@@@.......@...@..........@......@@..@@..........@@@...@@
@@@@@@@@@@@@@@@@@@@..@@.......@.........@@@@@@@@.........................@@.....@..........@@....@@
@@@@@@@@@@@@@@@@@@@@...@@..............@@@@@@@@@...............@.@..........@....................@@
@@@@@@@@@@@@@@@@@@@@@...............@@@@@@@@@@@@@@........@@.....................................@@
@@@@@@@@@@@@@@@@@@@...@....@........@..@@@@@@@@@@@....@...@@.....................@.........@.....@@
@@@@@@@@@@@@@@@@@@....@..................@@@@@@@@@......@@@@.................@...........@......@@@
@@@@@@@@@@@@@@@@@@...@.............@.....@@@@@@@@@@@.....@.......@...........@...@...............@@
@@@@@@@@.@@@@@@@@@.......................@@@@@@@@@@@.........@..@@@@............@@.@....@...@....@@
@@@@@@@..@@..@@@@..........@@@.........@@@@@@@@@@@@@...@@..@..@@@@@@@..........@............@...@@@
@@@@@@@..@.....@@..........@@@@@..@@.....@.@@@@@@@@....@@.......@@@@@...........................@@@
@@@@@@@@.......@@..........@@@@@...........@@@@@@@@@............@@@@@............@...............@@
@@@@@@@@.....................@@@@@@@.........@@@@@@.............@@@@@...@@@......@..............@@@
@@@@@@...@...........@.......@@@@@@@.........@@@@.......@@@...@@@@@@@...@@@.................@....@@
@@.................@.@.......@@@@@@@...@.@.@@@@@@.......@@.....@@@@.....@@@@..........@@@........@@
@@.............@@............@@@@@@@@.......@@@@@...@..........@@...@@@..@@@..........@@@...@....@@
@.........@...@@@............@@@@@@@..@@....@@@@@.......@.@@.........@.@.......@@.....@@@@..@@@...@
@..............@@@@............@@@@@...@...@@@.......@...@@@.........@.........@........@@@@@@@...@
....@..........@@@................@@@@.....@@@@.....@@...@@@.....@...@......@............@@@@@@@...
..@@@...........@@...........@...........@.@@@@...........@@.............................@@@@@@@...
@@@@@....@......@@@....................@...@..@......@..@@@@.....@..@@.....................@@@@@...
@@@@............@@@..@.....@...........@@..@........................@@@@....@@.....@@.......@@@@...
@..@.......@....@@@........................................@.......@......@@@@@@....@.......@@.....
..........@..@....@@@@@.@..........................@..@.......@@..........@@..@@............@@.....
......@.....@......@@@@@@.......................@@.........@...@...........@.....@...........@.....
......@.@...@@@...@@@@@@@@@............@.@.........@......@@.............@.........................
@@..........@@@@..@@@@@@@@@............@@@.............@.@@@............@.........................@
@@.......@..@@@@.@@@@@@@@@@@..........@..................@@..@@.................................@..
......@..@@@@@@@@@@@@@@@@@@@....@................@@......@...@........@..............@@............
...@.@....@@@@@@@@@@@@@@@@@@....................@@@....@@@...@.......@@............@@@.....@.......
...@......@@@@@@@@@@@@@@@@@.....................@@@.....@......@..............@....@@......@@......
@@...@@.@.@@@@@@@@@@@@@@@@@@............@.......@@@@...........@..............@...........@@@@@..@.
@@@@@@@@@@@@@@@@@@@@@@@@@@@..............@@@@....@@........................@..@@.........@@@@@@@...
@@@@@@@@@@@@@@@@@@@@@@@@@@@..............@@@@....@@...........................@...@.....@@@@@@@@...
@@@@@@@@@@@@@@@@@@@@@@@@@@@@@...@.......@@@@@@.@@@@@.........................@...@@.........@@@....
@@@@@@@@@@@@@@@@@@@@@@@@@@......@.......@@@@...@@@@@......................@........................
@@@@@@@@@@@@@@@@@@@@@@@@@@@@......................@@.......@....@...............@....@........@..@.
@@@@@@@@@@@@@@@@@@@@@@@@@@@@..@.......@.@@........@.@@..........................@..@........@.@@...
@@@@@@@@@@@@@@@@@@@@@@@@@@@@..@.......@@@@...@......@@...@..@...............................@@@@...
@@@@@@@@@@@@@@@@@@@@@@@@@@.@....@.....@@@....@@@.@..@@@.....@@.......................@......@@@@...
@@@@@@@@@@@@@@@@@@@@@@@@@....@..@@....@....@@@.........................@.............@....@@@......
@@@@@@@@@@@@@@@@@@@@@@@@@.@.................@@@..................@.....@.....@.....@@@..@@@.......@
@@@@@@@@@@@@@@@@@@@@@@@@@...................@@@@...@........@.....@@........@@.....@@@..@......@@..
@@@@@@@@@@@@@@@@@@@@@@@@@@......@......@....@@@............@@....@@............................@@..
@@@@@@@@@@@@@@@@@@@@@@@@@@@..........@@@@@..@....................@@...................@............
@@@@@@@@@@@@@@@@@@@@@@@@@@@..........@@@@@@@@..............................@..........@@.........@@
@@@@@@@@@@@@@@@@@@@@@@@@@@.....@.....@@@@@@@@.........................................@@.......@@@@
@@@@@@@@@@@@@@@@@@@@@@@@@@@@@@.@.@....@@@@@@@@......@@...........@........@@......@@..@@@@.....@@@@
@@@@@@@@@@@@@@@@@@@@@@@@@@@@@@@@......@@@@@@@@......@@.@........@@......@@@@@@...@@@.@@@@@@...@@@@@
8
28 81 0
55 73 0
91 39 0
69 28 0
23 64 0
88 73 0
50 48 0
69 31 0

95 20 0
70 77 0
36 76 0
97 37 0
16 77 0
89 31 0
76 39 0
3 77 0
