width 99
height 99
@@@@@@@@@@@@@@@@@@@@@@@@@.@..@@.@.@@@@@@...@@@@..............@@@@@@@@@@@@@@@@@@@@@@@@@@@@@@@@@@@@@@
@@@@@@@@@@@@@@@@@@@@@@@@@.........@@@@@@...@@@@.............@@@@@@@@@@@@@@@@@@@@@@@@@@@@@@@@@@@@@@@
@@@@@@@@@@@@@@@@@@@@@@@@.........@@@@@.....@........@.......@@@@@@@@@@@@@@@@@@@@@@@@@@@@@@@@@@@@@@@
@@@@@@@@@@@@@@@@@@@@@@@@@..................@................@@@@@@@@@@@@@@@@@@@@@@@@@@@@@@@@@@@@@@@
@@@@@@@@@@@@@@@@@@@@@@@@@@@@....................@............@@@@@@@@@@@@@@@@@@@@@@@@@@@@@@@@@@@@@@
@@@@@@@@@@@@@@@@@@@@@@@@@@@.........................@.@......@@@@@@@@@@@@@@@@@@@@@@@@@@@@@@@@@@@@@@
@@@@@@@@@@@@@@@@@@@@@@@@@.@@........................@........@@@@@@@@@@@@@@@@@@@@@@@@@@@@@@@@@@@@@@
@@@@@@@@@@@@@@@@@@@@@@@...@@.....................@.........@.@@@@@@@@@@@@@@@@@@@@@@@@@@@@@@@@@@@@@@
@@@@@@@@@@@@@@@@@@@@@@@@.@@.........@@..........@..........@@@@@@@@@@@@@@@@@@@@@@@@@@@@@@@@@@@@@@@@
@@@@@@@@@@@@@@@@@@@@@@@..@@..........................@....@@@@@@@@@@@@@@@@@@@@@@@@@@@@@@@@@@@@@@@@@
@@@@@@@@@@@@@@@@@@@@@@@@.....@.............@............@.@@@@@@@@@@@@@@@@@@@@@@@@@@@@@@@@@@@@@@@@@
@@@@@@@@..@..@@@@@..@@@................@...............@@@@@@@@@@@@@@@@@@@@@@@@@@@@@@@@@@@@@@@@@@@@
..............@@@@@.@@@......@........@@@@@............@@@@@@@@@@@@@@@@@@@@@@@@@@@@@@@@@@@@@@@@@@@@
...............@@@@...@@@............@..@@.....@@......@@@@@@@@@@@@@@@@@@@@@@@@@@@@@@@@@@@@@@@@@@@@
.......@..............@@@@...............@.....@.........@@@@@@@@@@@@@@@@@@@@@@@@@@@@@@@@@@@@@@@@@@
.....@@...@@@..........@......................@@...@.....@@@@@@@@@@@@@@@@@@@@@@@@@@@@@@@@@@@@@@@@@@
....@.....@@@@....@..........@@.............@@@@...@....@@@@@@@@@@@@@@@@@@@@@@@@@@@@@@@@@@@@@@@@@@@
.......@@@@@@.....@.@@@........@@....@@....@@@@@.......@@@@@@@@@@@@@@@@@@@@@@@@@@@@@@@@@@@@@@@@@@@@
.@@...@@@@@@@......@@@@.......@@@@......@..@@@@....@...@@@@@@@@@@@@@@@@@@@@@@@@@@@@@@@@@@@@@@@@@@@@
.@....@@@@@@..........@..@....@@@@.@...@@@@@@@@@........@@@@@@@@@@@@@@@@@@@@@@@@@@@@@@@@@@@@@@@@@@@
@@@@@@@@@@@@@.........@..@@...@@@@......@@@@@......@.@..@@@@@@@@@@@@@@@@@@@@@@@@@@@@@@@@@@@@@@@@@@@
@@@@@@@@@@@@..........@........@@...........@...@....@@@@@@@@@@@@@@@@@@@@@@@@@@@@@@@@@@@@@@@@@@@@@@
@@@@@@@@@@@@.......@....................@.......@@@.@.@@@@@@@@@@@@@@@@@@@@@@@@@@@@@@@@@@@@@@@@@@@@@
@@@@@@@@@@@@.....................@.....@@@............@@@@@@@@@@@@@@@@@@@@@@@@@@@@@@@@@@@@@@@@@@@@@
@@@@@@@@@@@@.@@@..@@@........@.........@@@@@...@......@@@@@@@@@@@@@@@@@@@@@@@@@@@@@@@@@@@@@@@@@@@@@
@@@@@@@@@@@@@@@...@@..........@@@@.......@@@..........@@@@@@@@@@@@@@@@@@@@@@@@@@@@@@@@@@@@@@@@@@@@@
@@@@@@@@@@@@@@....@@...........@@..@......@@..........@@@@@.@@@@@@@@@@@@@@@@@@@@@@@@@@@@@@@@@@@@@@@
@@@@@@@@@@@@@@@@@.@@............@..@..@@@@@@..........@@@@@...@@@@@@@@@@@@@@@@@@@@@@@@@@@@@@@@@@@@@
@@@@@@@@@@@@@@@@@..................@..@@@@@@..........@@@@....@@@@@@@@@@@@@@@@@@@@@@@@@@@@@@@@@@@@@
@@@@@@@@@@@@@@@@..........@.............@@@@.......@@.........@@@@@@@@@@@@@@@@@@@@@@@@@@@@@@@@@@@@@
@@@@@@@@@@@@@@@.........................@@@@...@..............@@@@@@@@@@@@@@@@@@@@@@@@@@@@@@@@@@@@@
@@@@@@@@@@@@@@@.......@...@@....@.......@@.....@......@.........@@@@@@@@@@@@@@@@@@@@@@@@@@@@@@@@@@@
@@@@@@@@@@@@@@@.......@@@.@..@..@.....@@@@...@....@...@@@.......@@@@@@@@@@@@@@@@@@@@@@@@@@@@@@@@@@@
@@@@@@@@@@@@@@........@.........@............@.........@@........@..@@@@@@@@@@@@@@@@@@@@@@@@@@@@@@@
@@@@@@@@@@@@@@@@......@.............................................@@@@@@..@@@@@@@@@@@@@@@@@@@@@@@
@@@@@@@@@@@@@@@......@@@.....................................@@.....@@@@@...@@@@@@@@@@@@@@@@@@@@@@@
@@@@@@@@@@@@@@@@@@.@............................@@..........@@@......@@@@....@@@@@@@@@@@@@@@@@@@@@@
@@@@@@@@@@@@@@...................@....@..@@@..@@@@@@.@@@....@@@@......@@@....@@@@@@@@@@.@@@@@@@@@@@
@@@@@@@@@@@@@..............@..........@.@@@@@..@@@@.........@@@@......@@@@...@@@@....@@.@@@@@@@@@@@
@@@@@@@@@@@@@@..........................@@@@@@@@@@..........@@@............@@@@@........@@@@@@@@@@@
@@@@@@@@@@@@@@.....................@.@...@@@@@@@........@@@..@...............@.......@...@@@@@@@@@@
@@@@@..@@@@@@....@....@..............@....@@@@@@@....................................@@@@@@@@@@@@@@
@@@@....@@@@@@@...@..@@....@.....@@....@@..@@@@@@@....@.@..@......@@@.....@....@@....@@@@@@@@@@@@@@
@@@@........@@@.@............@@........@...@@@@@@.....@@......@...................@@@@@@@@@@@@@@@@@
@@@@........@.@@@..........................@.@@@@.....@.........................@.@@@@@@@@@@@@@@@@@
@@@@..............@....@.............@@.........@.....@..........@..............@@@@@@@@@@@@@@@@@@@
@@@@.............@@....@.......@...@.@@..........................................@@@@@@@@@@@@@@@@@@
@@@@@..@........@@@..@@@...@..............................@......................@@@@@@@@@@@@@@@@@@
@@@@@@@@@@@.....@@....@@................@........@...............................@@@@@@@@@@@@@@@@@@
@@@@@.@.....@...@@@..............................@..........@@..@....@@..........@@@@@@@@@@@@@@@@@@
@@.@@.......@@.@@@@.....................@@.......@........@@@.....................@@@@@@@@@@@@@@@@@
@@..@...........@@@........@............@@@@............@.............@........@..@@@@@@@@@@@@@@@@@
@@..............@@@@.....................@@@.............................@........@@@@@@@@@@@@@@@@@
@@...@@...@@........@..@......@.......................@.@.@.....@@......@@@.....@@@@@@@@@@@@@@@@@@@
@@@@@@@@..@@...........@..........@......@........@...@@@@.......@.@@.....@....@@@@@@@@@@@@@@@@@@@@
@@@......@@@...................@.........@........@...@@@........@@@@@....@......@@@@@@@@@@@@@@@@@@
@@@@......@......@..@..@@@...@@....@...................@.........@@@@@@...@.....@@@@@@@@@@@@@@@@@@@
@@@@......@.........@...@@...@@@@@@@..........@.................@@@@@@@@.....@@@@@@@@@@@@@@@@@@@@@@
@@@@............@...@@@@@@.....@@@@@.........@@.............@...@@@@@@@@.....@@@@@@@@@@@@@@@@@@@@@@
..........@@.........@@@.......@@@@@...@@.......................@@@@@@@@........@@@@@@@@@@@@@@@@@@@
@@...................@@...@@....@@@@....@@...........@@@@.......@@@@@@@@........@@@@@@@@@@@@@@@@@@@
@@..............................@@@@@...@@...........@@.@...........@@@@@........@@@@@@@@@@@@@@@@@@
...........................@....@@@@@@...@......................@.....@@.........@@@@@@@@@@@@@@@@@@
......@....................@@@..@..@@....@........@..................@@..........@@@@@@@@@@@@@@@@@@
.@@..................@.....@@.......@.@................@.@..@.....@..@@.....@....@@@@@@@@@@@@@@@@@@
@..............@...........@@.......@........@.....@...............................@@@@@@@@@@@@@@@@
@...@....@..............@..@@@.........@.@...............@...@....@....@...........@@@@@@@@@@@@@@@@
@.......................@..@..@........@.............@...........@.................@@@@@@@@@@@@@@@@
@.....................................@@.....................................@......@@@@@@@@@@@@@@@
@..........@.............@.............@............................@@................@@@@@@@@@@@@@
.......................................@...@@.....@@...............@@@@..............@@@@@@@@@@@@@@
............................................@....@...........@@....@@.......@........@@@@@@@@@@@@@@
.........@@...@..........@@....................................@....@....................@@@@@@@@@@
@........@@..@@@..@.@.....@@................@@.....@......@..@@@@@@@@.@..................@@@@@@@@@@
@..........@@@@.....@..............................@......@@@@@@@@@@@@@.................@@@@@@@@@@@
@..........@@@@...........@@......@@.......@...............@@@@..@@@@@@....@...........@@@@.@@@@@@@
..@@...@@@@..............@@@@@..............@...............@@@...@@@@@@..@@@....@..........@@@@@@@
@..@..@@@@@@@...........@@@@@@......@@......................@@@....@@@@@@.@@@@@....@........@@@@@@@
.....@@@@@@@@.......@...@@@@@......@@@.................@....@.....@@@@@@...@@@@@...@...@@..@@@@@@@@
......@@@@@@@..@@@@....@@@@.....@...@@@..@@..........@.@@@............@@...@@@@@...........@@@@@@@@
@..@@..@@@@@@@.@@@.....@@@@...........@..@@............@@@@@@................@@@.........@@@@@@@@@@
@@@@@@@@@@@@@@.@@@..................................@..@@@................@...@@@@.@........@@@@@@@
@@@@@@@@@@@@@@..........................@..............@@...............@@@...@@@...........@@@@@@@
@@@@@@@@@@@@@@.............@.......@@.........................................@............@@@@@@@@
@@@@@@@@@@@@@@.............@........@...........@.........................@..............@@@@@@@@@@
@@@@@@@@@@@@@@..........@................@@......................@@........@..............@@@@@@@@@
@@@@@@@@@@@@@@.........@@@......@.....................@@..@......@@................@.....@@@@@@@@@@
@@@@@@@@@...@@.@.......@@.....@@@...@@...@......@@...@@..........@@................@.....@@@@@@@@@@
@@@@@@@.....@@@@.....@@@@@.@@@@@@@@@@@...........................@@............@.@@@@@@@@@@@@@@@@@@
@@@@@@@@.....@@@@....@@@@@@@@@@@@@@@@@...................@....@...@...@@@.......@@@@@@@@@@@@@@@@@@@
@@@@@@@@.......@@......@@@@@@@@@@@@@@@......@..@.........@............@@@@@.......@@@@@@@@@@@@@@@@@
@@@@@@@@.......@@....@.@@@@@@@@@@@@@@@.......@...........@...........@@@@@@@......@@@@@@@@@@@@@@@@@
@@@@@@@@........@..@..@@@@@@@@@@@@@@@@............................@..@@@@@@@......@@@@@@@@@@@@@@@@@
@@@@@@@@...........@@@@@@@@@@@@@@@@@@@@...........@........@....@.@@@@@@@@@@@@....@@@@@@@@@@@@@@@@@
@@@@@@@@...........@@@@@@@@@@@@@@@@@@@@.....@.............@.......@@@@@@@@@@@@...@@@@@@@@@@@@@@@@@@
@@@@@@@@@@@...@....@@@@@@@@@@@@@@@@@@@@........@........@........@@@@@@@@@@@@@@@@@@@@@@@@@@@@@@@@@@
@@@@@@@@@@@.....@@@@@@@@@@@@@@@@@@@@@@@.@@@....@..................@@@@@@@@@@@@@@@@@@@@@@@@@@@@@@@@@
@@@@@@@@@@@...@@@@@@@@@@@@@@@@@@@@@@@@@@@@@@@.@@@...............@@@@@@@@@@@@@@@@@@@@@@@@@@@@@@@@@@@
@@@@@@@@@@@...@@@@@@@@@@@@@@@@@@@@@@@@@@@@@@@@@@@@.........@.@@.@@@@@@@@@@@@@@@@@@@@@@@@@@@@@@@@@@@
8
33 22 0
5 14 0
26 36 0
53 82 0
11 63 0
32 37 0
63 68 0
27 40 0

46 96 0
51 26 0
49 80 0
79 41 0
49 54 0
70 55 0
88 40 0
52 77 0
