width 99
height 99
@@@@@@@@@@@@@@@@@@@@@@@@@@@@@@@@@@@@@@@@@@@@@@@@@@@@@@@@@@@@..........@@@@.......@@@@@@@@@@@@@@@@@@
@@@@@@@@@@@@@@@@@@@@@@@@@@@@@@@@@@@@@@@@@@@@.@@@@@@@@@@@@@@...........@......@....@@@@@@@@@@@@@@@@@
@@@@@@@@@@@@@@@@@@@@@@@@@@@@@@@@@@@@@@@@@@@@.@@@@@@@@@@@@@@.....................@.....@@@@@@@@@@@@@
@@@@@@@@@@@@@@@@@@@@@@@@@@@@@@@@@@@@@@@@@.@...@@@@@@@@@@@@@.............@@@...@@@@....@@.@@@@@@@@@@
@@@@@@@@@@@@@@@@@@@@@@@@@@@@@@@@@@@@@@@@@......@@@@@@@@@@@@@...@@......@@@@@..@.......@....@@@@@@@@
@@@@@@@@@@@@@@@@@@@@@@@@@@@@@@@@@@@@@@@@.......@@@@@@@@@@@@............@@@@@.............@@@@@@@@@@
@@@@@@@@@@@@@@@@@@@@@@@@@@@@@@@@@@@@@@@@...@...@@.@@@@@@@@.......@.......@@@.............@.@@@@@@@@
@@@@@@@@@@@@@@@@@@@@@@@@@@@@@@@@@@@@@@@@...@.@.....@@@@@@................@@@@..............@@@@....
@@@@@@@@@@@@@@@@@@@@@@@@@@@@@@@@@@@@@@@@@............@@@@.....@@......@..@@@@......@.......@.......
@@@@@@@@@@@@@@@@@@@@@@@@@@@@@@@@@@@@@@@@@............@@@@.....@@....................@@.....@.......
@@@@@@@@@@@@@@@@@@@@@@@@@@@@@@@@@@@@@@@.@........@...@@@@@....@@@..@@.....@.........@......@.......
@@@@@@@@@@@@@@@@@@@@@@@@@@@@@@@@@@@@@@@..........@..@@@.@.@..@@.............@...@.................@
@@@@@@@@@@@@@@@@@@@@@@@@@@@@@@@@@@@@@@.......................@...................................@@
@@@@@@@@@@@@@@@@@@@@@@@@@@@@@@@@@@@@@.................@....@.....................@...............@@
@@@@@@@@@@@@@@@@@@@@@@@@@@@@@@@@@@@@@@.........@@........@@@@......................@.....@.......@@
@@@@@@@@@@@@@@@@@@@@@@@@@@@@@@@@@@@@@@..................@@@@....@.................@.....@...@....@@
@@@@@@@@@@@@@@@@@@@@@@@@@@@@@@@@@@@@.....@@...@.......@.........@@...............@@.....@...@....@@
@@@@@@@@@@@@@@@@@@@@@@@@@@@@@@@@@@@@@@@@@@@@@...@......@......@...@..............@......@@@.....@@@
@@@@@@@@@@@@@@@@@@@@@@@@@@@@@@@@@@@@@@@@@@@@@@@........@.........................@....@@@@@@....@@@
@@@@@@@@@@@@@@@@@@@@@@@@@@@@@@@@@@@@@@@@@@@@@@@@@@.....@..........@..........@.@.@....@@.........@@
@@@@@@@@@@@@@@@@@@@@@@@@@@@@@@@@@@@@@@@@@@@@@@@@@@..................@.................@@...@......@
@@@@@@@@@@@@@@@@@@@@@@@@@.....@@@@@@@@@@@@@@@@@@@@...........@.....@@.....@........................
@@@@@@@@@@@@@@@@@@@@@@@@@@........@@@@@@@@@@@@@@....@...........@.........@@...@.............@....@
@@@@@@@@@@@@@@@@@@@@...............@@@@@@@@@@@@@...@.................@....@@...@@.................@
@@@@@@@@@@@@@@@@@@@@.........@......@.@@@@@@@@....@@...............@.........@@@@@@@@@....@.......@
@@@@@@@@@@@@@@@@@@@@..................@@@@@@@..................@.@@.@.......@@@@@@@@@@.......@.....
.@@@@@@@@@@@@@@@@@@@.............@.....@@@@@@@...................@@.@.....@.@@@@@@@@@@...@.........
......@@@@@@@@@@@@@@....................@@@@@@@............@.....@@...........@@@@@@@@@@@..........
......@@@@@@@@@@@@@@............@........@@@@.....@@....@@@@@....@@.@..@@@.......@@@@@@@@..@.......
......@@@@@@@@@@@@@@.......@.............@@.@@.......@@@@@@@@..@@....@.@@..........@@@@@@@..@......
...@..@@@@@@@@@@@.....@..................@@..........@@@@@@@@..@.......@@..........@@@@@@@..@...@..
..@@...@@@@@@@@@@.....@.................@@............@@@@@@@..@.......@@..........@@@@@@@......@..
..@@@..@@@@@@@@@@@@@@.......@@....@@.............@....@@@..@@...............@........@@@@@......@..
.@@@@.@.@@.@@@@@@@@...........@..@@@@............@............@...........@@...........@......@@@@@
......@....@@@@@@@@..........@...@@@@..........@@@@@......@...@.......@............@@..@.@.....@@@@
.........@@@@@@@@@...........@.@@@@@....@@......@.@@@@...@@............@@........@@@@..........@@@@
.........@@@@@@@@@..............@@@....@@@......@..@@@...@@....@.......@....@..................@@@@
.........@@@@@@@@@@...................@@@@@........@@...@@@....@....@.........................@@@@@
............@@@@@@@.....@@.......@....@@@@@........@....@@@@@@@@@.......@............@....@@@.@@@@@
............@@........................@@@@@...............@@@@@@@.................@@@.....@@@@@@@@@
............@@.............@@@.....@.@@@@@@@................@@@@@............@....@@@..@@@@@@@@@@@@
............................@@.....@.@@@@@@@@@.@.....@....................@..@...@@@@@@@@@@@@@@@@@@
.............@........@@...........@..@@@@@@@@@......@........@@..........@@@@@.@@@@@@@@@@@@@@@@@@@
........................................@@@@@@@......@.......@@@@.........@@@@@@@@@@@@@@@@@@@@@@@@@
......@@....@@...........@..............@@@@@@@......@......@@@...@@@@@@.@@@@@@@@@@@@@@@@@@@@@@@@@@
@..........@@@.......................@......@................@@...@@@@@@@@@@@@@@@@@@@@@@@@@@@@@@@@@
.........@.....@....................@@...........@......@.........@@@@@@@@@@@@@@@@@@@@@@@@@@@@@@@@@
.........@................................@....@@@.......@.......@@@@@@@@@@@@@@@@@@@@@@@@@@@@@@@@@@
...................@...........................@@................@@@@@@@@@@@@@@@@@@..@@@@@@@@@@@@@@
.........................@.@...................@@.................@@@@@@@@@@@@@@@.@..@@@@@@@@@@@@@@
.........@@.......@................................................@@..@@@@@..@...@@..@@@@@.@@@@@@@
............@.............@............@..................................@...@@...@.........@@.@@@
...@...@..................@..................@.......@............................................@
.......@..................@@.........................@.............@@@.............................
....@@..............@@....@@@@...............@......@@..@....@......@@@...@.............@........@@
...........@@@......@@.....@@@..@..............@@@..................@@@@@@@..........@@.@..........
...........@@@...@@.........@@............@.@.@@@@@@@........@@.......@@@@@.............@..........
......@@@@@@@@@@@@@.......................@.@@@@@@@@@.......@@@@@.....@@.@........@............@@..
....@@@@@@@@@@@@@@@@@@@.@.@.......@@........@@@@@@@@@.................@............................
..@.@@@@@@@@@@@@@@@@@@..@...................@@@@@@@@@@@....................@......................@
@@@@@@@@@@@@@@@@@@@@......@.................@@@@@@@@@@.........@@..........@.....................@@
@@@@@@@@@@@@@@@@@@@@...@@..........@....@..@@@.@@@@@@@..........@@@..........................@@@@@@
@@@@@@@@@@@@@@@@@@@@..@@@...@....@@@....@...@@....@.............@@@..........@........@@.......@@@@
@@@@@@@@@@@@@@@@@@@@..@@@........@@@....@.........@@@@..........@@@.........@@.@@@....@@.......@@@@
@@@@@@@@@@@@@@@@@@@@@@@@@..@....................................@@@@.....@..@@.@......@@..@@......@
@@@@@@@@@@@@@@@@@@@@@@@@...@.........@.................@@@.....@@@@......@...@.....@...............
@@@@@@@@@@@@@@@@@@@@@@@@.............@@...@............@@....@....@@.....@.........@.............@@
@@@@@@@@@@@@@@@@@@@@@@@@.....@..........@@@...@.............@@......@....@.....@.................@@
@@@@@@@@@@@@@@@@@@@@@@.@.@........@......@@@............@...........@..........@.................@@
@@@@@@@@@@@@@@...........................@@........................@@.....@........................
@@@@@@@@@@@@@..........@......@@.........@@....@........@.@...............@..........@...........@@
@@@@@@@@@@@@.......@..@@......@@..........................................@@@....@@@@@...........@@
@@@@@@@@@@@@...@...@...@@@...@...........@....................@@@..........@@@....@@@@........@@..@
@@@@@@@@@@@@@......@@@.@@@@@.@@@@..............................@@.........@@@@@@@@@@@........@...@@
@@@@@@@@@@@@.......@@@@@@@......@...@@.....@...................@....@.....@@@@@@@@@@@@@@........@@@
@@@@@@@@@@@@.........@@@@@.....@@@@.@@..@@@................@........@....@@@@@@@@@@@@@@............
@@@@@@@@@@@@@...................@@..@@..@@@.............@@@.............@@@@@@@@@@@@@@@@@..........
@@@@@@@@@@@@@...................@@...@..@@@@.........................@@@@@@@@@@@@@@@@@@............
@@@@@@@@@@@@@.......................@....@@..@............@.........@@@@@@@@@@@@@@@................
@@@@@@@@@@@@@........@................@..@......@.........@..@@.....@@@@@@@@@@@...................@
@@@@@@@@@@@@....................................@....@.....@@.@.......@@@@@@@@@.............@@.@...
@@@@@@@.@..........................................@@......@..........@@@@@@@@@@........@..........
@@@@@@@................@@@@.......@...........@.....................@@@@@@@@@@@@.@.................
@@@@@@@................@@@@...@@@@@@@@.......................@........@@@@@@@@@@@@.................
@@@@@@@........@.....@@@@@@....@@@@@@..................@.....@....@....@@@@@@@@@@@@................
@@@@@@@......@@@......@@@@@....@@@@@@..........@@@...........@@@@@........@@@@@@@.......@..........
@@@@@@@@....@@@@.....@@@.........@@............@@@..............@@........@@@@@@@@@@....@..........
@@@@@@@.....@@@.....@.@@.....@...@..........@..@...@......@..............@@@@@@@@..@.........@.....
@@@@@@@@@..@@@..............................@...@@.@@.....@........@.....@@@@@@@@..@@@.......@.@...
@@@@@@@@@..@@@@@.....................@..........@@..@@@...@........@@@@@.@@@@@@@@....@....@..@..@@@
@@@@@@@@@@@@@@...@................................@.@@@@..@..@@@..@@@@@@@@@@@@@@@.........@..@@.@@@
@@@@@@@@@@@@@....@..................................@@@@@@@@@@@@@.@@@@@@@@@@@@@@@..@............@@@
@@@@@@@@@@@....@.....@.............@@@@..........@@@@@@@@@@@@@@@@.@@@@@@@@@@@@@@@.........@......@@
@@@@@@@@@@@......@@.@@.@@.......@..@@@@@@@@........@@@@@@@@@@@@@@@@@@@@@@@@@@@@@@@.@..@.@@......@@@
@@@@@@@@@@@@.......@@@@@@........@@@@@@@@@@@@@..@..@@@@@@@@@@@@@@@@@@@@@@@@@@@@@@@@@..@@@@.....@@@@
@@@@@@@@@@@@@@@....@@@@@@@.......@@@@@@@@@@@@@....@@@@@@@@@@@@@@@@@@@@@@@@@@@@@@@@@@@@@@@@...@@@@@@
@@@@@@@@@@@@@@@@@...@@@@@@@@.......@@@@@@@@@@@@@@.@@@@@@@@@@@@@@@@@@@@@@@@@@@@@@@@@@@@@@@@@..@@@@@@
@@@@@@@@@@@@@@@@@@@@@@@@@@@@@@......@@@@@@@@@@@@@@@@@@@@@@@@@@@@@@@@@@@@@@@@@@@@@@@@@@@@@@@@@@@@@@@
@@@@@@@@@@@@@@@@@@@@@@@@@@@@@@@..@.@@@@@@@@@@@@@@@@@@@@@@@@@@@@@@@@@@@@@@@@@@@@@@@@@@@@@@@@@@@@@@@@
8
96 54 0
79 7 0
3 35 0
40 80 0
26 79 0
74 63 0
43 73 0
94 83 0

18 85 0
34 98 0
77 35 0
98 8 0
73 25 0
41 86 0
49 29 0
91 60 0
