width 99
height 99
@@@@@@@@@@@@@@@@@@@@@@@@@@@@@@@@@@@@@@@@@@@@@@@@@@@@@@@@@@@@@@@@@...@@@@@@@@@@@@@@@@@@....@@@@@@@@@
@@@@@@@@@@@@@@@@@@@@@@@@@@@@@@@@@@@@@@@@@@@@@@@@@@@@@@@@@@@@@@......@@@@@@@@@@@@@@@@@..@@..@...@@@@
@@@@@@@@@@@@@@@@@@@@@@@@@@@@@@@@@@@@@@@@@@@@@@@@@.@@...@@@@@@@......@@@@@@@@@@@@@@@@...@...@....@@@
@@@@@@@@@@@@@@@@@@@@@@@@@@@@@@@@@@@@@@@@@@@@@@@@@......@@@@@@.......@@@@@@@@@@@@@@@@@@....@@@....@@
@@@@@@@@@@@@@@@@@@@@@@@@@@@@@@@@@@@@@@@@@@@@@@@@@....@.@@@@@@...........@@@@@@@@@@@@@@....@@@@@..@@
@@@@@@@@@@@@@@@@@@@@@@@@@@@@@@@@@@@@@@@@@@@@@@@........@@@@@@........@..@@@@@..@@@@@@@@.......@@..@
@@@@@@@@@@@@@@@@@@@@@@@@@@@@@@@@@@@@@@@@@@@@@@@.......@@@@@@@............@.@...@@@@.........@@....@
@@@@@@@@@@@@@@@@@@@@@@@@@@@@@@@@@@@@@@@@@@@@@@@........@@@@@@.......@...@@.....@@@@................
@@@@@@@@@@@@@@@@@@@@@@@@@@@@@@@@@@@@@@@@@@@@@@@.........@@@@@@@..........@.....@@@.................
@@@@@@@@@@@@@@@@@@@@@@@@@@@@@@@@@@@@@@@@@@@@@............@@@@@@@..............@@@@..........@......
@@@@@@@@@@@@@@@@@@@@@@@@@@@@@@@@@@@@@@@@@.@@...........@@@@@@@@@..............@@@@.@.@@............
@@@@@@@@@@@@@@@@@@@@@@@@@@@@@@@@@@@@@@@...@............@@@@@@@@@......@.......@@@@@@.......@..@....
@@@@@@@@@@@@@@@@@@@@@@@@@@@@@@@@@@@@@@@...@.........@@@@@@@@@@@@@@@............@@@@...............@
@@@@@@@@@@@@@@@@@@@@@@@@@@@@@@@@@@@@@@..............@@@@@@@@@@@@@@@..@...........................@@
@@@@@@@@@@@@@@@@@@@@@@@@@@@@@@@@@@@@.@.@..@....@....@@@@@@@@@@@@@@@@...........@@@...@@@......@...@
@@@@@@@@@@@@@@@@@@@@@@@@@@@@@@@@.@@@.@.@..@@..@@@@.@@@@@@@@@@@@@@@@@.......@@@....................@
@@@@@@@@@@@@@@@@@@@@@@@@@@@@@@@@.@@@.@.........@@@@@@@@@@@...@@@@@@@.....@@@@@...........@.@.......
@@@@@@@@@@@@@@@@@@@@@@@@@@@@@@@......@.........@@@@@@@@@.....@@@@@@......@@@@@..@.....@.@@.........
@@@@@@@@@@@@@@@@@@@@@@.....@@@@@...........@...@@@..@@@@@@....@@.@@......@@@@.........@.@@@@.......
@@@@@@@@@@@@@..@..@@@......@@@@......@...........@...@@@@@.@.............@@@@.........@@@@@@.....@@
@@@@@@@@@@@@.......@@........@...........@..........@@@@...@@@...........@@@..........@@@@@......@@
@@@@@@@@@@..........@@..............................@@@@..@@@..@@.........@@..........@@@@@.@.....@
@@@@@@@@@@...........@@.....@@@......@...............@@@@.@@@..............@@.......@.@@@@@.@......
@@@@@@@@@............@............@..................@@@@.@@......................@@........@.....@
@@@@@@@@@..........@...............@@@...............@@@..............@@..........@@@..@@@........@
@@@@@@@............@..............@@.......@..........@................@@@....@..@......@@...@.....
@@@@@.@@...................@@...@@@@.......@..........@..@@...........@@@@...@@@.................@@
@@@@@.........@@...........@@@...@@@.@...................@@@.........@@@@@@...................@@@@@
@@@@@@.@....@@@......@@....@@..@......@@..@@.@........@..@@..........@@@......@...................@
@@@@@...........@....@@@.@@@..@@.............@........@@@@@.@.......@@@@@..........................
@@@..................@.@.@@@@..@...@@..........@@.@...@@@@@@@@@....@@@@@@.@........................
@@@.@...@....@.......@...@.....................@@.....@@@@@@@@@@@@@@@@@@@.....@.................@.@
@@.........@@@.......@...................@@....@@@@...@@@@@@@@@@@@@@@@......................@@@@.@@
...........@.....@........@..............@@@@@.........@@@@@@@@@@@@@@@@@....@@.....@@@@...@..@...@@
@.....@......@...@..@.......................@....@.....@@@@@@@@@@@@@@@@@.....@@...@@@@@..........@@
......@.@.........................@......@..............@@@@@@@@@@@@@@@@......@....@@@............@
..........................@@.................@@......@...@@@@@@@@@@@@@@@......@..@@@@@@...........@
......@....@@@....@...........................@....@......@@@@@@@@@@@@@@@@....@@@@@@@@@@@.........@
....@.@....@@@@....................................@...@...@@@@@@@@@@@@@@@@...@@@@@@@@@...........@
...........@.@...................@.....@..........@....@...@@@@@@@@@@@@@@@@...@@@@@@@@@....@....@@@
..@.@...@@@@.@....@...........@@.........@...............@@@@@@@@@@@@@@@@@@...@@@@@@@@@.........@@@
@........@........@........@@@@@.........@................@@@@@@@@@@@@@@......@@@@@@@@@........@@@@
@@...@@.........@@@@......@@@@@@.......@...........@.@.....@@@@@@@.@@.@@.....@@@@@@@.@@........@@@@
@@@@@...........@@@@@.....@@@@@........@@....@.............@..@.....@.@.....@@@@@@@......@...@@@@@.
@@@@@...............@.....@@@@@@............@@.@@@.@@...............@.......@@@@@@@.@.........@@@..
@@@@@@..................@@@@@@@@............@@@@@@.@........................@@@@@@@@@..........@...
@@.......@...........@@@@@@@@@@.............@@.@@@..........................@..@@@@@@@@@....@@.@...
@@@......@@............@@@......................@@.......@.....................@@@@@@@@@...........
@@@.......@....................@.....@..@.......@@................................@@@@@@..........@
@@@...............@@@..@...........@@@@@@........@................................@@@@@...........@
@.............@..@@@@..............@@@@@@...................@........@..........................@@@
@@..............@@@@@@......@@@@@@@@@@@@................@.....................@.................@@@
@...............@@@@@......@@@@@@@@@@@@............................................@............@@@
@@.......@@.........@.....@@@@@.@@..@@@................@@..@@.@@............@....@@@..@@.........@@
@........@..@@.@@@........@@@.......@@@@.......@@.@......@@@@.@....@.....................@...@...@@
@...@........@@@...@...............@@..........@@........@@@@@@....@.............@...@...........@@
....................................@.......@..@@........@@@@@@.........@.....@..................@@
....................@@@.....@..................@@.......@@.@..@@..............@@....@............@@
................@.@@....@...@...............@@@@........@.....@@..............@@@................@@
...................@.........................@@@.@............@@@@...........@@@@...@.....@.......@
......@@@@.........@.................@.........@.@..........@@@@@@@@.@@@@@...@@@@.@@.......@@@....@
....@@@..............@....@...........................@..@@@@@@@@@@@@@@@@..@@@@@@@.........@@.....@
...@@@@.@.............@@....@...........@@@@..........@@@@@@@@@@@@@@@@@....@.@@@@@.....@@.........@
@@@@@@@.@@@@...@@@................@@....@@@@.....@....@@@@@@@@@@@@@@@........@...@@...............@
@@@@@@@@@@@@@@@@@.................@.....@....@........@@@@@@@@@@@...............@@@......@....@@@.@
@@@@@@@@@@@@@@@@@..............@@@@..........@@.......@@@@@@@@@@.........................@@...@@@@@
@@@@@@@@@@@@@@@@@@.......@@@@@@@.@@@......@..@@...@@.@@@@@@@@@@@.........................@@@@.@@@@@
@@@@@@@@@@@@@@..@...........@@@@..................@@...@@@@@@@@.................@......@@@@@@@@@@@@
@@@@@@@@@@@@@@..........@...@@@@...........@......@@....@@@@@@..................@@....@@@@@@@@@@@@@
@@@@@@@@@@@@@.@.................@@@........................@@@..................@@..@@@@@@@@@@@@@@@
@@@@@@@@@@@@@..........@................................................@.@.......@@@@@@@@@@@@@@@@@
@@@@@@@@@@@@...........@..................................................@..@@....@@@@@@@@@@@@@@@@
@@@@@@@@@@@.......@...@............................................@@........@@@...@..@@@@@@@@@@@@@
@@@@@@@@@@@..@...@@.......................@@@@.................@......@.@....@@@......@@.@@@@@@@@@@
@@@@@@@@..@......@@.....@@.......@@.....@.@@@@@@.............@.@@@@@..........@@...@.....@@@@@@@@@@
@@@@@@@@.......@.........@@@......@.@...@@@@@@@@@@............@@@@@..........@@.......@@@@@@@@@@@@@
@@@@@@@@.................@@@....@...@@@.@@@@@@@@@@@@..........@@@@@@.........@@@.......@@@@@@@@@@@@
@@@@@@@@.@@........@...@.@@@@.......@@@@@@@@@@@@@@@@..........@@@@@@..........@@@.......@@@@@@@@@@.
@@@@@@@@@@@@.............@@@........@@@@@@@@@@.@@.@@......@@..@@@@@@..........@.....@...@@@@@@@@@@.
@@@@@@@@@@@@@..@..........@@.......@@@@@@@@@@....................@@.......................@...@@@@.
@@@@@@@@@@@@@......@@............@@@@@@@@@@@........@@@..@.............................@.....@@@@@.
@@@@@@@@@@@@@.......@..........@@@@@@@@@@@@@@.........@.........@...@..........................@@..
@@@@@@@@@@@@@.@..........@@@@@@@@@@@@@@@@@@@.................@.@@@.................................
@@@@@@@@@@@@@@@..........@@@@@@@@@@@@@@@@@@.........@...@..@.@@@@@@...........@.@.................@
@@@@@@@@@@@@@@...........@@@@@@@@@@@@@@@@....................@@@@@@@............@................@@
@@@@@@@@@@@@@@............@@@@@@@@@..@..@...................@@@@@@@@......@................@....@@@
@@@@@@@@@@@@@@@....@@@....@@.@.@@@...@@.@...................@@@@@@@@......@.@....................@@
@@@@@@@@@@@@@@@@@@...@................@.....................@@@@@@@@@.....@......................@.
@@@@@@@@@@@@@@@@@@@@@@............@.@.........@.............@@@@@@@@@...@@.....@.@.................
@@@@@@@@@@@@@@@@@@@@.@@@....@@@@....@...................@.@@@@@@@@@@@@.@@@@...@@@@.................
@@@@@@@@@@@@@@@@@@@..@@....@@@....@.......@@......@@....@@@@@@@@@@@@@@@@@@@....@@@.................
@@@@@@@@@@@@@@@@@@@.........@@............@@@.........@@..@@@@@@@@@@@@@@@@@....@@@.....@..........@
@@@@@@@@@@@@@@@@@@......................@@@@@@..@@@...@....@@@@@@@@@@@@@@@@...@@@...@.@@...@....@@@
@@@@@@@@@@@@@@@@@@........@.........................@....@@@@@@@@@@@@@@@@@@@@@@@@...@@@@@@.....@@@@
@@@@@@@@@@@@@@@@@.....@@@@@.........................@...@@@@@@@@@@@@@@@@@@@@@@@@.....@@@@@......@@@
@@@@@@@@@@@@@@@@@....@@@@@@.............@....@.@....@...@@@@@@@@@@@@@@@@@@@@@@@@..@@@@@@@@@@...@@@@
@@@@@@@@@@@@@@@@@....@@@@@.....@@.........@@@@@...@@@.@@@@@@@@@@@@@@@@@@@@@@@@@@@@@@@@@@@@@@.@..@@@
@@@@@@@@@@@@@@@@@...@@@@@@..@..@@..@..@@@@@@@@...@@@@@@@@@@@@@@@@@@@@@@@@@@@@@@@@@@@@@@@@@@@@@@@@@@
@@@@@@@@@@@@@@@@@...@@@@@......@@....@@@@@@@@@@@@@@@@@@@@@@@@@@@@@@@@@@@@@@@@@@@@@@@@@@@@@@@@@@@@@@
8
34 38 0
21 75 0
18 98 0
16 23 0
13 26 0
42 13 0
82 83 0
77 77 0

54 70 0
57 70 0
18 98 0
16 23 0
25 72 0
33 29 0
35 89 0
25 50 0
