width 99
height 99
@@@@@@@......@@......@.....@@@@@@@@@@@@@@@.........@@@@@@@@@@@@@.................@@@..........@@..@
@@@@@@@.......@@..........@@@@@@@@@@@@@@@...@........@@@@@@@@@@@............@..........@@..........
@@@@@@@...............@@..@.@@@@@@@@@@................@@@@@@@@@@...@.......@@......@...............
@@@@@@@................@@...@@@@@@@@@@.................@@@@@@@@@...........@@....................@.
@@@@@@@@......@....@...@@...@@@@@@@....................@@@@@@@@@@..@@............@.......@@@.......
@@@@@@@................@....@@@@@@@@........@..........@@@@@@@@@@......................@@..........
@@@@@@............@........@@@@@@@@@@............@...@.@@@.@@...@@..........................@@.....
@@@@@@...................@@@@@@@@@@@.................@@@@..@@....@@@........................@@.....
@@@@@@@.@................@@@@@@@@@@.............@...@@@@@.........@...........@@............@......
@@@@@@@.@...............@@@@@@@@...............@@...@.@@..........@......@............@...........@
@@@@@........@@.........@@@@@@@@..........@....@@...............@.@..........@................@...@
@@.@..@..@@@.@@.........@@@@@@@...@@@@........@@.............................@....@@@...........@@@
...@...@.@@@.......@......@@@@@@..@@@@........@.....@............................@@@@......@....@@@
@.....@..@@...@............@@@.@..@.....@@@.@......@..@.@.........@.@.............@@@@..........@@@
@..........................@@@.......@..@@@.@......................................@@@.......@..@@@
@....@...@.....@@.........@@@@.........@@@@.@.......................@.....@........@@@.........@@@@
...@...........@@.........@.......@.......@...............................@@@.......@@@..@.....@@@@
.@.........@.......@.....................................@...............@...................@.@@@@
.........................@............................@@@@....................................@@@@@
.......@@@@.....................@..............@@@@...@@@.................@........................
.......@@@@@..............@@...................@@@@...@@@@.......................................@.
@@.....@@@@......@@.......@@@.@...............@@@@........................@........@...............
@@...@....@...............@@........@.......@............................@@............@.@@.......@
@.........@............@@.@@............@...............@...........@...............@.............@
@@@@@...@.@.....@@@....@@@..............@.......................@.....................@@..@.@......
@@@@@............@@...@@@.............@@@@.........@......@...@@.......@......@.........@.@@.......
@@@@@..........@.......@@.............@@@@...............@.............@@@....@.......@@@@@@@......
@@@@@@@.......@@........@.......@@@@@...............@...@@........@.....@..@@@@......@@@@@@@@..@@..
@@@@@@@@@.............@.@........@@@...............@@...@@....................@@@......@@@@@.......
@@@...@@@...............@...@@............@@....@@..@@..@@............@...................@.....@..
@@@....@@.......@.........@@@@@@@.....@...@@@@@@@@..@@@@@.....................@....................
@@@....@@@@@@.........@...@@@@@@......@..@@@@..@@@..@@@@......................@....................
@@@@...@.@@..........@....@@@..@@@..............@@.@@@@@....@......................................
@@@@.....@...............@@@@......@................@.............@..................@.............
@@@...............@...........@@.......@@.................@........................................
@@@@..@@...........@....................@.@@....@@........@...@..............@.................@...
@@@@.@....................@.............@@@@@...@@@.@.........................@@..@@@...@.....@@...
@@@..............@@.....................@@@@@@..@@@@@@@@@..............@......@@..@@@@@.......@@...
@@@.......................@..............@@@@@..@@@................@@....@@.........@@........@@@..
@@@........@........@@@...@.......@...@@.@@@@@.....................@@...............@.....@........
@@@................@@................@@@@@@@@@@@.@..............@@................@@@..............
@@......@..........@@..........@....@@@@.@@@@@@@@@.@....@@......@@@.............@@@...@@@@.........
@@@@@@@@.........@.@@@..@................@@@@@@.......@@@@..@@@@@@@.............@@@................
@@@@@@@..@.......@......@...@......@.........@@.......@@@@@@@@@@@@@@@.@.........@@@........@.......
@@.............@...................@.........@.........@@@@@@@@@@@@@..@...........@....@........@@@
@@...@.........@.@.............................@..@@....@@@@@@@@@@@@..@...............@.....@@.@@@@
@@...........@.................................@@@@@.....@@@@@@@@@@...@..................@..@@..@@@
@@..................@..........................@@@@@@.....@@@@@@@@@...@.....................@@..@@@
@...................@.........@..................@.@@@....@@@@@@@@@......@@@@@..................@@.
@@............@...............@@@..............@.@.@@@@.@@@@@@@@@@.......@@@@@@.@....@.............
@..@@@@@@@@............@.@...@@@...............@......@.@@....@@@....@@..@@@@@@@@....@@............
..@@@@@@@@@@............@@@..@.@.....@@@...@........@@........@.....@@@@@@@@@@@@@.........@@...@...
...@@@@@@...............@@@....@@.....@@.........@............@.....@@@@@@@@@@@@...@...........@@..
....@.@@......@@.@....@@@@.@.........................@@@....@@@@....@@@@@@@@@@@@...............@@..
......@@...................@@.............................@.........@@@@@@@@@@@@@@.............@@..
............@@@...............................................@@.....@@@@@@@@@@@@@.@.......@...@@..
....................@@@@....@.......................@.........@@.....@@@@@@@@@@@@.....@@@......@@..
.......@@.........@@@@@@...@@.................................@@.....@@@@@@@@@@@@.@............@@@@
.......@...@..@@@@@@@.................................................@@@@@@@@@@...............@@@@
@...@......@@@@@@@@@...........@@....@@....@@...@.@..............@@@@@@@@@@@@@.................@@@@
...........@@.@@@@@@......@.....@....@@@...@@............@....@@.@@@@@@@@@@@@..................@@@@
@..........@@........@@@@@@@@..........@@..@..................@@@@@@@@@@@@@@@.........@@@......@@@@
@....................@@@@@@@...............@..........@...@...@@@@@@@@@@@@@@@@.................@@@@
@@.............@.....@@@@@@@....@@....@...@..............@@...@@@@@@@@@@@@@@@................@.@@@@
...............@@@@..@@...@@@...@@@@......@@...................@@@@@@@@@@@@@@..................@@@@
@..............@..........@......@@@@...............................@@@@@@@@@........@.........@@@@
@@@...........@...................@@........@.......................@@@@@@@@.....................@@
@.............................@@........@..@@......................@@@@@@@@@..........@.........@@@
@@@@@@...............................@@....@@...........@@.........@@@@@@@@@@..................@@@@
@@@@@@.........@........@@..............@@@@@...@@.................@@@@@@@@@@@.@..........@.....@@@
@@..@......................@.....@...........@@@@@@@@..............@@@@@@@@@@@@@@..............@@@@
@...@...@.@@@.............@@.................@@@@@@@@......@......@@@@@@@@@@@@@@@@.@@.......@...@@@
...@....@.....@@..........@@........@@.......@@@@@@@@.............@....@.@@@@@@....@..............@
...................@@.....@@@@....@.@@@@.......@@@@@@.....@@@.............@.@@@...........@.@.....@
.....@@....................@@@@@..@@@@@@@@.....@@@@@@......@.................................@@..@@
....................@.....@@@@@@@@@@@@@@@@....@@@@@@@@.............................................
@@@.......@@........@.....@@@@@@@@@@@@@@@@@@@@@@@@@@@@.........@@..................................
@@@@@.....@...@@....@.....@@@@@@@@@@@@@@@@@@@@@@@@@@@@..................@...............@.@........
@@@@@.....@.........@....@@@@@@@@@@@@@@@@@@@@@@@@@@@@@@.......................@@.....@.@@.@.......@
@@@@@@..@....@......@.....@@@@@@@@@@@@@@@@@@@@@@@@@@@@@...............@.......@...........@......@@
@@@@@@..@.........@.@@....@@@@@@@@@@@@@@@@@@@@@@@@@@@@@@.....@......@@@..........................@@
@@@@@@@@..................@@@@@@@@@@@@@@@@@@@@@@@@@@@@@@@.@@@.......@..@@............@.......@@..@@
@@@@@@@@............@.....@@@@@@@@@@@@@@@@@@@@@@@@@@@@@@@@@@@......@@@.......@...............@@..@@
@@@@@@@@@......@..............@@@@@@@@@@@@@@@@@@@@@@@@@@@@@@@.@...................................@
@@@@@@@@.........@@............@@@@@@@@@@@@@@@@@@@@@@@@@@@@@@....@@..............@...............@@
@@@@@@@@.............@@@.........@@@@@@@@@@@@@@@@@@@@@@@@@@@@.....@.............................@@@
@@@@@@@@..@.........@@@@@@.......@@@@@@@@@@@@@@@@@@@@@@@@@@@@...........@......@.@..............@@@
@@@@@@@@.......@@.....@@.........@@@@@@@@@@@@@@@@@@@@@@@@@@@@.................@............@@@@@@@@
@@@@@@@@@....................@....@@@@@@@@@@@@@@@@@@@@@@@@@@.......@@.....................@@@@@@@@@
@@@@@@@@@...@......@@@.......@....@@@@@@@@@@@@@@@@@@@@@@@@@@.......@..............@....@@@@@@@@@@@@
@@@@@@@@...@@......@@@@......@...@@@@@@@@@@@@@@@@@@@@@@@@@@@................@..@@......@@@@@@@@@@@@
@@@@@@@@@@@@@......@@@@@@.......@@@@@@@@@@@@@@@@@@@@@@@@@@@....................@@......@@@@@@@@@@@@
@@@@@@@@@@@@@.@.......@@@..@...@@@@@@@@@@@@@@@@@@@@@@@@@@@@@.............@@.....@.@...@@@@@@@@@@@@@
@@@@@@@@@@@@@@@.......@..@.....@@@@@@@@@@@@@@@@@@@@@@@@@@@@@@@...........@@...........@@@@@@@@@@@@@
@@@@@@@@@@@@@@@................@@@@@@@@@@@@@@@@@@@@@@@@@@@@.......@.@.............@....@@@@@@@@@@@@
@@@@@@@@@@@@@@..............@@@@@@@@@@@@@@@@@@@@@@@@@@@@@@@.@.@................@.......@@@@@@@@@@@@
@@@@@@@@@@@@@..@@.............@@@@@@@@@@@@@@@@@@@@@@@@@@@@@@.............@.....@......@@@@@@@@@@@@@
@@@@@@@@@@@@@@.@@.............@@@@@@@@@@@@@@@@@@@@@@@@@@@@@@@@...........@.............@@@@@@@@@@@@
@@@@@@@@@@@@@@@@@.@..@@.......@@@@@@@@@@@@@@@@@@@@@@@@@@@@@@@@@@...@@@...@.............@@@@@@@@@@@@
8
67 20 0
49 67 0
14 34 0
47 12 0
4 23 0
15 74 0
30 56 0
88 14 0

23 84 0
41 67 0
82 29 0
57 55 0
85 48 0
35 61 0
40 11 0
15 95 0
