width 13
height 13
@@@@.......@@
@@@@.....@@@@
.@@......@@@@
.@@....@..@@@
........@@@@@
.......@@@@@@
.....@..@@@@@
.@......@@@@@
.........@@@@
..@@@@....@@@
..@@@@...@@@@
..@@...@@@@@@
..@@....@@@@@
8
7 1 0
5 0 0
8 8 0
0 2 0
4 5 0
6 5 0
7 9 0
7 4 0

6 0 0
5 0 0
9 0 0
0 2 0
10 0 0
0 9 0
0 5 0
5 4 0
