width 22
height 22
@@@@@@@.@@@@@@@@......
@@@@@@@....@@@@@......
@@@@@@.....@@@@@.....@
@@@@@@................
@@@@@@................
@@@@@@................
@@@@@@@@...@@.........
@@...@@@.........@@...
@.....................
@........@@..........@
..@@@..............@@@
.@@@@..@@..........@@@
.@@@@.........@....@..
.@@............@......
............@@.@......
......................
......................
@.....................
...@@.................
..@@....@.@...........
.@@@@@@@@@@.......@@@.
@@@@@@@@@@@.......@@@@
8
19 13 0
11 17 0
3 17 0
14 20 0
2 7 0
11 9 0
7 12 0
3 9 0

20 7 0
11 17 0
20 0 0
0 12 0
1 8 0
0 19 0
16 12 0
18 15 0
