width 17
height 17
@@@@@@@@@@@@...@@
@@@@@@@@@@@....@@
@@@@@@@@@@@.....@
@@@@@@@@.........
@@@.@@@@..@......
@@@.@.@..........
@@@.....@.....@..
....@...@........
........@........
@................
@.........@...@..
.................
............@.@.@
..........@.@@..@
............@...@
....@.@@....@@.@@
@.@@@@@@@.@.@@...
8
12 7 0
13 2 0
9 12 0
5 9 0
8 10 0
1 12 0
10 9 0
2 11 0

11 8 0
12 11 0
7 8 0
2 13 0
8 9 0
8 10 0
9 11 0
0 7 0
