width 17
height 17
@@@@@@@@@@@...@@@
@@@@@@@@@.....@@@
@@@@@@@@@...@@@@@
@@.@@@......@@@@@
@@.@@.......@@@@@
...@@..@..@.....@
@................
@................
@@...............
......@@@...@....
.................
@@.@......@......
@@@...@...@@..@@.
@@@@@.....@...@@@
@@@@@@...........
@@@@@@@@..@......
@@@@@@@@.....@...
8
2 7 0
9 10 0
10 4 0
8 13 0
9 7 0
5 10 0
9 14 0
12 14 0

15 15 0
16 16 0
13 10 0
12 0 0
1 7 0
12 10 0
8 16 0
2 4 0
