width 17
height 17
.....@@@@@.......
....@@@@.........
.....@...........
........@........
..........@@.....
.....@.@..@@.@..@
.....@.@..@@.....
.......@.@@.@....
.......@..@......
..........@......
..........@....@@
...............@@
@@....@.........@
@@@.............@
@@@@@...........@
@@@@@.....@@....@
@@@@.....@@@@....
8
15 3 0
4 6 0
5 11 0
6 16 0
7 2 0
15 13 0
13 4 0
15 15 0

2 6 0
13 3 0
11 1 0
6 16 0
10 0 0
0 7 0
0 0 0
0 1 0
