width 17
height 17
.....@..@@@@...@@
..............@@@
......@@@....@@@@
........@...@@@@@
........@...@@@@@
..@.....@@.@@@@@@
........@@.@@@@@@
...........@@@@@@
..........@@@@@@@
......@...@@@@@@@
..........@@@@@@@
..........@@@@@@@
...@@....@..@@@@@
..@@........@@@@@
.@@@...@@....@@@@
..@@@.......@@@@@
@@@@@...@...@@@@@
8
3 6 0
7 11 0
6 6 0
10 1 0
8 13 0
11 13 0
10 6 0
3 10 0

4 1 0
11 3 0
14 0 0
7 0 0
0 15 0
2 4 0
0 6 0
9 2 0
