width 20
height 14
..............@.....
....................
.........@.@..@.....
....@............@..
....................
.......@............
....................
...............@....
....................
.....@...@........@.
...@.........@......
.......@............
...............@....
.........@.@@.......
6
3 1 0
19 12 0
9 3 0
10 13 1
17 9 1
6 3 1

13 8 0
19 5 0
16 9 0
0 0 1
5 0 1
3 2 1
