width 20
height 14
.........@@.........
....@...........@...
..@.................
........@..@........
....@..........@....
....@.....@.@.@.....
.@...@..............
..@.....@.......@...
...@..........@.@...
....................
................@...
......@.@.@.........
.........@...@......
....................
6
5 1 0
19 2 0
10 10 0
8 5 1
17 11 1
13 7 1

10 1 0
0 4 0
2 6 0
11 11 1
8 8 1
17 5 1
