width 20
height 14
.................@@.
....................
........@...........
....................
......@....@........
...............@....
@@@........@..@.....
..@...@.............
....@......@..@.@...
...@......@.........
@...................
..@....@..@...@..@..
......@.@...........
....................
6
4 7 0
16 7 0
1 0 0
4 2 1
5 9 1
2 10 1

5 9 0
5 12 0
17 5 0
18 12 1
1 7 1
19 0 1
