width 20
height 14
.................@..
........@...........
...@................
.............@......
......@....@.....@..
.@..................
...@.@.....@@.@.....
......@....@@.......
..................@.
....................
........@........@..
....@.....@..@......
.................@@@
..................@@
6
17 1 0
15 6 0
19 9 0
6 8 1
8 5 1
7 6 1

9 9 0
15 6 0
15 10 0
16 3 1
11 10 1
18 11 1
