width 20
height 23
....................
.......@............
...............@....
.....@..............
.........@....@.....
......@.@...........
....................
.@..@..@...@........
.....@..............
............@.@.....
.........@.....@.@..
....@...............
..@....@............
...........@.@..@...
......@...@.........
...@...............@
..............@.....
.@....@.............
..............@.....
...@.....@..........
........@...........
................@...
@@..@@..............
6
6 16 0
12 12 0
14 14 0
4 20 1
2 7 1
6 9 1

4 18 0
17 7 0
14 13 0
0 15 1
11 22 1
10 0 1
