width 20
height 23
@........@@@@@..@...
@...........@@......
......@........@....
........@...........
............@....@..
...........@........
..............@.....
................@...
...........@........
....@.......@....@@.
........@......@.@@.
.................@@.
@@.....@..........@.
......@.............
.........@......@...
....................
..@.@.@.............
............@.@..@..
...........@........
..@..@..............
.............@......
......@......@......
.........@..........
6
14 19 0
3 19 0
12 21 0
15 20 1
17 16 1
2 22 1

14 20 0
13 15 0
8 17 0
19 1 1
6 4 1
3 9 1
