width 20
height 23
@@@....@............
@@@@................
@@@@.......@.@....@@
@@@.................
@@@..@.@.@.......@..
@...................
.....@..............
..............@.....
....@..........@..@.
...@................
.......@.@....@.@...
.@..................
.....@...@..........
....................
@...@...............
@..........@@.@.....
.@.@........@.....@.
..@.................
.........@.........@
....@...............
............@...@...
......@..@..........
....@......@......@.
6
0 19 0
18 17 0
1 12 0
18 13 1
6 20 1
10 16 1

13 7 0
6 17 0
13 8 0
8 13 1
13 16 1
5 2 1
