width 20
height 23
....................
....................
..............@.....
.....@....@....@@...
...............@@...
...@..........@@@...
.......@....@@@@....
.@...........@@@....
...@.........@......
..........@....@....
...@....@..@........
....................
........@...........
....@..@........@...
......@......@......
...................@
.....@.@...........@
...@.............@..
.......@........@...
....................
..................@@
...@.......@........
@..@....@.@.........
6
7 9 0
8 19 0
12 19 0
11 0 1
0 5 1
1 22 1

17 21 0
14 10 0
15 1 0
2 16 1
18 17 1
18 6 1
