width 20
height 23
....................
....@.........@.....
......@..........@..
..............@...@.
..@.@.@.@.......@...
@@.......@..........
.........@....@.....
.....@..........@...
@.......@...@.......
......@...........@@
.........@...@.@...@
.............@..@...
......@..@.....@....
..@.................
...@...@..........@.
...........@........
.........@......@...
..................@.
...........@.@......
.....@..............
.....@..............
.....@@..@.....@....
....@@@@............
6
13 7 0
17 0 0
19 4 0
12 14 1
11 11 1
4 10 1

12 7 0
0 22 0
19 5 0
13 1 1
18 11 1
15 15 1
