width 20
height 23
....@...............
......@.............
....@.............@.
....................
........@...........
.........@.......@@.
.@...........@......
.@..........@.......
......@..@......@...
.................@..
.............@......
....................
@......@............
..........@.....@...
.....@..@...@.......
............@...@...
.........@......@...
...@..@...@.........
.@.....@.........@..
....................
..........@.........
.........@..........
@...................
6
12 5 0
13 12 0
3 21 0
14 11 1
8 16 1
5 0 1

4 21 0
0 3 0
2 21 0
15 13 1
14 17 1
19 13 1
