width 28
height 28
@@.@@....@@.....@@..@@@@@...
@@..@...............@@@@....
@@@............@@....@@@..@@
@@@@...........@@....@@@.@@@
@@@@...@@@...............@@@
@@......@@@..@.......@@...@@
........@@@.......@@@@@@..@@
...................@@@@@....
............@......@@@@@....
.......@...@@....@..@@...@@.
............@.@...@.........
..@..@...@..@@@...@@@@......
..@@................@@.....@
...@...@............@@@.@@..
..............@.@...@@@.@@@@
.....................@@....@
........................@..@
.....@@..@...@@.............
.@.......@...@@.@@..@.......
.......@@@.........@........
.......@@@.......@@@........
@................@@@........
@@@@@@...................@@@
..@@.......@.@............@@
..........@@@@...@.........@
..........@@.........@@....@
.........@@@@........@....@@
.........@@@@.......@@....@@
8
25 21 0
14 9 0
11 4 0
2 0 0
7 1 0
12 7 0
27 10 0
18 15 0

16 21 0
2 13 0
26 25 0
4 13 0
7 1 0
16 6 0
0 23 0
22 24 0
