width 28
height 28
@@@@@@.......@@........@@@@@
@@@@@@...@....@@.....@.@@@@@
@...@@..@.....@@.....@@@@@@@
@......@@.................@@
@......@@..@@......@.......@
@@.....@@.@@@........@.....@
...........@...............@
............................
.........................@@@
@...............@..@@....@@@
@.......@....@.....@@.@@@@@@
.....@.@@@@...........@@@@@@
......................@@@@@@
..............@........@@@@@
.............@..@.....@@@@@@
@......@....@@........@@@@@@
@@@.@.....@..@........@@@@@@
@@@@@@.......@........@@@@@@
@@@@....@............@@@@@.@
@@@@@...................@@..
@@@@@@@.......@.@...........
@@@@@@@@@.@......@@........@
@@@@@@@@@.@................@
@@@@@@@@@@@@................
@@@@@@@@@@@@@.......@.......
@@@@@@@@@@@@@@@@@...@.@.....
@@@@@@@@@@@@@@@@@..@........
@@@@@@@@@@@@@@@@@.@@........
8
10 12 0
10 13 0
26 22 0
21 25 0
1 12 0
11 17 0
0 8 0
16 16 0

24 9 0
0 14 0
18 22 0
16 1 0
2 12 0
5 6 0
8 14 0
1 2 0
