width 28
height 28
@@@@@@@@@@@@@...@@..@.@@@@@@
@@@@@@@@@@@.....@@.....@@@@@
@@@@@@@@@@@...........@@@@@@
@@@@@@@@@.@@...........@@@..
@@@@@@@@@.@@...........@....
@@@@@@@@@........@...@.@...@
@@@@@.@..........@@@@@.....@
@@@@@.............@@@@......
@@..@...............@@......
@@..@.@@@...@@..............
@@@.@..@@.....@..........@..
@@@....@@..........@.....@@@
.@.......................@@@
.....................@@@@@@@
.................@........@@
@@@....@.................@@@
@@@@...@.................@@@
@@@@@.@@....@@.@@........@@@
@@@@@@@@....@@@.........@@@@
@@@@@@@@...@@@...........@@@
@@@@@@@.....@........@@@.@@@
@@@@@@@.....@.............@@
@@@@@@@@..............@...@@
@@@@@@@................@@@@@
@@@@@@@@........@.......@@@@
@@@@@@@@@@...@.@@.......@@@@
@@@@@@@@.....@@......@....@@
@@@@@@@@....@@@...@.......@@
8
10 15 0
9 10 0
15 7 0
10 7 0
24 4 0
24 22 0
26 7 0
14 20 0

6 7 0
20 4 0
25 27 0
22 25 0
14 25 0
8 6 0
15 19 0
14 21 0
