width 28
height 28
@@@@@@@@@@@@@@@@@@@@@@@@@@@@
@@@@@@@@@@@@@@@@@@@@@@@@@@@@
@@@@@@@@@@@@@@@@@@@@@@@@@@@@
@@@@@@@@@@@@@@@@@@@@@@@@@@@@
@@@@@@@...@@.@@@@@@@@@@@@@@@
@@@@@@....@@..@@@@@@@@@@@@@@
@@@@@@....@...@@@@@@@@@@@@@@
...@..........@@@@@@@@@@@@@@
....@.........@@@@@@@@@@@@@@
...............@@@@@@..@@@@@
@@.................@@@...@@@
@@.......................@@@
@@......@....@.....@.....@@@
@@.....................@@@@@
@@...........@.........@@@@@
@.....................@@@@@@
.....................@@@@@@@
.................@...@@@@@@@
....................@.@@@@@@
@@@@......@..@@.......@@@@@@
@@@@..................@@@@@@
@@@........@..........@@@@@@
......................@@@@@@
.......@..........@@..@@@@@@
...........@@@.........@@@@@
...@.......@@..........@@@@@
@.....................@@@@@@
@.....@@@@...........@@@@@@@
8
14 22 0
17 11 0
17 10 0
22 12 0
15 11 0
1 26 0
18 27 0
1 17 0

8 20 0
1 27 0
9 26 0
8 9 0
1 26 0
18 10 0
0 8 0
1 17 0
