width 28
height 28
@....@@@@@@@@@@@@@.@@@@@@@@@
.....@.@@@@@@@@@@.....@@@@@@
.......@@@@@@@@@@....@@@@@@@
.......@@@@@@@@@@....@@@@@@.
....@..@@@@@@@@@@.@@..@.@...
.........@@@@@@@........@...
@@...........@@@............
@@@..........@@.............
@@...........@......@.......
@@.....@....................
@@....@@@........@.....@..@.
@@....@..........@..........
@@...................@@...@.
@@..........................
@...........................
@.................@@@@@@@@@@
@@...............@@@@@@@@@@@
@@................@@@@@@@@@@
@...................@@@@@@@@
@@..@............@...@@@@@@@
@@@@@@@..@...........@@@@@@@
@@@@@@@.........@.........@@
@@@@@@@...................@@
@@@@@@@...@@..........@..@@@
@@@@@@@@.........@......@@@@
@@@@@@@@..........@@....@@@@
@@@@@@@.@..@@@..@....@..@@@@
@@@@@@@....@@@....@@@@@@@@@@
8
6 17 0
16 15 0
27 14 0
5 18 0
16 16 0
14 17 0
1 3 0
17 22 0

19 1 0
14 14 0
12 6 0
19 5 0
1 5 0
20 7 0
27 4 0
1 3 0
