width 28
height 28
@@@@@@@@@@@@@@@.....@@.....@
@@@@@@@@@@@@@@@......@......
@@@@@@..@@@@@@@@............
@@@@@.....@@@@@@@...........
@@@@@.....@@..@...........@@
@@@@.........@............@@
@@@@........@..@@@@.....@@@@
@@@@...........@@@@......@@@
@@@@...........@@.@@@@...@@@
@............@......@.......
@@...........@......@.......
@@.@................@......@
@@@@....................@@.@
@..........................@
@..........@@...............
@...........................
@......@.........@@.........
@......@......@...@.@@...@..
@...................@@......
@..............@@@@.@@......
..............@@@@@.........
.....@........@@@@..........
@..............@@@..........
@@........@...@@@@.@@....@..
...@@.........@@@@@@........
..............@@@@@@........
............@@@@@@@@........
..........@@@@@@@@@@@..@@@..
8
6 10 0
25 4 0
7 7 0
22 3 0
18 13 0
5 5 0
23 6 0
13 19 0

10 13 0
9 7 0
23 22 0
10 17 0
5 5 0
9 10 0
0 27 0
24 9 0
