width 63
height 63
@@@@@@@@@@@@@@@@@@@@@@@@@@@@@@..@@@@@....@....................@
@@@@@@@@@@@@@@@@@@@@@@@..@@.....@@@@..............@...........@
@@@@@@@@@@@@@@@@@@@@@@@.........@@@@..............@..@........@
@@@@@@@@@@@@@@@@@@@@@@@.......@@@@...@.....@@...........@......
@@@@@@@@@@@@@@@@@@@@@@@......@@@@@..@................@.@.......
@@@@@@@@@@@@@@@@@@@@@@@@.....@@@@@......@.....................@
@@@@@@@@@@@@@@@@@@@@@@@@......................................@
@@@@@@@@@@@@@@@@@@@@@@@@....@...@.......@@.....................
@@@@@@@@@@@@@@@@@@@@@@@.....@...........@@..................@..
@@@@@@@@@@@@@@@@@@@@@.......................@.........@.....@..
@@@@@@@@@@@@@@@@@@@@@..........................@@@.@..@...@.@@@
@@@@@@@@@@@@@@@@@@@@@.@................@...................@@@@
@@@@@@@@@@@@@@@@@@@@@....@...@@.@.....@....................@@@@
@@@@@@@@@@@@@@@@@@@@@.......@@@..@@........@@..............@@@@
@@@@@@@@@@@@@@@@@@@@@........@@@...........@@...@..........@@@@
@@@@@@@@@@@@@@@@@@@@@@.......@@..........@@@@..................
@@@@@@@@@@@@@@@@@@@@@@.......@...........@.@.....@@...........@
@@@@@@@@@@@@@@@@@@@@@@.....................@..@...@@@@.........
@@@@@@@@@@@@@@@@@@@@@@.............@................@@.........
@@@@@@@@@@@@@@@@@@@@@@..............@@...@......@..@@@.@@......
@@@@@@@@@@@@@@@@@@@@@..@..@......@@@@@........@@...@@@.@.......
@@@@@@@@@@@@@@@@@@@@@..@......@@@@@@@@........@.........@@@@@..
@@@@@@@@@@@@@@@@@@@@@@@.......@..@@@@@@.@@..............@@.@...
@@@@@@@@@@@@@@@@@@@@@@@.....@....@@@@@.@..............@....@@..
@@@@@@@@@@@@@@@@@@@@@..........@@@@@@@.@.......................
@@@@@@@@@@@@@@@@@@@@@@.........@@@@@@.....@@@@.@@..............
@@@@@@@@@@@@@@@@@@@@@@..@......@@@@@@.................@......@.
@@@@@@@@@@@@@@@@@@@.....@.@...@@@@@@@.............@......@...@@
@@@@@@@@@@@@@@@@@@@@@....@@...@@@@@........@......@......@@@.@@
@@@@@@@@@@@@@@@@@@@@@.....@...@@@@@....@.@.......@......@@@@@@@
@@@@@@@@@@@@@@@@@@@@@......@..@@@@@@@@@@@@..@....@@.......@@@@@
@@@@@@@@@@@@@@@@@@..............@@@@@@@@@@.......@@...@....@@@@
@@@@@@@@@@@@@@@@@............@..@@@@@@@@@@@......@.....@..@....
@@@@@@@@@@@@@@@...................@@@@@@@@@@@..................
@@@@@@@@@@@@@@@......@@.@.........@@@@@@@@@@@@.................
@@@@@@@@@@@@@@@@..@..@@.@...........@@@@@@@@@@..........@.@....
@@@@@@@@@@@@@@@@@@@.................@@@@@@@@@@....@...@.@@@@...
@@@@@@@@@@@@@@@@@@@@@@.............@@@@@@@@@@@@@.@@@@..@@@@@...
@@@.@@@@@@@@@@@@............@@.....@@@@@@@@@@@@@@@@@@@@@@@@@@.@
....@@@@@@...........@@...........@@@@@@@@@@@@@@@@@@@@@@@@@@...
....@.@@@@.......................@@@@@@@@@@@@@@@@@@@@@@@@@@....
...................@...@@....@....@@@@@@@@@@@@@@@@@@@@@@@@@....
.................@@@..............@@@@@@@@@@@@@@@@@@@@@@@@@....
@..........@.....@....................@@@@@@@@@@@@@@@@@@@@.....
@@@@@@.....@..............@@......@..@@@@@@@@@@@@@@@@@@@@@.....
@@@@@@.....@@@.....@@....@@@............@@@@@@@@@@@@@@@@@@@..@@
@@@@@@..@.@@@@@@@..@@@@..@..........@....@@@@@@@@@@@@@@@@@@@@@@
@@@@@.....@@@@@@....@@..............@....@@@@@@@@@@@@@@@@@@@@@@
..@......@@@@@@@@..........@..............@@@@@@@@@@@@@@@@@@@@@
...@..@..@@@@@@@...........................@.@@@@@@@@@@@@@@@@@@
.........@@@@@..................................@@@@@@@@@@@@@@@
@.@............................................@@@@@@@@@@@@@@@@
@@........@..............@@@@.@............@@...@@@@@@@@@@@@@@@
@@....@...................@@@@@....@@..@....@..@@@@@@@@@@@@@@@@
....@@.............@......@@@@@@..@@@@@@@@.@@..@..@@@@@@@@@@@@@
....@@@@...@....@..........@.@@@.@@@@@@@@@..@.....@@@@@@@@@@@@@
..@.@@...@.@.................@@@@@@@@@@@@@.............@@@@@@@@
......................@@@....@@@@@@@@@@@@...............@@@@@@@
..................@....@@@....@@@@@@@@@@..........@@...@@@@@@@@
........................@@...@@@@@@@@@@@@@@....@@@.....@@@@@@@@
..........@@...@.......@@@@@@@@@@@@@@@@@@@@@@.@@@@@@..@@@@@@@@@
..........@@...........@@@@@@@@@@@@@@@@@@@@@@@@@@@@@@@@@@@@@@@@
..@@.....@@@@@.......@.@@@@@@@@@@@@@@@@@@@@@@@@@@@@@@@@@@@@@@@@
8
56 31 0
44 6 0
26 23 0
58 16 0
17 49 0
51 3 0
22 9 0
57 33 0

21 33 0
43 5 0
4 57 0
31 17 0
38 13 0
23 23 0
23 22 0
56 4 0
