width 63
height 63
@@@@@@@.............@@@....@@...@@@@@@@@@@@@@@@@@@@@@@@@@......
@@@@@@@@...........@@@@@............@@@@@@@@@@@@@@@@@@@@....@@@
@@@@@@@@..........@@@..........@.@...@@@@@@@@@.@@@@@@@@@.....@@
@@@@@@@@............@@...@@............@@@@@@@.@@@@..........@@
@@@@@@@@@.....@.....@....@.............@@@@@@@...@@@@@.@@....@@
@@@@@@@@..@.....@...@@..........@......@@@@@.....@@@@@@@....@@@
@@@@@@@............@@@...................@@@@..@@@@@@@@.....@@@
@@@@@@....................@...............@.....@@@@@@.......@@
@@@@@@@.........@..............................@@@@@@....@...@@
@@@@@@...........................@@...........@@@@@@@........@@
@@@@@..........@@................@@.......@.@..@@@.@@.........@
@@@@...@........@@..........................@............@.....
@@@@....................@@............@............@...@.......
@@@@................................@.......@..................
@@@@......@.....@..........@................@..........@@......
..@...................@..................@..@.........@@.......
.....@................@.............@................@@@..@....
..............................@.....@................@@@.......
.......................@..............@@.............@@@@......
..................@...@.........@.............@.....@@@@......@
..................@@........@......................@@@@@......@
..................@@@.....................@...@....@@@@........
....@..........@@..@@.....@.@@......................@@@........
@........@.....@............@@.............@........@@.....@...
@@....................@@.@..@........@@@.......@@.......@@...@@
@@.....................@@@@@.........@......@@@@@@...@@@@@@....
@@@....................@@............@......@@@@@@....@@..@....
@@@..........@.........................@@.@@@@@@@@@....@.@@.@.@
@@@......................................@@@@...@@@.........@.@
@@@.......@@@.....@.........@@.....@.....@@@@@...@.............
@@@....@@..@@@@................@..........@@@....@.............
@@@........@@@@@.........................@@@...................
@@@.....@..@@@@@@...........@............@@@.@.......@@.......@
@@..........@..@@@.............@@@......@@@@@@@@.......@@.....@
@@@@...........@@........................@@@@@@@.......@@....@@
@@@@@@@.................................@@@@@@@@......@@@...@@@
@@@@@@@.................................@@@@@.@.............@@@
@@@@@@@@.......@............@.......@...@@@.................@@@
@@@@@@@@...@..@@............@@........@@..............@......@@
@@@@@@@@@...................@@.......@............@...@......@@
@@@@@@@@@..................@@@...............................@@
@@@@@@@@@@@@@@@....@@.......................@........@......@@@
@@@@@@@@@@@@@.....@@@.............@@.......................@@@@
@@@@@@@@@@@....@@.@@@.............@@@@...@@................@@@@
@@@@@@..@@@................@........@@...@@....@@@.........@@@@
@@@@@@..........@.......@...........@...@@@@@@.@@@.....@....@@@
@@@@@@.@.............@............@....@@@@@@@@@@@@@........@@@
@@@@@@..............@@....@.@..........@@@@@@@@@@@@@.@.......@@
@@@@@@..@...........@@.@@@@@@..........@@@@@@@@@@@@@@@@......@@
@@@@@@@@@............@@@@@@@@@.....@@.@@@@@@@@@@@@@@@@@@..@@@@@
@@@@@@@@@@...............@@@@@@........@@@@@@@@@@@@@@@@@....@@@
@@@@@@@@.@................@............@@@@@@@@@@@@@@@@@.....@@
@@@@@@@.....@@..@@..............@......@@@@@@@@..@@@@..........
@@@@@@......@@.........@................@@@@...................
@@@@@.....................@.......@...............@@@@.........
@@@@@@...........@..................................@@@........
@@@@@@@@.@.........@@..........@.........@.....................
@@@@@@@@.....................@@........@@@.@................@@@
@@@@@@@.........@.......@....@.....@@@.....@................@@@
@@@@@@@.........@@@......@...@@...@@@@.......................@@
@@@@@@........@...@@.....@...@@..@@@@@........@@..........@@@@@
@@@@@@............@@.........@@@@@@@@@@..@...@@@......@...@@@@@
@@@@............@@@@........@@@@@@@@@@@@......@@@.@...@...@@@@@
8
41 8 0
28 26 0
12 49 0
23 13 0
29 17 0
11 59 0
49 41 0
57 59 0

14 19 0
10 7 0
59 27 0
60 48 0
7 55 0
13 60 0
34 40 0
6 19 0
