width 63
height 63
@@@@@@@@@@@@@@@@@@@@@@..@......@@@@@@@@@@@@@...@@@@@@@......@@@
@@@@@@@@@@@@@@@@@@@@...........@@@@@...@@@@@...@@@@@@@......@@@
@@@@@@@@@@@@@@@@@@@@......@.....@@@@...@@@@@.@@@@@@@@@.@.......
@@@@@@@@@@@@@@@@@@@@.@....@....@@@@............@@@@@@@.........
@@@@@@@@@@@@@@@@@.@@.@@@.......@@...............@@@@..@.......@
@@@@@@@@@@@@@@@@.................................@.............
@@@@@@@@@@@@@@.......@@....................@...@@@..@..........
@@@@@@@.@@@@@@@....................@.........................@@
@@@@@@.......@..........@...........................@.....@@@@@
@@...@.....@.....................@.......@................@@@@@
@@......................@@................@...............@@@@@
@@@@.............@.................................@......@@@@@
@@@@...............................@@@@....@@.............@@@@@
@@@@...........@..@................@@.....................@@@@@
@......@@@@..@.@.........@@...................@............@@@@
@......@@...@@.@@.......@@.............@......................@
@...@@@@@.......@.@.....@@......@.............................@
@@@@@@@@.......@@........@......@.........@...................@
@@@@@@@@@......@@.@@.......@..............................@....
@@@@@@@@@......@...@....@............................@....@....
@@@@@@@................@..........@@@......@@@.............@@..
@@@@@@@.............................@.....@@@@..@@.......@.....
@@@@@@@..@........................@@@...........@@.............
@@@@@@@...........................@....................@.....@@
@@@@@@@.....................@.....@@@@.......................@@
@@@@@@...........@......@.....@....@@@...........@.....@.......
@@@@@...................@...........@@........@..@.@...@.......
@@@@@...................@........@...@@......@@............@...
@@@@@.............@.....@@.............@......@@...............
@@@@@............@@...........................@...............@
@@@@.......@@@@...@....@.........@@........@...................
@@@.........@....................@@...............@@....@.....@
@@@@.............................@@...............@@....@..@..@
@@@@@@.....@@@...............@@..@@...............@@@@.....@...
@@@..@@@...@@@..............@@@..@@.....@@........@@@@....@@...
..@..@@@@@..@@@...@......@..@@..@@@............................
.................@...@.....@@@...............................@.
@..............@.@@.......@@@@......@..........@....@..........
@@................@.................@..........................
@.........@@...@@....@....@.........@@.........................
........@.@@...@@..........@........@...................@...@@@
....@....@...............................................@@@@@@
@@............@@..........................................@@@@@
@@............@@..........@.................................@@@
.............@@@@...@......@..@................@@........@...@@
....@@@@..@@.@@@@..........@@@@.@@.@...........@@........@.....
....@@@......@@@@@@....@.@@@@@@@@@.............@@@.@@..........
@@..@@@...@@@@@@@@@@..@@@@@@@@@@@..@@..........@@..@..........@
@@...@...@@@@@@@@@@@@@@@....@@@@@..@@...........@@@@..........@
@@.......@@@@@@@@@@@@.......@@@@...........@......@@...........
@........@@@@@@@@@@@@.......@@@@.....@.....@......@............
.......@@@@@@@@@@@@@.....@@.@@@............@.@.....@...........
.....@@@@@@@@@@@@@@@....@@@.@........@..@.@..@...@@@......@....
@....@@@@@@@@@@@@@@@@.@@@@@........@.@@@@.....@..@@..........@.
@@.@@@@@@@@@@@@@@@@@@@@@@@@.......@@....@......@........@@.....
@@@@@@@@@@@@@@@@@@@@@@@@@@@......@@@....@............@@@@@@....
@@@@@@@@@@@@@@@@@@@@@@@@@@...@@.@@@@......@@@......@@.........@
@@@@@@@@@@@@@@@@@@@@@@@@@@@@@@@@@@@@@...@@@.........@........@@
@@@@@@@@@@@@@@@@@@@@@@@@@@@@@@@@@@@@@@..@@@.........@........@@
@@@@@@@@@@@@@@@@@@@@@@@@@@@@@@@@@@@@@@@@@......@..............@
@@@@@@@@@@@@@@@@@@@@@@@@@@@@@@@@@@@@@@@@@.............@@.......
@@@@@@@@@@@@@@@@@@@@@@@@@@@@@@@@@@@@@@@@@.........@............
@@@@@@@@@@@@@@@@@@@@@@@@@@@@@@@@@@@@@@@@@@.@....@..............
8
59 49 0
47 4 0
24 34 0
59 5 0
11 27 0
54 40 0
21 14 0
55 22 0

44 42 0
39 30 0
56 2 0
14 23 0
45 60 0
51 5 0
41 44 0
2 14 0
