width 20
height 40
@@@@@@@...@@......@@
@@@@@@@........@..@@
@@..................
@@...........@......
.........@@.........
....................
.@..............@...
....@.@.@......@.@..
@.........@.........
....................
...@@............@..
..@..@......@.......
.............@@.....
.........@..........
.............@......
.....@......@.......
.....@..@...........
@............@......
@@.@...........@....
......@.............
.......@.......@...@
...@...@..@.........
...............@....
.......@............
....@.....@.....@...
....................
........@..@.......@
...................@
....@...@..........@
..@...@.......@.....
...@.@....@@........
..........@...@.....
....................
.........@.@........
....@..@.......@....
.....@....@.........
@...........@.......
@..@..........@.....
...@..............@.
.........@..........
6
9 18 0
1 16 0
13 11 0
2 9 1
8 10 1
0 10 1

13 16 0
10 17 0
15 0 0
12 4 1
7 6 1
0 16 1
