width 20
height 40
...........@........
........@@.@..@.....
....................
.............@......
.@.....@.........@..
.@.......@.........@
...@...........@.@.@
...........@.......@
.......@............
..@..@.@.....@....@.
....................
.........@.@.....@..
....@...@...........
..@..............@..
......@.............
@...........@..@....
.........@..........
.......@.......@....
@...................
...@................
..........@...@.@...
...@................
......@.............
...@....@..@........
....................
......@.@...@.......
.............@......
...@................
.............@......
...@.@.@.@....@.....
...................@
..............@.....
.@...@....@....@....
....@........@......
........@..@....@...
..........@.........
@@@@...............@
@@@@...............@
@@@@....@........@.@
@@@@@............@@@
6
2 33 0
16 31 0
4 21 0
12 7 1
18 25 1
18 29 1

10 17 0
3 30 0
10 34 0
12 7 1
11 21 1
4 4 1
