width 20
height 40
....................
..........@.........
.........@..@...@...
...........@........
....@..........@....
.....@.@.@..........
...........@.@......
.......@............
.@...@.....@......@.
....................
...@......@...@.....
..@......@..........
.......@............
.@............@.@...
.....@..............
....@.....@..@......
.........@...@.@....
..@...@......@......
....................
......@...@......@..
.......@....@.......
..............@@....
............@....@@@
..........@.........
...........@...@....
....@...............
@................@..
.......@............
..@.@.....@.....@..@
..........@.@.......
.......@............
....@...@....@......
....................
@..@...@..........@.
.................@..
......@.............
..@...............@.
........@...........
..........@........@
...................@
6
10 8 0
18 11 0
4 8 0
0 34 1
0 18 1
12 17 1

1 38 0
19 13 0
16 20 0
17 5 1
17 33 1
1 36 1
