width 46
height 46
@@@@@@@@@@@@@@@@@@@@.....@...........@@@.@...@
@@@@@@@@@@@@@@@@@@.......@....................
@@@@@@@@@@@@@@@@@@........@...................
@@@@@@@@@@@@@@@@@@....................@.....@@
@@@@@@@@@@@@@@@@@..@.........@.....@........@@
@@@@@@@@@@@@@@@@@@@@.......@.@........@.....@@
@@@@@@@@@@@.@@@@@@@@...@@.@@......@.@.....@@@@
@@@@@@@@@@@.@.....@@....@........@@.....@@@@@@
@@@@@@@@@@@.....................@@.......@@@@@
@@@@@@@@@@@..........@@........@@@@......@@@@@
@@@@@@@@@@.....@.@..@@@.....@..@@@@.....@@@@@@
@@@@@@@@@@.........@@@@.....@....@@@......@@@@
@@@@@..@@@........@.@@...........@@.....@.@@@@
@@@......@@.......@..@............@......@@@@@
@@.......@@..................@@...@..@@@..@@@@
.........@..................@@@......@@...@@@@
............................@....@......@..@@@
.........@.......................@....@@...@.@
..@@................................@@@@@....@
@@@@@@@..@@.........................@@.@......
@@@@@@..............................@@........
@@@.@@@@.............@@.@@.........@@@.......@
@@...@@@.....@........@@@@.........@@@........
@@..........@@.....................@..........
@.........@.@@.......@................@..@....
...@...@@@@..@.@@....@........................
......@@@@@@@@@@@...............@.............
........@@@@@@@@@.@@............@.....@.......
.@......@@@@@@@@@@@@@@..........@.............
........@@@@@@@@@@@@@@@@........@..@@.........
........@@@@@@@@@@@@@@@@@.....................
@...@@@@@@@@@@@@@@@@@@@@@@..@@@.....@.........
.......@@@@@@@@@@@@@@@@@@@..@@................
@@...@@@@@@@@@@@@@@@@@@@@@.....@...@.........@
@@...@@@@@@@@@@@@@@@@@@@@......@...@..........
@@....@@@@@@@@@@@@@@@...@..........@.....@@@@@
@@...@@@@@@@@@@@@@@@@@@........@..@@....@@@@@@
@@...@@.@@@@@@@@@@@@@@@...........@@@..@@@@@@@
@@@..@...@@@@@@@@@@@@@@@..........@@@@@@@@@@@@
@..@.@....@@@@@@@@@@@@@@........@@@@@@@@@@@@@@
@@...@....@@@@@@@@@@@@@@@......@@@@@@@@@@@@@@@
@.......@@@@@@@@@@@@@@@@@@...@@@@@@@@@@@@@@@@@
.........@@@@@@@@@@@@@@@....@@@@@@@@@@@@@@@@@@
@@.....@@@@@@@@@@@@@@@@@@.@@@@@@@@@@@@@@@@@@@@
@@@.....@@@@@@@@@@@@@@@@@@@@@@@@@@@@@@@@@@@@@@
@@......@@@@@@@@@@@@@@@@@@@@@@@@@@@@@@@@@@@@@@
8
15 12 0
6 14 0
36 16 0
7 42 0
36 3 0
36 13 0
29 8 0
37 31 0

27 21 0
39 33 0
5 44 0
35 8 0
6 24 0
4 16 0
9 39 0
6 45 0
