width 46
height 46
@@@@@@@........@@@@@@@@@@@@@@@@@@@@@@@@@@@@@@@
@@@@@@@@@@@...@.@@@@@@@@@@@@@@@@@@@@.........@
@@@@@@@@@........@@@@@@@@@@@@@@@@@@@@........@
@@@@@@@@.........@@@@@@@@@@@@@@@@@@@@@........
@@@@@.............@@@@@@@@@@@@@@@@@@@@........
@@@@@@@@@........@@@@@@@@@.@@@@@@@..@@@......@
@@@@@@@@@@.......@@@@@@@@..@@@@@....@@@......@
@@@@@@@@.@...@@...@@@@@@..@@@@@.@..@@@@@.....@
@..@..@@.....@@@...@@@@@...........@@@@@@....@
@@...........@@@..@@@@@@...........@@@@@@...@@
@@@......@.@@......@@@@@............@@@@@...@@
...........@@@@.....@@@@@...@........@@.....@@
.........@@@@@@........@@...................@@
........@@@@@@@....@..@@.....................@
........@@@...@........................@..@...
........@....@@@.........@............@@..@...
.......................................@......
...@@...................@.....................
@..@..........................................
............@@...................@............
.................@@@........................@.
..........@......@............................
...........................@..................
...@@@@@@..................@..@...............
.@.@@@@@@@.....@.................@@.@....@..@@
@@.@@@@@@@....@@@.......@........@..@..@.....@
@@@@@@@@@@.....@@.......@........@...........@
@@@..@@@@@.....@@....................@....@..@
@@@......@.....................@.............@
@@@.@....................@@.....@........@@@@@
@@@....................@.................@@@@@
............@...................@........@@@@@
............@.............@.....@@........@@@@
..@......................@@..........@......@@
..........@.................@........@@.....@@
.......@.@...@@@@...........................@@
.......@......@@@@@@@.....................@@@@
.......@.@...@@@@@@@@.............@@.@....@@@@
......@.......@@@@@@@@...@........@@@@@..@@@@@
@@...........@@@@@@@@@......@@...@@@@@@@@@@@@@
@@@@@...@@@@@@@@@@@@@.......@@@@@@@@@@@@@@@@@@
@@@@@@.@@@@@@@@@@@@@@@........@@@@@@@@@@@@@@@@
@@@@@@@@@@@@@@@@@@@@..........@@@@@@@@@@@@@@@@
@@@@@@@@@@@@@@@@@@@@.......@..@@@@@@@@@@@@@@@@
@@@@@@@@@@@@@@@@@@@@...@.......@@@@@@@@@@@@@@@
@@@@@@@@@@@@@@@@@@@@@@.....@...@@@@@@@@@@@@@@@
8
20 32 0
20 18 0
1 32 0
39 12 0
11 7 0
28 32 0
23 25 0
10 4 0

9 0 0
6 14 0
36 1 0
31 25 0
15 31 0
28 32 0
6 18 0
7 16 0
