width 46
height 46
@@@@@@..@@....@....@@.@@@@@@....@@@..@@@@.....
@@@@@@........@....@@.@@@@.......@@...........
@@@@@@@............@@..@@@@.......@...........
@@@@@@@@@@.@.......@...@@................@....
@@@@@@@@@@@@.....@.............@........@@...@
@@@@@@@@@@@......@@........@........@..@@@....
@@@@@@@@@@@......@@..........@.........@@@....
@@@@@@@@@@@@.....@@....................@@@@@..
@@@@@@@@@@@@@.@....@...@......@@@......@@@@...
@@.....@@@@@@@@..@.............@.......@@@....
@.......@@@......@....................@@@@@@..
@................@@........@...........@@@....
..................@........@@@@@.....@@@@@....
...@.....................@...@.@.....@@@@@@.@@
...........@.........@...@.............@@@@@@@
..........@@.............@..............@@@@@@
@@@......................@@@@@..........@@@@@@
@@@.........@@@.........@@@@@@........@.@@@@@@
@@@....@@........@.@....@@@@@@.@@@...@...@@@@@
@@@........@@@.....@..@.@@@@@@@@@@.@.@...@@@@@
.@....................@@@@@@@@@@@..@......@@@@
...........@..........@@@@@@@@@@@@........@@@@
....@.........@....@..@@@@@@@@@@@@........@@@@
...........@@.@....@@@@@@@@@@@@@...@......@@@@
.....@.....@@.@.....@@@@@@@@@@@@..........@@@@
....@........@@.....@@@@@@@@@@@@....@@..@@@@@@
@...........@.@@....@@@@@@@@@@@@@@@@@@@..@@@@@
@@.........@..@@....@@@@@@@@@@@@@@@@@@@@@@@@@@
.@.........@..@@.....@@@@@@@@@@@@@@@@@@@@@@@@@
.@.............@.....@@@@@.@@@@@@@@@@@@@@@@@@@
......................@@@..@@@@@@@...@...@@@@@
@@....@................@@..@@@@@@@........@@@@
@............@..@...........@@@@@@.........@@@
@........................@.@....@@........@@@@
@@..........@.............................@@@@
@@@.......@.....@..................@@.@.@@@@@@
@@@.............@...........@@@...@@@@@@@@@@@@
@@@@..........................@...@@@@@@@@@@@@
@@@..........@@@.........@@...@@...@@@@@@@@@@@
@@@.....@@@.............@..........@@@@@@@@@@@
@@@....@@@............@............@@@@@@@@@@@
@@@.........@@@@.@.@.@@@..@@.......@@@@@@@@@@@
@@@@@.......@@@@...................@@@@@@@@@@@
@@@@@.......@@@@..@...............@@@@@@@@@@@@
@@@@@@....@@@@@@.................@@@@@@@@@@@@@
@@@@@@....@@@@@@@@.....@@......@@@@@@@@@@@@@@@
8
10 24 0
24 9 0
5 21 0
35 7 0
3 15 0
23 7 0
15 20 0
0 20 0

27 36 0
24 11 0
29 33 0
28 14 0
38 6 0
31 44 0
38 34 0
45 2 0
