width 91
height 91
@@@@@@@@@@@@@@@@@@@@@@@@@@@@@@@@@@@@@.......@.......@@@@@@@@@@@@......@@@@@@@@@@@@@@.@@@@@@
@@@@@@@@@@@.@@.@..@@@@@@@@@@@@@@@@@@@................@@@@@@@.@@@.......@@@@@@@@@@@@@..@@@@@
@@@@@@@@....@.....@@@@@@@@@@@@@@@@@@@................@@@@@@@............@@@@@@@@@@@@...@@@@
@@@@@@@@...........@@@@@@@@@@@@@@@@@@...........@@...@@@@@@@@............@@@@@@@@@@@....@@@
@@@@@@@@..........@@@@@@@@@@@@@@@@.....................@@@@@@@@....@@@@..@@@@@@@@@.....@@@@
@@@@@@@@..........@@@@@@@@@@@@@@@@..@@@..............@@@@@@@@@@...........@@@@@@........@@@
@@@@@@@...........@@@@@@@@@@@@@@@@@...@.....@..........@@@@@@@@@@@.......@@@@@...@.......@@
@@@@@@.....@@....@@@@@@@@@@@@@@@.......@.................@@@.@@@@@@.......@@@@.@...........
@@@@@@@.......@@@@..@@@@@@@@@@@..........................@@@..@@@@@............@...........
@@@@@@@@.......@@@.@@@@@@@@@@@@....@@..........@.........@@@...@@@@....@.....@@@......@....
@@@@@@@@.......@@...@@@@@@@@@@@@...............@.@@......@@......@@....@.@....@.@@@........
@@@@@@@@...........@@@@@@@@@@@@..................@@.@....@@................................
@@@@@@@@@..........@@@@@@@@@@@@.................@@@@......................................@
@@@@@@@@@..........@@@@@@..@@@@........@.....@@@@@@@@...........................@.........@
@@@@@@@@@..........@@@.....@@@@@@@@@@@.......@...@@@....................@.@....@@.@..@@....
@@@@@@@@@@..@.......@@.....@@.@..@@@.@@........@.......@@.......@...........@@.......@.....
@@@@@@@@@@..@@...........@...........@@.........................@...........@@...@.........
@@@@@@@@@....@.........@.............@@.........................@...@.......@..............
@@@@@@@@.........................@..@............................................@.........
@@@@@@@............@..........................................@@@.....................@....
@@@@@@@@@...........................@@@@..............@@..........@.................@...@..
@@@@@@@@@...........@........@........@@@@@.......@...@@...@@.....................@@@...@..
@@@@@@@@....................@@...........@@...........@..@@@@.....@.................@@.....
@@@@...@@@..................@@..........@@@@@@...........@@@@@.....@................@@.....
@@@........................@@@@.........@@@@......@......@@@@@..........@@.@........@@.....
@@..........................@@@.....@@@.@@@......@..........@........@@.@@................@
@.....................@@....@@@@....@@@@@@.......@..@@......@@......@@@@@@............@...@
............@................@.@....@@@@@@@.@.......@@..............@@.@..@..........@....@
..........@....@@@@.......@@@........@@@@@..@..@@..@.@....................................@
.......................@.............@@@@@@@@@@@@@............@.....@............@..@.....@
...................@.@............@@..@@@@@@@@@.......@............................@.......
@@@@@@............@@@.............@@@.@@@@@@@@.....................................@.......
@@@@@@............@@@@@..........@@@@@@@@@@@@..@.................@.................@.......
@@@@...@@@@.@@@@@@@@@@@.......@@....@@@@@@@@@...........@..................@@..............
@@@@....@@@@@@@@@@@@@@@@@@@.........@@@@@@@@@........@....@@..............@@@......@.......
@@@.......@@@@@@@@@@@@@@@@@@@........@@@@@@@..............@..@@...........@.............@@@
@@@......@@@@@@@@@@@@@@@@@@@@@........@@@@@..........@...@@..........@..............@@@@@@@
..........@..@@@@@@@@@@....@@@........@......@@@@@.@@....@.....................@@@..@@@@@@@
@...@..@.....@@@@@@@@@@@.....@.......@.......@@@@@.@@..............@...........@@@@@@@@@@@@
.............@@@@@@@@@@@.............@.......@@@@..@@...........@..@..........@@@@@@@@@@@@@
......@......@@@@@@@@@@@....@....@................@@@@@.......................@@@@@@@@@@@@@
.............@@@@..@@@@.....@@.....@...............@@@@@...................@@.@@@@@@@@@@@@@
.....@...@...@@@@..@........@......@......@........@@@@@@@@@..........@@@.@@@@@@@@@@@@@@@@@
.............@@@..........@........@@...........@@@@@@@@@@@@@@@.........@@@@@@@@@@@@@@@@@@@
.............@@@.............@....@@@@..........@@@@@@@@@@@@@@@..........@@@@@@@@@@@@@@@@@@
........@@....@@@..@....@..................@@@@@@@@@@@@@@@@@@@@@..........@@@@@@@@@@@@@@@@@
....@....@...........@.@@.................@@@@@@@@@@@@@@@@@...@@@@@....@@.@@@@@@@@@@@@@@@@@
@@@.@@....................................@@@@@@@@@@@@@@@.....@..@.....@@..@@@@@@@@@@@@@@@@
@@@@@.............................@..@@@@@@@@@@@@@@@@@@@@.....@............@@@@@@@@@@@@@@@@
@@@@..............................@..@@@@@@@@@@@@@@@@@@....................@@@@@@@@@@@@@@@@
@@@@@@@...@...................@..@@...@@@@@@@@@@@@@@@@@.................@@@@@@@@@@@@@@@@@@@
@@@@@@........................@@@@@@@@@@@@@@@@@@@@@@@@@.......@@.........@@@@@@@@@@@@@@@@@@
@@@@@@............@......@.....@@@@@@@@@@@@@@@@@@@@@@@@@....@@@@@........@@@@@@@@@@@@@@@@@@
@@@@@..........................@@@@@@@.@.@@@@@@@@@@@@@@@@...@@...........@.@@@@@@@@@@@@@@@@
@@@@@...@....@@@....@@..........@...@@...@@@@@@@@@@@@@@@@@..@..............@@@..@@@@@@@@@@@
@@@@@@..@.......................@.......@@@@@@@.@@@@@@@@@@..@.....................@@@@@@@@@
@@@..................@.....@....................@@@@@@@@@@.......................@@@@@@@@@@
@@@@.....................@@.......@.............@@@@@@@@@@@.....@................@@@@@@@@@@
@@@......................@@@....@@..............@@@@@@@@@@@@...@@...............@@@@@@@@@@@
@@..........@...................@@..@@@.....@...@@@@@@@@@@@@@@.@@.@.............@@@@@@@@@@@
@@@.........@@@@.@@.........@@......@@@@@@.....@@..@@@@@@@@@@@.@@.@.........@@@.@@@@@@@@@@@
.@@....@...@@@@@.@@@...........@@...@@@@@@@@.......@@@@@@@@@@@@@@.@@.@@..@......@@@@@@@@@@@
...........@@@@@@@@@...........@.....@@@@@@@....@@.@@@@@@@@@@@@@@@@@.......@@...@@@@@@@@@@@
.......@...@@@@@@@@@.@@...............@@@@@@@@@@@@@@@@@@@@@@@@@@@@.....@@@@@@@@@@@@@@@@@@@@
...........@@@@@@@@@@@.................@@@@@@@@@@@@@@@@@@@@@@@@@@@@@@@@@@@@@@@@@@@@@@@@@@@@
..............@@@@@@...................@@@@@@@@@@@@@@@@@@@@@@@@@@@@@@@@@@@@@@@@@@@@@@@@@@@@
...............@@@@...................@@@@@@@@@@@@@@@@@@@@@@@@@@@@@@@@@@@@@@@@@@@@@@@@@@@@@
........@.......@@....................@@@@@@@@@@@@@@@@@@@@@@@@@@@@@@@@@@@@@@@@@@@@@@@@@@@@@
.@.....@@.............................@@@@@@@@@@@@@@@@@@@@@@@@@@@@@@@@@@@@@@@@@@@@@@@@@@@@@
.......@@.............@@........@@.....@@@@@@@@@@@@@@@@@@@@@@@@@@@@@@@@@@@@@@@@@@@@@@@@@@@@
@.@....................@....@@..@@.....@@@@@@@@@@@@@@@@@@@@@@@@@@@@@@@@@@@@@@@@@@@@@@@@@@@@
@...............@@...................@.@@@@@@@@@@@@@@@@@@@@@@@@@@@@@@@@@@@@@@@@@@@@@@@@@@@@
@....................................@@@@@@@@@@@@@@@@@@@@@@@@@@@@@@@@@@@@@@@@@@@@@@@@@@@@@@
@@..............@..@..................@@@@@@@@@@@@@@@@@@@@@@@@@@@@@@@@@@@@@@@@@@@@@@@@@@@@@
@..........@@@@................@......@@@@@@@@@@@@@@@@@@@@@@@@@@@@@@@@@@@@@@@@@@@@@@@@@@@@@
..@...@@..@@@@@..............@@@@..@@@@@@@@@@@@@@@@@@@@@@@@@@@@@@@@@@@@@@@@@@@@@@@@@@@@@@@@
@.@..@@@.@@@@@...............@@@@@@@@@@@@@@@@@@@@@@@@@@@@@@@@@@@@@@@@@@@@@@@@@@@@@@@@@@@@@@
...........@................@@@@@@@@@@@@@@@@@@@@@@@@@@@@@@@@@@@@@@@@@@@@@@@@@@@@@@@@@@@@@@@
.....@......................@@@@@@@@@@@@@@@@@@@@@@@@@@@@@@@@@@@@@@@@@@@@@@@@@@@@@@@@@@@@@@@
@......@..................@.@.@@@@@@@@@@@@@@@@@@@@@@@@@@@@@@@@@@@@@@@@@@@@@@@@@@@@@@@@@@@@@
@...............................@@@@@@@@@@@@@@@@@@@@@@@@@@@@@@@@@@@@@@@@@@@@@@@@@@@@@@@@@@@
@.......@@@....................@@..@@@@@@@@@@@@@@@@@@@@@@@@@@@@@@@@@@@@@@@@@@@@@@@@@@@@@@@@
@@.......@@.......@@...@.......@...@@@@@@@@@@@@@@@@@@@@@@@@@@@@@@@@@@@@@@@@@@@@@@@@@@@@@@@@
@@@.............@@@....@.......@.....@@@@@@@@@@@@@@@@@@@@@@@@@@@@@@@@@@@@@@@@@@@@@@@@@@@@@@
@@@@.......@@...@@@....@.............@@@@@@@@@@@@@@@@@@@@@@@@@@@@@@@@@@@@@@@@@@@@@@@@@@@@@@
@@...@@@.@.@@@@.@@@@@...............@@@@@@@@@@@@@@@@@@@@@@@@@@@@@@@@@@@@@@@@@@@@@@@@@@@@@@@
@@@@@@@@@@@@@@@@@@@@..............@@@@@@@@@@@@@@@@@@@@@@@@@@@@@@@@@@@@@@@@@@@@@@@@@@@@@@@@@
@@@@@@@@@@@@@@@@@@@@@@@.....@.....@@@@@@@@@@@@@@@@@@@@@@@@@@@@@@@@@@@@@@@@@@@@@@@@@@@@@@@@@
@@@@@@@@@@@@@@@@@@@@@@@...........@@@@@@@@@@@@@@@@@@@@@@@@@@@@@@@@@@@@@@@@@@@@@@@@@@@@@@@@@
@@@@@@@@@@@@@@@@@@@@@@.............@@@@@@@@@@@@@@@@@@@@@@@@@@@@@@@@@@@@@@@@@@@@@@@@@@@@@@@@
@@@@@@@@@@@@@@@@@@@.....@..@@@@.@@@@@@@@@@@@@@@@@@@@@@@@@@@@@@@@@@@@@@@@@@@@@@@@@@@@@@@@@@@
8
7 19 0
8 31 0
88 19 0
66 51 0
56 49 0
2 67 0
60 15 0
69 42 0

70 53 0
14 31 0
84 15 0
31 48 0
12 38 0
29 39 0
2 62 0
18 80 0
