width 91
height 91
@@@@@@@@@.......@@......@@@@........@@@...@@@@@@@...@@@@..@@@@@@@@....@@@@@@@@@@@@@@@@@@@@@
@@@@@@@@@@......@........@@@.........@@@@....@@.@.@@@@@@..@@@@@@@@.......@@@@@@@@@@@@@@@@@@
@@@@@@@@@................@@@.........@@@@....@@.......@....@..@..........@@@@@@@@@@@@@@@@@@
@@@@@@@@@@........@.......@@.......@.@@@@....@..................@............@@@@@@@@@@@@@@
@@@@@@@@@@@....@@.@@@@@............@...@@...@@.......................@........@@.@@@@@@@@@@
@@@@@@@@@@@....@@.@@@...................@.@..@......................@@@........@.@@@@@@@@@@
@@@@@@@@@@@....@@@...@.@@...........@....@@@.....@...................@@...........@@@@@@@@@
@@@@@@@@@@@@..............@@.............@@@.....@@@.....@@@.........@..............@@@@@@@
@@@@@@@@@@@@..............@@......@......@...............@@@...@........@......@@@@..@@@@@@
@@@@@@@@@@@@......@@.......@.........@...@....@@.....@@@.@@...@@@..@..........@@@@@@@@@@@@@
@@@@@@@@@@@@@....@@@...................................@.....@@@.....@..@.......@@@@@@@@@@@
@@@@@@@@@@@@@.......@.....................@..........@@@.....@@@.....@..........@.@@@@@@@@@
@@@@@@@@@@@@@@....................................@.@@@@...@.......@@@@@...........@@@@@@@@
@@@@.@@@@@..@@.................@@..@..........@...@@@@@@@@......@..@@@@@@@@........@@@@@@@@
@@@@..@@@..............@@....@@@..............@@@@@@@@@@@..................@...@@@@@@@@@@@@
@@@.....@................@@..@@@.......@.@...@@@@@@@@@@@@.............@.@..@..@@@@@@@@@@@@@
@@@.......@@@.......@..@......@@@@.....@.@...@@@@@@@@@@....@..........@.......@@@@@@@@@@@@@
@..........................@.@@@@@@@..........@@@@@@@@@@@@@@.................@@@@@@@@@@@@@@
.........................@@@@@@@@@@@..........@@@@@@@@@@@@@@..@@...............@@@@@@@@@@@@
................@.........@@@@@@@@@@.@.......@@@...@@@@@@@@@@..........@@......@@@@@@@@@@@@
....@......................@@@@@@.............@.@....@@@@@@.....@.....@@@@@....@@..@@@@@@@@
............@...............@@@@@...........................@..@......@@@@...@.@@..@@@@@@@@
....@.....@..........@......@@@@@@@@........................@..........@@.........@@@@@@@@@
..........@@........@@@....@@@@@@@@@....@........................@.....@@.........@@@@@@@@@
.....@..............@@....@@@@@@@@@@@...............@..................@@............@@@@@@
..........................@..@@@@@@@......@@@.....@.@...............@..@@............@@@@@@
.............@...............@@@@@@@@.@@@.@@@..................@.....................@@@@@@
......@....................@@@@@@@@@@@@@@@@@@.................@@.......................@@@@
...@..........................@@@@@@@@@@..@....@..............@@@....@.................@@@@
..............................@@@@@@@........................@@@@.@..@@......@.....@...@@@@
...........@....@@@@@.........@@@@@@@@.......@..........@...@@@@......@@.....@@..........@@
................@.............@@@@@@@@......@@..@.@.@....@...@@@.............@..@........@@
..................@@..........@@@@@@@@..............@........................@...........@@
..@@............................@@@.........................................@@@@@.......@@@
@@@@@.....@..@@@........................@@........@..@.....@........@........@@@@.......@@@
@@@@@........@@@...............@...........................@@@.....@..@.......@@@......@@@@
@@@.@........@@@.....@................................@....@.........@@......@@@@.....@@@@@
@............@@@@@..............@.......@.......................@@@@@.........@@@.....@@@@@
..........@...@@@..............@@@............@@@@@@@@.@........@@@@@@@.@.....@@@.....@@@@@
........@@......@@@............@@@@@........@..@@@@@@@@.....@@...@@@@@@..@@@@.@@.....@@@@@@
.........@.....@@@................@@......@.@.@@@@@...@......@.....@@@...@@@...@.....@@@@@@
...............@@@............................@@@@.........@...@@...@@..@@@@........@@@@@@@
................@@...@........@@...............@...@.....@....@@..@......@@@....@..@@@@@@@@
.................@..........@@@@..............................@@.........@..........@@@@@@.
...............@@...........@@@..........@............@@@......@......................@@@..
........@.................................@@@@........@@@@..@.........@.........@..........
.....@..@....@....@@.......@...........@@.@@@@......@@@@@@..@......................@...@@@.
@.......@@...@...@@@@@............@@...@......@@@....@@@@@...........@.................@@@.
@........@@@......@@@@............@@...@...........@@@@@.........@...@.................@@@@
@............@..@@@@@.............@...........@..@.@.@@................................@@@@
@.............@@@@@@@............................@...@@......@.........................@@@@
..............@@@@@.........@..............@...............@...........................@@@@
.......@@.....@@@@@.........@@@.......@@@..@..@.......................................@@@@@
........@......@@@..........@@@.......@@@@@@...........@@.......@..........@.@@@.....@@@@@@
..............@@@@....@@.....@@@@..@.@@@@@@@@......@@@.@...@@..............@@@@@..@@@@@@@@@
.........@...@@@@@@@..@.......@......@.....@@..................@...........@@@...@..@@@@@@@
..@.....@......@.@............@@...@.......@@@@@..@@.........@....@@.........@......@@@@@@@
...@..................................@@@@@@@@@@.....@@@..........@@@........@.@....@@@@@@@
.@.......@.......@.........@..........@@@@@@@@@@.....@@..............................@@@@@@
.......................@...@..........@@@@@@@@@.....@...............................@@@@@@@
@......@...........@.......@..........@@@@@@@@......................................@@@@@@@
@..........................@...........@@@@@@....@..........@.......................@@@@@@@
@..................@@@...............@..@@@@@@@@@@@.@@..@...@..@@@..............@..@@@@@@@@
@..............@...@@@...................@@@@@@@@@@@@@@@@@..@@@@@@@@@....@......@..@@@@@@@@
...............@.@@@@@...@@@@.................@@@@@@@@@@@@.@@@@@@.@@@..............@@@@@@@@
.............@...@@@@@...@@@...@@@............@@@@@@@@@......@@@@..@..............@@@@@@@@@
.................@@@@.....@@.....@@....@@......@@@@@@@@........@@...............@@@@@@@@@@@
.......@@....@....@@@..@..@.......@............@@@@@.........@@@@@@.............@@@@@@@@@@@
...................@@.....@@................@......@....@@...@@@@.....@........@@@@@@@@@@@@
....@..............@......................@@@..@.............@@@@@............@@@@@@@@@@@@@
..@.........@@@@..........................@@.....@.........@@@@@@@.@.........@@@@@@@@@@@@@@
............@@@@.......................@@...@@@@@@..@..@...@@@@..............@@@@@@@@@@@@@@
............@@@@.....@.................@@@.@@@@@@@.........@@@...............@@@@@@@@@@@@@@
.....@@@@...@@@@.......@@...@............@@@@@@@@@........@.@@................@@@@@@@@@@@@@
.....@@@@..@@@@@@@@@......@@@@..........@@@...@@@@..........@@...............@@@@@@@@@@@@@@
.......@@....@@@@@@@......@@.........@@@@@@.....@....@@@@@...@................@@@@@@@@@@@@@
...@....@...@@@@@@@@...............@@@@@@@@.....@@@.............@.............@@@@@@@@@@@@@
@..........@@@@@@@@@........@@.....@@@@@@@@.......@@..........................@@@@@..@@@@@@
@....@@.@..@@@@@@@@@........@@@....@@@@@@@..@.....@@..........................@..@...@@@@@@
@@@.@@@@@@@@@@@@@@@@........@@@....@@@@@@@.@@@...........................@@.@........@@@@@@
@@@@@@@@@@@@@@@@@@@@...............@@@@@@@@@@@@...........@.............@....@....@@..@@@@@
@@@@@@@@@@@@@@@@@@@@.....@@......@@@@@@@@@@@@@@......@...@@.............@.@.............@@@
@@@@@@@@@@@@@@@@@@@@.@...@@...@@@@@@@@@@@@@@@@@@@..@....@@@@....@........@@......@......@@@
@@@@@@@@@@@@@@@@@@@@@@@..@@...@@@@@@@@@@@@@@@@@@@@@@@...@@@@......@..@@@..@.............@@@
@@@@@@@@@@@@@@@@@@@@@@@@@@@@@@@@@@@@@@@@@@@@@@@@@@@@@...@@...............@.........@....@@@
@@@@@@@@@@@@@@@@@@@@@@@@@@@@@@@@@@@@@@@@@@@@@@@@@@@@@.@......@...........@..........@......
@@@@@@@@@@@@@@@@@@@@@@@@@@@@@@@@@@@@@@@@@@@@@@@@@@@@@@@......@...........@.......@@........
@@@@@@@@@@@@@@@@@@@@@@@@@@@@@@@@@@@@@@@@@@@@@@@@@@@@@@@......@@@@.@..............@@.@......
@@@@@@@@@@@@@@@@@@@@@@@@@@@@@@@@@@@@@@@@@@@@@@@@@@@@@@....@@@@@@@@@......@..@@.@...........
@@@@@@@@@@@@@@@@@@@@@@@@@@@@@@@@@@@@@@@@@@@@@@@@@@.......@@@@@@@@@@.@@....................@
@@@@@@@@@@@@@@@@@@@@@@@@@@@@@@@@@@@@@@@@@@@@@@@@@@....@..@@@@@@@@@@.@@@....@@@.........@.@@
8
17 60 0
67 23 0
58 11 0
46 77 0
73 4 0
22 61 0
72 58 0
55 3 0

77 77 0
8 70 0
58 11 0
27 6 0
73 19 0
31 41 0
67 22 0
55 2 0
