width 91
height 91
@@@@@@@@@@@@@@@@@@@@@@@............@.@@@@.@@@@.@@@@@@@@@@@@@@@@@@@@@@@@@@.......@@@@.....@@
@@@@@@@@@@@@@@@@@@@@@@@...............@@..@....@@@@@@@@@@@@@@@@@@@@@@@@@........@@@.......@
@@@@@@@@@@@@@@@@@@@@@@.@.@............@@......@@@@@@@@@@@@@@@@@@@@@@@@@@@....@@@@.........@
@@@@@@@@@@@@@@@@@@@@@@...@@..@@..............@@@@@@@@@@@@@@@@@@@@@@@@@..........@..........
@@@@@@@@@@@@@@@@@@@@@@@..@@...@...........@@@@@@@@@@@@@@@@@@@@@@@@@@@@@.........@@...@@....
@@@@@@@@@@@@@@@@@@@@.......@..@...........@@@@@@@@@@@@@@@@@@@@@@@@..@@@..@...........@@@...
@@@@@@@@@@@@@@@@@@@@@..@......@.....@.....@@@@@@@@@@@@@@..@@@@@.....@....@..............@..
@@@@@@@@@@@@@@@@@@@@@@@@......@....@@..@...@@@@@@@@@@@@.....@...@.@.@................@@.@..
@@@@@@@@@@@@@@@@@@@@@@@@@@........@@@..@@..@@@@@@@@@....@......................@@@.........
@@@@@@.@..@@@@@@@@@@@@@@...........@@.@@@@.@@@....@...................@....@...@@..........
@@@@@@.....@@@@@@@@@@@@@.........@.@@@@@@@@@@..@..@............................@@..........
@@@@@@@@......@@@@@@@@@........@.@@@@@@@@@@@@...............@.......@.........@............
@@@@@@@@..........@@@@@@........@@@@@@@@@@@@@....@.................@.......................
@@@@@@@@............@@@@.@......@@@@@@@@@@@@@.......................@.................@@...
@@@@@@..............@@@@.@...@@@@@.@@@@@@@@@@................@......@@......@.....@...@@@@@
@@@@@@.....................@@@@@...@.@@@@@@@@@........@......@.......@..@@@@@@........@@@@@
@@@@@@@..@.................@@@@@........@@@@@@@......@@..............@@@@@@@@@..@@...@@@@@@
@@@@@@@..................................@@@@@@@......@..............@@@@@@@@@@@@@@@.@@@@@@
@@@@@@@@...............@...........@....@@@.@@@@..@..................@@@@@@@@@@@@@@@@@@@@@@
@@@@@@@.....@....@.@....................@@.....@@.@........@@.........@@@@@@@@@@@@@@@@@@@@@
@@@@@@@.....@@@.........@..@...........@@......@@.@.........@@........@@@@@@@@@@@@@@@@@@@@@
@@@@@@.......@@......................@@@........@.@.........@@..........@@@@@@@@@@@@@@@@@@@
@@@@@@@.................@@............@@...........................@....@@@@@@@@@@@@@@@@@@@
@@@@@@@..........@............@.......@............@......@.....@@.....@@@@@@@@@@@@@@@@@@@@
@@@@@@@@.........................@.................@......@.............@@@@@@@@@@@@@@@@@@@
@@@@@@@..@.............@@@@......@.................@@@..........@......@@@@@@@@@@@@@@@@@@@@
@@@@@@@..@.....@..............@@.@@.@..@@...........@@@................@@@@@@@@@@@@@@@@@@@@
@@@@@@..............@............@@@@@@@@.............@.....@..........@@@@@@@@@@@@@@@@@@@@
@@@@@@......@.....@@@@...........@@@@@@@.......@..............@...@@...@@@..@@@..@@@@@@@@@@
@@@@@@............@@@@...........@@@@@@........@@@....................@@@@.......@@@@@@@@@@
@@@@@@.............@@@@....@.....@@@@@@@.....@@@.............@@........@@@@.....@@@@@@@@@@@
@@@@@......@.......@@......@.....@@@@@@.......@@..............@.......@@@........@....@@@@@
@@@@@......@@@......@..........@@@@@@@@@.....@@@......................@@@......@......@@@@@
@@@@@...........@@@@@@........@@....@@@@@@@@.@@.....................@@@@@........@....@@@@@
@@@@@...@......@@@@@@@@.............@@@@@@@@.@@@@..@...........@................@...@@@@@@@
@@@@@.@@.....@.@@@@@..@.........@..@@@@@@@@@@@@@@...@....@...@@@@............@@.....@@@@@@@
@@@@@@@@@......@@@@@.................@@@@@@@@@@@@..@.....@...@@@@@@....@..............@@@@@
@@@@@@@@@...@@@@@@@@.........@.......@@@@@@@@@@@@@@@............@@@................@...@@@@
@@@@@@@@.....@@@@@@@......@...@.......@@@@@@@@@@@@@@..@.@@@.@...@@@..@@@..............@@@@@
@@@@@@@.......@@@@........@...............@@@@@@@@@@........@..@@@@...@@..........@@...@.@@
@@@@@@@@@@.....@@@@.........@.@............@@@@@@@@..........@@@...................@...@..@
@@@@@@@@@@@....@@@...................@.@@..@@@@@@@........@...........................@@..@
@@@@@@@........@@@............@............@@@@@@@.......@......................@@@..@....@
@@@@..........@@@..........................@@............@........@..........@............@
@.............@@@........@@......@..........@............@@....@.....@@.................@@@
@.............@@@@..@..@..............................@.....@......@..@...........@.....@@@
@.......@@@....@@@@@@........@......@@....@@@.........@...............@..................@@
@.......@@@@@...@@@@@...............@@@...@@..@..............@.......@@...@@.@...........@@
@.........@@@....@@@@..............@@@.....@..........................@...@@@@@............
@..@.......@@....@@@................@@@...............@........@....@@@....@@@@.......@....
................@@@@.@@@...........@@@@...............@@@............@@....@@@@......@@@@@.
................@@...@@......@......@@..............@..@@.................@@@@@.......@@@@@
...@........................@@@..@..............@@..@......@..........@...@@@@@....@..@@@@@
.....................@......@@@@.@@........@...@.@.@@.@...............@..@@@@@.....@....@@@
@.@.......................@@@@@@.@.@.@@..@.......@@@@.@...............@@@@@.@@...........@@
@......@....................@@@@@@...@@.............@.@...............@@@@@..............@@
@.......@...........@...@@@@@@@@@....@..@.......@......@@............@@@@@@@@.......@.@@@@@
@.............@@.@......@@@@@@..@....@.@@...@.............@.........@@@@@@@@@@..@@@@@@@@@@@
@............@@...........@@@..........@...@.........@@............@@@@@@@@@@@@.@@@@@@@@@@@
@.@...........@...........@@@..........@@@..........@@@@@@@.......@@@@@@@@@@@@@@@@@@@@@@@@@
......................@..@@@@@...@@....@@..@....@@@@@@@@@@.......@@@@@@@@@@@@@@@@@@@@@@@@@@
...................@..@@@@@@@@@...@@..@@@....@.@@@@@@@@@@@@......@@@@@@@@@@@@@@@@@@@@@@@@@@
......................@@@@@@@@@..@@....@@@...@@@@@@@@.@@@@@......@@@@@@@@@@@@@@@@@@@@@@@@@@
......@@.............@@@@@@@@@@@..@....@@@@@.@@@@@@@..@@@@@......@@@@@@@@@@@@@@@@@@@@@@@@@@
@...........@..@....@@@@@@@@@@@@@.......@@....@@@@@.....@@......@@@@@@@@@@@@@@@@@@@@@@@@@@@
@...........@@..@.@@@@@@@@@@@@@@@.......@@....@.........@.......@@@@@@@@@@@@@@@@@@@@@@@@@@@
....@@..........@@@@@@@@@@@@@@@@@@@@....@@....@............@@@@@@@@@@@@@@@@@@@@@@@@@@@@@@@@
.@@@@@........@@@@@@@@@@@@@@@@@@@@@@.............@...@@@.@@@@@@@@@@@@@@@@@@@@@@@@@@@@@@@@@@
@@@@@......@@@@@@@@@@@@@@@@@@@@@@@@..................@@@.@@@@@@@@@@@@@@@@@@@@@@@@@@@@@@@@@@
@@@@........@@@@@@@@@@@@@@@.@@@@@@@@..................@@@@@@@@@@@@@@@@@@@@@@@@@@@@@@@@@@@@@
@@@.........@@@@@@@@@@@@@@....@....@.....@@@@..@@@....@@@@@@@@@@@@@@@@@@@@@@@@@@@@@@@@@@@@@
@@@..........@@@@@@@@@@@@@...@....@@...@...............@@@@@@@@@@@@@@@@@@@@@@@@@@@@@@@@@@@@
@@@@@@......@.@@@@@@@@@@@@.............@...............@@@@@@@@@@@@@@@@@@@@@@@@@@@@@@@@@@@@
@@@@@@.............@@@@@@@..@..................@.......@@@@@@@@@@@@@@@@@@@@@@@@@@@@@@@@@@@@
@@@@@@................@@@..........@..........@@@@@@..@@@@@@@@@@@@@@@@@@@@@@@@@@@@@@@@@@@@@
@@.....................@......................@@@@@@@@@@@@@@@@@@@@@@@@@@@@@@@@@@@@@@@@@@@@@
..................@@.....@...@@............@@@@@@@@@@@@@@@@@@@@@@@@@@@@@@@@@@@@@@@@@@@@@@@@
......@.....@.@@@@.......@.@..@...........@...@@@@@@@@@@@@@@@@@@@@@@@@@@@@@@@@@@@@@@@@@@@@@
@........................@.@@@..............@..@@@@@@@@@@@@@@@@@@@@@@@@@@@@@@@@@@@@@@@@@@@@
@@@@@..................@@@@@@@.......@......@@.@@@@@@@@@@@@@@@@@@@@@@@@@@@@@@@@@@@@@@@@@@@@
@@@@@........@@@......@@@@@@@@@....@@......@@@@@@@@@@@@@@@@@@@@@@@@@@@@@@@@@@@@@@@@@@@@@@@@
@@@@@................@@@@@@@@@...........@@@@@@@@@@@@@@@@@@@@@@@@@@@@@@@@@@@@@@@@@@@@@@@@@@
@@@@..@..............@@@.....@.......@..@@@@@@@@@@@@@@@@@@@@@@@@@@@@@@@@@@@@@@@@@@@@@@@@@@@
@@@.......@@@..............@.@@@.@.....@@@@@@@@@@@@@@@@@@@@@@@@@@@@@@@@@@@@@@@@@@@@@@@@@@@@
@@@............@...............@.@.@@..@@@@@@@@@@@@@@@@@@@@@@@@@@@@@@@@@@@@@@@@@@@@@@@@@@@@
@@...@.............................@@.@@@@@@@@@@@@@@@@@@@@@@@@@@@@@@@@@@@@@@@@@@@@@@@@@@@@@
@@..........@.........@...........@@@@@@@@@@@@@@@@@@@@@@@@@@@@@@@@@@@@@@@@@@@@@@@@@@@@@@@@@
@@@@............@@@...........@@..@@@@@@@@@@@@@@@@@@@@@@@@@@@@@@@@@@@@@@@@@@@@@@@@@@@@@@@@@
@@......@@@@@@..@@@@..........@@@@@@@@@@@@@@@@@@@@@@@@@@@@@@@@@@@@@@@@@@@@@@@@@@@@@@@@@@@@@
@@......@@@@@@@@@....@@@.......@@@@@@@@@@@@@@@@@@@@@@@@@@@@@@@@@@@@@@@@@@@@@@@@@@@@@@@@@@@@
@@@..@@@@@@@@@@@@@..@@@.......@@@@@@@@@@@@@@@@@@@@@@@@@@@@@@@@@@@@@@@@@@@@@@@@@@@@@@@@@@@@@
8
23 83 0
37 69 0
49 16 0
14 35 0
75 10 0
10 65 0
66 18 0
12 57 0

51 68 0
89 11 0
7 84 0
73 11 0
63 21 0
9 71 0
9 49 0
28 14 0
