width 91
height 91
@...........@@@@.........@@.......@@...............@@@@@@@@@@@@@@@@....@@@.......@@@@@@@@@@
.......@...@@@....................@................@@@@@@@@@@@@@@@@....@@.......@@@@@@@@..@
...@@..@...@@@...@@@..............................@@@@@@@@@@@@@@@@@.@.........@.@@@..@@...@
...@........@@@@@@.@............@@........@@.........@@@@@@@@@@@@@@...............@..@@...@
.@@..........@.....@@@.....@.....@.................@.@@@@@@@@@@@@@........@@.........@..@@@
.............@......@................@@..............@@@@@@@@@@@@@...........@...........@@
.....................................@@.....@........@@@@@@@@@@@@@............@@..........@
....................................@@@.....@..........@@@@@@@@@@...........@@@@@.....@...@
..........................@@@.......@.@...............@@@@@@@@@@@........@..@@@@..........@
...@....@.................@@@@.....@..@..@..@...@.....@@@@@@@@@@@.@.@.....@@@@.@.......@.@@
..................@.@.....@@@@.................@......@@@@@@@@......@@....................@
....@.........@@@@@.......@@@@..@.....................@@@@@@................@............@@
..........@...@@@@@...@@..@@@@@@@.....................@@@@@......@@.....................@@@
..@....@@.@...@@@@@....@...@@@@@@.....................@@@@@@..@@.@.....@...............@@@@
..@......@....@@@@@..@@@@..@@@....@...@......@.@.........@@...@@....@...................@@@
@@@@.........@@@@...@@.@@.............@@....@@.......@...@@..@@@....@............@@...@@.@@
@@...........@@@@@@....@@.....@.......@@@...@.....@.....@@..@@@@....@.........@..@....@@..@
@..@..@......@@@@@@....@@..............@@@..@.......................@.@.@@...@@............
............@@@@@@@@@.......@.@........@@.....@@@@........@.........@..@@@@...@@....@@....@
...@@.......@@@@@@@@@..............@.........@@@@@@.......@@.....@......@@@@..@@.........@@
@..@@..@@..@@@@@@@@@@..............@.........@@@@.@.......@@...............@......@....@@@@
...@.......@@@@@@@@@@....@...@....@....@@@....@@..........@@......@......@...........@@@@@@
.......@..@@@@...........@@........@...........@@.........@@@@..@@@@.....@.............@@@@
@@.....@@...@@..@........@@@@............@.....@@..@@....@@@......@....................@@@@
@@.....@@@..@@@...@.........@............@.............@@@@@................@@@......@@@@@@
@.....@@....@@@...@...................................@@@......@............@@....@..@@@@@@
@...........@@@@................................@@....@.@......@............@.........@@@@@
............@@@.....@.........................@@@@.......@.....................@......@@@@@
..............................................@@@.@......@...@.....................@@@@....
..................@@@@..........................@.................@......@@...@...@@@@.....
@@................@@@@@.......@@....@..........@@......@...............@@@@@@.@...@@@@.....
@@..........@...@@@@@@@..........@..........@..@@.@...................@@@@@@@.....@@@......
.....@.............@@@..@...@@...@.............@@@@...................@@@@@@@...@..........
...................@@@..@.@.@@..@@.............@@@@.....................@@@@@@.............
......@@...........@@.....@@@...@@............@@@@@@.....@......@....@@.@@@@@@....@....@.@.
......@@..@....................@@@@@...@@@@@.....@@..............@@@..@@@@@@@@@...........@
..............@.............@@.@@@@@..@@@@@@......@@...@..........@@.@@@@@@@@@@...........@
.@@@....@......@@..........@@...@@@@...@@@@@.@....@@@.......@......@.@@@@@@@............@@@
..@@@@....@..........@......@....@@....@@@@@......@@@@......@........@@@@@@.............@@@
@@@@.@@.........................@@@.@@...@@@....@@@@@@...........@...@@@@@.....@......@....
@@...@@.........@...@...........@.........@........@@@...............@@@@@.@...............
@@....@@............@@@@...@@...............@@.....@@@@...@@@........@@@@@@..........@.....
@@.................@@@@@@...@.....................@@@@@.....@@@.....@@@@@@@..............@@
@@.................@@.............................@@@@@......@@....@@@@@@@@................
@.............................@...................@@@@@..............@@@@@@@...............
@........@....................@...........@........@@@...............@@@@@@@...@@@@@@...@..
@......@@@@................@..@.....@.....@@......@@@@...@@..........@@@@@@@@@@@@@@........
@....@..@@@..............................@@..........@.@@.......@..@@@@@@@@@@@@@@..........
@..@....@@..........@@...............@.....@@...@......@@.......@@@@@@@@@@@@@@............@
@.......@@.....@@....................@.....@@..........@@.......@@@@@@@@@@@@@@@..@.......@@
@@.......@..............@.......................................@@@@@@@@@@@@@@@@@@.......@@
@@...@@..........................@@...........................@...@@@@@@@@@@@@@@@@...@..@@@
@@@@...........@...@..............@..........@.........@@@@@@@@...@@@@@@@@@@@@@@@@@@@@@@@@@
@@@@...............@.@.....@........@..................@..@@@@@....@@@@@@@@@@@@@@@@@@@@@@@@
@@@..............@@@......@...............................@@@@@..@.@@@@@@@@@@@@@@@@@@@@@@@@
@@@.........@..............................................@@@@@....@@@@@@@@@@@@@@@@@@@@@@@
@@........@@@...................................@@@....@..@@@@@@....@@@@@@@@@@@@@@@@@@@@@@@
@..........@.....@@.........@..........@..@@......@..@@@...@@@......@@@@@@@@@@@@@@@@@@@@@@@
................@@@.@.....@@@@...........@.@.........@@@@..@@@......@@@@@@@@@@@@@@@@@@@@@@@
@..@@................@....@@..........@@@...........@@@@@.........@@@@@@@@@@@@@@@@@@@@@@@@@
@@@@@.....................@......@....@@.............@@@@..@@...@@@@@@@@@@@@@@@@@@@@@@@@@@@
@@.....@@.@@......@@......@@.....@.......@@@...........@...@....@@@@@@@...@@@@@@@@@@@@@@@@@
@@@....@.....@......@.....@..............@@@@@..........@......@@@@@@......@@@@@@@@@@@@@@@@
@@@@................@.....@........................@..........@@@........@.@@@@@@@@@@@@@@@@
@@@@@...............@.....@@..................................@@@@...@.....@@@@@@@@@@@@@@@@
@@@@@........@........................@........................@@@.........@@@@@@@@@@@@@@@@
@@@@@@@....@@@@@.@@@@@..........................................@.........@@@@@@@@@@@@@@@@@
@@@@@@@.@@@@@@@@@@@@@@..@....@.@......................@....................@@@@@@@@@@@@@@@@
@@@@@@@@@@@@@@@@@@@@@@....................@..@.@.........................@..@@@@@@@@@@@@@@@
@@@@@@@@@@@@@@@@@@@@@@@.................@.@....@............@..............@@@@@@@@@@@@@@@@
@@@@@@@@@@@@@@@@@@@@@...@................@...............@......@......@..@@.@@@@@@@@@@@@@@
@@@@@@@@@@@@@@@@@@@@@....@........@@......@.....................@.........@@.@@@@@@@@@@@@@@
@@@@@@@@@@@@@@@@@@@@@....@@@@@..@.@...........@......@..@.@@@.@............@.@@@@@@@@@@@@@@
@@@@@@@@@@@@@@@@@@@@@......@@@@@@@@...........@.....@.....@@.......@...@.....@@@@@@@@@@@@@@
@@@@@@@@@@@@@@@@@@@........@..@......@@..........@....@@...........@......@..@@@@@@@@@@@@@@
@@@@@@@@@@@@@@@@@@@@...............@@@@.@..........................@......@@@@@@@@@@@@@@@@@
@@@@@@@@@@@@@@@@@@@@@..@@..@.......@@@@..@.................@......@@......@@@@@@@@@@@@@@@@@
@@@@@@@@@@@@@@@@@@@@......@@........@@@.@@...@.....@..@@..............@...@@@@@@@@@@@@@@@@@
@@@@@@@@@@@@@@@@@@@@.........@@.......................@.......@.........@.@@@@@@@@@@@@@@@@@
@@@@@@@@@@@@@@@@@@@@@.....@..@@......@..@...........@@@.@.................@@@@@@@@@@@@@@@@@
@@@@@@@@@@@@@@@@@@@@@@....@..@@....@@@@@@......................@..........@@@@@@@@@@@@@@@@@
@@@@@@@@@@@@@@@@@@@@@@@@@....@@@@@@@@@@@@...............................@.@@@@@@@@@@@@@@@@@
@@@@@@@@@@@@@@@@@@@@@@@@@...@@@@@@@@@@@@@.....@......@................@@@..@@@@@@@@@@@@@@@@
@@@@@@@@@@@@@@@@@@@@@@@@@@@@@@@@@@@@@@@@@@@...........................@@@..@@@@@@@@@@@@@@@@
@@@@@@@@@@@@@@@@@@@@@@@@@@@@@@@@@@@@@@@@@@@@@...........................@@@@@@@@@@@@@@@@@@@
@@@@@@@@@@@@@@@@@@@@@@@@@@@@@@@@@@@@@@@@@@@@@.......................@...@@@@@@@@@@@@@@@@@@@
@@@@@@@@@@@@@@@@@@@@@@@@@@@@@@@@@@@@@@@@@@@@@.....................@@@@@@@@@@@@@@@@@@@@@@@@@
@@@@@@@@@@@@@@@@@@@@@@@@@@@@@@@@@@@@@@@@@@@@@@@@@@@@................@@@@@@@@@@@@@@@@@@@@@@@
@@@@@@@@@@@@@@@@@@@@@@@@@@@@@@@@@@@@@@@@@@@@@@@@@@@@@..............@@.@@@@@@@@@@@@@@@@@@@@@
@@@@@@@@@@@@@@@@@@@@@@@@@@@@@@@@@@@@@@@@@@@@@@@@@@........@@@@.........@@@@@@@@@@@@@@@@@@@@
@@@@@@@@@@@@@@@@@@@@@@@@@@@@@@@@@@@@@@@@@@@@@@@@@@@.......@@@@.......@@@@@@@@@@@@@@@@@@@@@@
8
64 21 0
30 22 0
68 1 0
34 78 0
20 2 0
60 50 0
23 22 0
66 18 0

2 61 0
66 54 0
24 10 0
35 68 0
39 9 0
45 67 0
69 71 0
56 74 0
