width 91
height 91
..........@@@@@@@@@@@@@@.....@@@....@@@........@@......@@......@@@@..@@...@..@@@@@@@@@@@@@@
...........@@@@@@@@@@@@.............@@@........@...............@@.@@........@@@@@@@@@@@@@@@
@@@@.......@@@@@@@@@@@@..@......@...@.............@.............@.@@..@@@...@@@@@@@@@@@@@@@
@@@@@.....@@@@@@@@@@@@@..@@@@...@.......@.........@@@@@...@@...........@.@@@@@@@@@@@@@@@@@@
@@@@@.............@@@@.....@@@.......@...........@@.@@@..................@@@@@@@@@@@@@@@@@@
@@@...............@@@@....................@@..@@.....@......................@@@@@@@@@@@@@@@
@@@@...@..........@@@@............@.......@@@.@@.......................@@...@@@@@@@@@@@@@@@
@@@.........@......@.@..............@@....@@@@@@.......................@@...@@@@@@@@@@@@@@@
@@@....................@............@@.@.....@...........@@....@........@..@@@@@@@@@@@@@@@@
@@@@..............@...@@.............@....@..............@.................@@@@@@@@@@@@@@@@
@@@@@.................@@..@......@@..........@.....@@@....................@@@@@@@@@@@@@@@@@
@@@@@.......@.........@@....................@@......@@.....@.............@@@@@@@@@@@@@@@@@@
@@@@@.@....@..........@........................@....................@...@@@@@@@@@@@@@@@@@@@
@@@@@@.........@.....@@...............................@........@@........@@@@@@...@@.@@@@@@
@@@@@@@@.....@.@.....@@@@.............................@...@...............@@@@@.......@@@@@
@@@@@@@@..@...........@@@........@......@@....@@@@@@@........@..............@@@.......@@@@@
@@@@@@@@.....................@@@.@......@@@@@@@@@@@@.....................@............@@@@@
@@@@@@@.............@.....@......@......@@@@@@@@@@@@........@@.@...@..................@@@@@
@@@@@@......@.......................@..@@@@@@@@@@@@....@@.@@@@@@@........................@@
@@@@@@.....@@....................@@..@.@@@@@@@@@@.........@@@@@@@........................@@
@@@@@@@...................@.......@@.@@@@@@@@@@@..........@@@@@@@.@.......................@
@@@@@@......@..........................@@@@@@@@@@.........@@@@@@@.@.......................@
@@@@@@@@@@@@@..........................@@@@@@@@@@...........@@@@@....@.......@.............
@@@@@@@@@@@@@@..................@@.....@@@@@@@@@@@..........@@@@@............@.............
@@@@@@@@@@@@@@@......@.................@@@@.@..@@@..@.@.....@.@@.....................@@@...
@@@@@@@@@@@@@@@..@...@..............@....@@.....@.....@.@............................@@@@@@
@@@@@@@@@@@@@....@............@........................@@..@..............@@.........@@@@@@
@@@@@@@@@@@@....@@..................@@...................@@.......@@.......@...@@..@.@@@@@@
@@@@@@@@@@@..........@..........................................@.@@...@...@...@.....@@@@@@
@@@@@@@@@@@@@...........@.........................................@@..................@@@@@
@@@@@@@@@@@@@.....@...................................................................@@@@@
@@@@@@@@@@@@......@@@@....@.@...@.....@@....................................@......@...@@@@
@@@@@@@@@@@@......@@@@@...@@@........@.........@.........@..................@..........@@@@
@@@@@@@@@@@@......@@@@.....@@@@@..........................................@............@@@@
@@@@@@@@@.@@........@@.....@@@@@....................................@@....@@.....@.@@@@@@@@
@@@@@@@@@.........@.@@.@...@@@@@......@.@@...@.................@@...@@@.@@@@@....@@@@@@@@@@
@@@@@@@@@@@@.....@@.@@.....@@@@@@@...@@......@.................@@@@@@...@@@......@@@@@@@@@@
@@@@@@@@@@.......@@.@@.....@..@@@@.................@....@@@......@@@@...@@@@@......@@@@@@@@
@@@@@@@@@....@.@@@@@@@.........@@@...@...@.....@.........@...............@@@@......@@@@@@@@
@@@@@@@@@@@@@@.@@@@@@@.........@@@@..@@.......@@@.......@@...........@.............@@@@@@@@
@@@@@@@@@@@@@@@@@@@@@......@.................@@@@@@@@@.............................@@@@@@@@
@@@@@@@@@@@@@@.@@@@@@...@..................@@@@@@@@@@@..........@@..@..............@@@@@@@@
@@@@@@@@@@@@@@..@@.....@@@...................@@@@@@@@@@@@.......@@.................@@..@@@@
@@@@@@@@@@@@@@..@@......@@@.......@.........@@@@@@@@@@@@@..@@........@.............@@.....@
@@@@@@@@@@@.............@@@................@@@@@@@@@@@@@@@.@@...@......@...........@@....@@
@@@@@@@@@@@@@@.............................@@@@@@@@@@@@@@@@@@...@.....@................@@@@
@@@@@@@@@@@@@@@@...........@@@....@........@@@@@@@@@@@..@.@@......@............@.........@@
@@@@@@@@@@@@........@.......@@....@.@.....@@@@@@@@@.@......@@@@..........................@@
@@@@@@@@@@@@@..@.........................@@@@....@@.........@@@..........................@@
@@@@@@@@@@@@@......@@..............@@....@@@@...............@@@.......................@....
@@@@@@@@@@@@@.....@@@...............................................@@@....................
@@@@@@@@@@@@@@....@@..@@...........@............@@@................@@@.....................
@@@@@@@@..@@@@.....@@.............@@...........@@@@@....@@.......@@@@@...@...........@.....
@@@@@@@@..@@..@....@@............@...........@.@@@@@@@..@..........@..@...@@....@.@@....@@@
@@@@@@@....@..............@....................@@@@@@.............@.......@@.@..@@@@@..@@@@
@@@@@@@@.........................................@@@@........................@..@@@@@@@@@@@
@@@@@@@@........................@@..............@@@.@.@.........................@@@@@@@@@@@
@@@@@@@@@........................@............@@@..................................@@@@@@@@
@@@@@@@@@@@@@@@..........@...@@@........@@@........................................@@@@@@@@
@@@@@@@@@@@@@@...@...........@....@@@.....@.......@.........@......................@@@@@@@@
@@@@@@@@@@@@@@@................@...@@@@@@.@@@...................................@..@@@@@@@@
@@@@@@@@@@@@@@@..........@....@@....@..@@.@@@......@@........@.@@......@@......@@@@@@@@@@@@
@@@@@@@@@@@@@@@..........@.............@...........@@.......@@...@.........@@..@@@@@@@@@@@@
@@@@@@@@@@@@@@@...@....................@...........@@......................@@...@@@@@@@@@@@
@@@@@@@@@@@@@@@............................@@@.....@@@......@..............@@..@@@@@@@@@@@@
@@@@@@@@@@@@@@@...@............@............@@......@@@@@...@..................@@@@@@@@@@@@
@@@@@@@@@@@@@.@....@.....@.............@.....@.....@@@@@@@@@@...@@...............@@@@@@@@@.
@@@@@@@@@@@@@.@........@......@@...................@@@@@@@@@@.........@.........@@@@@@@@...
@@@@@@@@@@@@........@@........@@@.......@...@@.......@@@@@@@@....................@@@@@@@...
@@@@@@@@@..@........@@@.@@@...@@@......@...............@@@@@..@..................@@@@@@@...
@@@@@@@@@......@.....@@...@@@.@@@.@......@@......@.......@@@@.@.@.........@.....@@@@@@.@...
@@@@@@@@@@............@.......@...@......@...............@@@@@@@@@@.............@@@@@......
@@@@@@@........@.@@...@@.................................@@@@@@@@@@.......@@@@@@@@@@.....@@
@@@@@@@.......@@.....@@@...........@@@..........@@@....@@@@@@@@@@@@@......@@@@@@@@@@......@
@@@.......@...@@@.@..........@...@@@@@...........@@@@@@@@@@@@@@@@@@@......@..@@@...@..@..@@
@............@@@@@...............@@@@@@.........@@@@@@@@@@@@@@@@@.@@.@@@.....@@@..........@
@..............@@@.........................@....@@@@@@@@@@@@@@@@@....@@@...@..........@..@@
@@@.............@...........@............@.........@@@@@@...@@@@@@@...@@.............@@@@@@
@.......@.......@.................................@.@@@.....@@.@@@...@@.@..............@@@@
@@..................@........................@@@@...@@@.....@...@....@@..........@.@...@@@@
............................@@@..@@...@@..@@..@@@.....@....@@...@@..........@@...@...@@@@@@
....@@.....................@@@@.......@@.......@@.@@..@@........@@.........@@@.......@@@@@@
...@@@.....................@@@.......@@.........@...........................@.@@..@@@@@@@@@
.....@........@............@@........@@.........@@................@.......@...@...@..@@@@@@
..............@@....@@.....@@.@@@@@.@@....@............................@.............@@@@@@
.........................@@@@@@@@@@@@@@@..............................@@@...@...@......@@@@
.....................@@...@@@@@@@@@@@@@@........@...@..................................@@@@
........@.............@...@@@@@@@@@@@@@@@...............................@..............@@@@
......@....@.@.............@@@@@@@@@@@@@@......................................@.......@@@@
@....@@@...........@........@@@@@@@@@@@@@.....................................@@...........
@....@@@@..........@.........@@@@@@@@@@@@.........@@@..............@@.........@...@.@@@@@@.
8
59 27 0
7 54 0
25 39 0
33 29 0
42 71 0
49 66 0
53 70 0
51 83 0

9 79 0
51 85 0
67 76 0
27 90 0
44 67 0
16 47 0
0 0 0
58 77 0
