width 91
height 91
@@@@@@@@@@@@@@@@@@@@@@@@@@@@@@@@@@@@@@@@....@.@.........@@@@@@@@@@@@@@@@@@@@@@@@@@@@@@@@@@@
@@@@@@@@@@@@@@@@@@@@@@@@@@@@@@@@@@@@@@@@....@..........@@@@@@@@@@@@@@@@@@@@@@@@@@@@@@@@@@@@
@@@@@@@@@@@@@@@@@@@@@@@@@@@@@@@@@@@@@@@@@.........@.....@.@@@@.@@@@@@@@@@@@@@@@@@@@@@@@@@@@
@@@@@@@@@@@@@@@@@@@@@@@@@@@@@@@@@@@@@@@@@@..@@............@@.@.@@@@@@@@@@@@@@@@@@@@@@@@@@@@
@@@@@@@@@@@@@@@@@@@@@@@@@@@@@@@@@@@@@@@@@@...........@@@..@....@@@@@@@@@@@@@@@@@@@@@@@@@@@@
@@@@@@@@@@@@@@@@@@@@@@@@@@@@@@@@@@@@@@@@@.....@@@....@@........@@@@@@@@@@@@@@@@@@@@@@@@@@@@
@@@@@@@@@@@@@@@@@@@@@@@@@@@@@@@@@@@@@@@@@.....................@@@@@@@@@@@@@@@@@@@@@@@@@@@@@
@@@@@@@@@@@@@@@@@@@@@@@@@@@@@@@@@@@@@@@@@@........@....@.........@@@@@@@@@@@@@@@@@@@@@@@@@@
@@@@@@@@@@@@@@@@@@@@@@@@@@@@@@@@@@@@@@@@@@@@........@...........@@@@@@...@@@@@@@@@@@@@@@@@@
@@@@@@@@@@@@@@@@@@@@@@@@@@@@@@@@@@@@@@@@@@@@@@......@.........@@@@@@@@...@@@@@@@@@@@@@@@@@@
@@@@@@@@@@@@@@@@@@@@@@@@@@@@@@@@@@@@@@@@@@@@@@.@....@.........@@@.@@@@.@...@@@@@@@@.@@@@@@@
@@@@@@@@@@@@@@@@@@@@@@@@@@@@@@@@@@@@@@@@@@@@@@.........@.@@.....@.@@@@.@..@......@@....@@@@
@@@@@@@@@@@@@@@@@@@@@@@@@@@@@@@@@@@@@@@@@@@@@@@@..................@@@@...................@@
@@@@@@@@@@@@@@@@@@@@@@@@@@@@@@@@@@@@@@@@@@@@@@@@.@.@..............@@..................@@@@@
@@@@@@@@@@@@@@@@@@@@@@@@@@@@@@@@@@@@@@@@@@@@@@@@@@@@...............@@......@@..........@@@@
@@@@@@@@@@@@@@@@@@@@@@@@@@@@@@@@@@@@@@@@@@@@@@@@@@@@@.....@@............@..@@@...@.@......@
@@@@@@@@@@@@@@@@@@@@@@@@@@@@@@@@@@@.@@@@@@@@@@@@@@@@@.....@@@@@..@.................@@@....@
@@@@@@@@@@@@@@@@@@@@@@@@@@@@@@@@@@..@@@@@@@@@@@@@@@@@...@.@@@@@@@@@@.............@.@@@...@@
@@@@@@@@@@@@@@@@@@@@@@@@@@@@@@@@@@.....@@@@@@@@@@@@@@@@@@.@@@@@@@@.............@.@..@....@@
@@@@@@@@@@@@@@@@@@@@@@@@@@@@@@@@@@....@@@@@@@@@@@@@@@@@@@@@@@@@@@@.............@........@@@
@@@@@@@@@@@@@@@@@@@@@@@@@@@@@..@.......@@@@@@@@@@@@@@@@@@@@@@@@@@@...........@...........@@
@@@@@@@@@@@@@@@@@@@@@@@@@@@@@..........@@@@@@@@@@@@@@@@@@@@@@@@@@@.......@@..............@@
@@@@@@@@@@@@@@@@@@@@@@@@@@@@@.........@@@@@@@@@@@@@@@@@@@@@@@@@@@@@....@..@..............@@
@@@@@@@@@@@@@@@@@@@@@@@@@@@@@@.........@@@@@@@@@@@@@@@@@@@@@@@@@@@@........................
@@@@@@@@@@@@@@@@@@@@@@@@@@@@@...........@@@@@@@@@@@@@@@@@@@@@@@@@@@............@@@@........
@@@@@@@@@@@@@@@@@@@@@@@@@@@@@............@@@@@@@@@@@@@@@@@@@@@@@@@@@@......................
@@@@@@@@@@@@@@@@@@@@@@@@@@@@@..@.........@@@@@@@@@@@@@@@@@@@@@@@........................@..
@@@@@@@@@@@@@@@@@@@@@@@@@@................@@@@@@@@@@@@@@@@@@@@@@...@.............@..@......
@@@@@@@@@@@@@@@@@@@@@..@......@.............@@@@@@@@@@@@@.@@@@@@..............@..@@........
@@@@@@@@@@@@@@@@@@..@....@..........@.......@@@@@@@@@@@@@.@@@@@@.................@@....@...
@@@@@@@@@@@@@@@@@@@...@...........@.........@@@@@@@@@@@......@....@..............@@....@@..
@@@@@@@@@@@@@@@@@@@@@@@.@........@@.........@@@@@@@@@@@..........................@@@...@@..
@@@@@@@@@@@@@@@@@@@@@@@@@...@@..@@.......@..@@@@@@@@@.......@.@............@@.....@.......@
@@@@@@@@@@@@@@@@@@@@@@@@@@@.@...............@@@@@@@@@@@........@@@.........@@.............@
@@@@@@@@@@@@@@@@@@@@@@@@@@@................@@@@@@@@@@@@@@@.........@.....@................@
@@@@@@@@@@@@@@@@@@@@@@@@@@..........@.....@@@@@@@@@@.@@...................................@
@@@@@@@@@@@@@@@@@@@@@@@@@@.......@........@@@@@@@@@...@.@...............@...............@@@
@@@@@@@@@@@@@@@@@@@@@@@@@@..............@@@@@@@@@...@@.........@@.............@........@@@@
@@@@@@@@@@@@@@@@@@@@@@@@@@..............@@@@@@@@@.@.@@.........@.......@..@@............@@@
@@@@@@@@@@@@@@@@@@@@@@@@@@@............@@@@@@@@@@.@@@...........@.........@@............@@@
@@@@@@@@@@@@@@@@@@@@@@@.@@.............@@@@@@@@@..@@@@@@...@......@..@....@@@.............@
@@@@@@@@@@@@@@@@@@@@.........@.......@@@@@@..@@.....@@@@...@@.....@.......@@@@@@@..@...@..@
@@@@@@@@@@@@@@@@@@@@........................@@@..........@@@@..@@@...@....@@@@@@@..........
@@@@@@@@@@@@@@@@@@@.........................@@@@@.........@@@...@@..@@@.@.....@@...........
@@@@@@@@@@@@@@@@@..........@...........................@............@@@.......@....@.......
@@@@@@@@@@@@@@@@@@.......@@.............@@..............................................@..
@@@@@@@@@@@@@@@.....@@.............................@...@..@@@@.....@....................@..
@@@@@@@@@@@@.@......@@@......@..........................@@@@@@@.........................@..
@@@@@@@@@@.......@.@@@@@@....@....@@@......................@@@........................@@...
@@@@@@@@......@@.@@@@@@@..........@.........................@@......@.................@....
..@.@@@@...@......@...@@@......................@@...........@@.......@@.................@..
....@@@@@@@.......@@...@@............................................@......@@.............
.....@..................@...............@...................................@@@............
....................@...@.@@............@......................@...........@@@............@
......@.............@..............@.......@@............@.@...@...........@@............@@
........................@..@......@@................@...@@.............@...@@.........@..@@
...............@.@.........................................@..........@@...@@@............@
..............@..@....................@.............@...@.@...........@@.@@.........@.@...@
..@@.........@@......@@@@.............@...........@@@.....@@..........@@@.....@...........@
..@@....@.....@@......@@@....@..........@@....@.....@....@@@.........@@@......@.......@@..@
..............@@.......@@@@@.....@.......@....@...........@@..........................@..@@
........................@@@......@@@.....@@@..@@.....@........@@@...........@..........@@..
@@......@..............@@@@......@.@....@@@....@...............@@..@...............@.......
@.....@@................................@@@...............@..............................@@
...........................................@.....@@.@@......@...........@..@.@...........@@
...........@.....@..............@..........@@.....@@........@@.@.......................@@@@
.....@...........@........@.....@.................@....@.......@@...............@@..@@@@@@@
..........@................................@.................@@@@....@.......@@@@@@@@@@@@@@
.@...................@...........@@...........@..............@..............@@@@@@@@@@@@@@@
...@...@@...............@@@...................@.....@...................@.@@@@@@@@@@@@@@@@@
@@.....@@@..@............@@@..................@.........................@@@@@@@@@@@@@@@@@@@
@@.........@@.......@....@@@@.......@..@..............@....@..@@@...@..@@@@@@@@@@@@@@@@@@@@
@@...@.....@@..@....@.....@...........................@....@.@@@@@@..@@@@@@@@@@@@@@@@@@@@@@
@@.....@...@@..........@.............@.......@............@@@@@@@@..@@@@@@@@@@@@@@@@@@@@@@@
@...@@@@.......@...@................@.................@@..@@@@@@@@@@@@@@@@@@@@@@@@@@@@@@@@@
....@@@@..@...@@.....@.............@@.....@...........@@..@@@@@@@@@@@@@@@@@@@@@@@@@@@@@@@@@
.........@@......@...@..............@.........@......@@@@.@@@@@@@@@@@@@@@@@@@@@@@@@@@@@@@@@
.................@@@@......@....@.@@@.@......@.....@..@@..@@@@@@@@@@@@@@@@@@@@@@@@@@@@@@@@@
@.@.........@..@..@.@..........@@@@@@.@..................@@@@@@@@@@@@@@@@@@@@@@@@@@@@@@@@@@
@....@...@........@.............@@@@@..........@....@....@@@@@@@@@@@@@@@@@@@@@@@@@@@@@@@@@@
@...............................@@@@@..............@@..@@@@@@@@@@@@@@@@@@@@@@@@@@@@@@@@@@@@
@@...................@@@...@@@..@@@@..@.............@@.@@@@@@@@@@@@@@@@@@@@@@@@@@@@@@@@@@@@
@@@......@.....@.....@@@.@@@@@@...@.....................@@@@@@@@@@@@@@@@@@@@@@@@@@@@@@@@@@@
@@@..@.........@....@@@@@@@@@@@@@@@..............@.....@@@@@@@@@@@@@@@@@@@@@@@@@@@@@@@@@@@@
@@@.........@@@.....@@@@@@@@@@@@@@@..@.@.......@.........@@@@@@@@@@@@@@@@@@@@@@@@@@@@@@@@@@
@@@@@@@@....@@@@@@@@@@@@@@@@@@@@..@@.@...................@@@@@@@@@@@@@@@@@@@@@@@@@@@@@@@@@@
@@@@@@@@@....@@@@@@@@@@@@@@@@@@@........................@@@@@@@@@@@@@@@@@@@@@@@@@@@@@@@@@@@
@@@@@@@@@..@.@@@@@@@@@@@@@@@@@@@.......................@@@@@@@@@@@@@@@@@@@@@@@@@@@@@@@@@@@@
@@@@@@@@@..@@@@@@@@@@@@@@@@@@@@..........@...........@@@@@@@@@@@@@@@@@@@@@@@@@@@@@@@@@@@@@@
@@@@@@@@@@@@@@@@@@@@@@@@@@@@@@@......@@..............@@@@@@@@@@@@@@@@@@@@@@@@@@@@@@@@@@@@@@
@@@@@@@@@@@@@@@@@@@@@@@@@@@@@@@@.@@..@@@@.@@..@@@@@@@@@@@@@@@@@@@@@@@@@@@@@@@@@@@@@@@@@@@@@
8
44 80 0
31 36 0
48 13 0
43 46 0
70 41 0
59 66 0
36 56 0
15 55 0

82 18 0
32 51 0
41 0 0
62 15 0
68 45 0
88 58 0
12 54 0
82 14 0
