width 91
height 91
@@................@@@@@@@@@@@@@@@@@@@@@@@@.......@@@@@@@.@@@@@@@@@@@@@@@@@@@@@@@@@@@@@@@@@@
@@.................@@...@@@@@@@.....@@...@@.......@@@@@...@@@@@@@@@@@@@@@@@@@@@@@@@@@@@@@@@
@@....@@....@......@@@..@@@@@.......@............@@@@@..@....@@@@@@@@@@@@@@@@@@@@@@@@@@@@@@
@@..............@...@....................@.......@@@@........@@@@@@@@@@@@@@@@@@@@@@@@@@@@@@
@........@@@.............@.......................@@@@.....@.@@@@@@@@@@@@@@@@@@@@@@@@@@@@@@@
@@......@..........@............@.....@...@..@@@@...........@@@@@@@@@@@@@@@@@@@@@@@@@@@@@@@
@@@........@@......@@...@.....@@@.....@..@@..@@@@.............@@@@@@@@@@@@@@@@@@@@@@@@@@@@@
@@......................@@....@@@.....@@@@@..@...........@.....@@@@@@@@@@@@@@@@@@@@@@@@@@@@
@@.......@..............@@@...@.........@@......@@..............@@@@@@@@@@@@@@@@@@@@@@@@@@@
@@@............@....@.....@....................@@@..............@@@@@@@@@@@@@@@@@@@@@@@@@@@
@.@........@..............@............@@...@..@@@..............@@@@@@@@@@@@@@@@@@@@@@@@@@@
.......................@@@@............@@...@..@@@...@...@...@@@@@@@@@@@@@@@@@@@@@@@@@@@@@@
.....................@@@.@@......@..........@.................@@@@@@@@@@@@@@@@@@@@@@@@@@@@@
@@@...............@..@.....@.@.@..............................@@@@@@@@@@@@@@@@@@@@@@@@@@@@@
@@@@....@@........@..@.......@.@..............................@@@@@@@@@@@@@@@@@@@@@@@@@@@@@
@@@@...........................@.....................@......@@@@@@@@@@@@@@@@@@@@@@@@@@@@@@@
@@@.......................................@.....@.@..@@.....@@@@@@@@@@@@@@@@@@@@@@@@@@@@@@@
................@......@..................@.......@..@@........@@@@@@@@@@@@@@@@@@@@@@@@@@@@
@............@@.@@@..............................@@...........@@@@@@@@@@@@@@@@@@@@@@@@@@@@@
@.................@..................@.@.........@............@@@@@@@@@@@@@@@@@@@@@@@@@@@@@
@......@..........@@.....@@.....@....@@@@@@...........@.......@@@@@@@@@@@@@@@@@@@@@@@@@@@@@
@.....@..................@@@....@..@.@@@@@@@...................@@@@@@@@@@@@@@@@@@@@@@@@@@@@
@@@..................@@............@@@@@@@@@@@.@.@.......@......@@@@@@@@@@@@@@@@@@@@@@@@@@@
.....................@@..@.........@@@@@@@@@@@@@@@@@.............@@@..@@@@@@@@@@@@@@@@@@@@@
@...........@..@....................@@@@@@@@@@@@@@...........@...@@@@.@@@@@@@@@@@@@@@@@@@@@
....................................@@@@@@@@@....@@..............@@@@..@@@@@@@@@@@@@@@@@@@@
........@........@@.@.@............@@..@.@@@.....@@..............@.....@@@@@.@@@@@@@@@@@@@@
........@...........@...@@........@@......................@............@@@@...@@@@@@@@@@@@@
@@...@.................@@@.....................@......@...@.......@...@@@@@...@@@@@@@@@@@@@
@..............................................@@...@........@....@............@@@@@@@@@@@@
...@@@@..@......@.................@@............@..@@...@...................@@@@@@@@@@@@@@@
..........................@@......@@.................@..@.....................@@@@@@@@@@@@@
......................@@@.........@@.................@........................@...@@@@@@@@@
..........@...........@@@....@..............@....@...................@@...........@@@@@@@@@
..............@@.......@@@..........@....@@...@@@@@............@@...@@@...@.......@@@@@@@@@
@......................@@@@@.@......@....@....@@@@@@.....@@....@@@..@.................@@@@@
................@@......@.@@.........@........@@@@@@@..........@.............@........@@@@@
..........................@..................@@@@.@@@....@....@......................@@@@@@
.......@.@.........................@@...@@@@@@@@@..@@........@@@@@..@.@....@.......@.@@@@@@
....@......@..........@............@@...@@@@@@@....@.......@.@@@@@....................@@@@@
...@.......@@.......................@@..@@@@@@@@..........@@@@@@@@@@.@...@@...........@@@@@
..@@.......@@@@...............@..@...@...@@@@@@@@..........@@@@@@@@@@@.@@@@..@.........@@@@
...@.......@@@@..............@@@.@@@@@...@@@@@@@@@.........@@@@@@@@@@@.@@@@@@@@........@@@@
@..........@.@@...@....@...@.@@..@@@@@@@@@@@@@@@@@@@.......@@@@@@@@@@@.@@@.@@.@........@@@@
...........@......@....@........@@..@@@@@@@@@@@@@@@@......@@@@@@@@@@@...@..@.......@@..@@@@
@@.........@@.....@..........@.....@@@@@@@@@@@@@@@@@@.....@@@@@@@@@@@..........@@..........
@@....@....@@.....@@.@@.@@@.@@@@@..@@@@@@@@@@@@@@@@.@..@@.@@@@@@@@@@@......................
@@@........@@.@........@@@@@@@@@@.....@@@@@@@@@........@...@@@@@@@..@.@@.......@...........
@@@..@.....@..@........@.@@@@@@@........@@@@@@@@............@@@@@@.....@..........@@.......
@@@@.........@@..........@@@@@@@.......@..@@@@@@..@@@.......@@@@@@..........@.....@....@...
@@@...@......@@.......@...@@@@@@@.@@...@......@@............................@..............
@@@........@@@.@.@...@@@..@@@@@...@@...@...............................@.......@...........
......@........@@......@..@@@@....@@............................@@@@..@@................@@@
..............@@@.................@.....@..@...................@@@@@@.@................@@@@
@..@@@.......@@.@@.......@@@............@..................@...@@@@@@@@@..............@@@@@
@..@@........@...@..............@@.........................@..@@@@@@@.................@@@@@
@@@@@.......@@.....@.....@.@@@.@@@@..@....@.................@...@@@@.....@@..........@@@@@@
@@@@@....................@@@.....@@............................@@@@@............@....@@@@@@
@@@@@@.................@@@@@...............................@......@...................@..@@
@@@@@@...@@........@.............@@............@..........@@...............................
@@@@@@.@@@@.......@@.....@@.@..................@.@.@.........@...@.@...@............@......
@@@@@@@@@@..@@.@.@@@.......@@@...................@.@...............@...@@..................
@@@@@@@@@@...@@@.................@@.@...@.@..@............@............@.............@.....
@@@@@@@@@......@....@@@.................@....@@...........@@................@........@@....
@@@@@@@@@@@...........@@....@...........................@.@@.@.......................@@....
@@@@@@@@@@@@..@..........@.............@...@...@..@.....@............................@@....
@@@@@@@@@@@@...................@..........@@@@.@@.......@..................@@..@......@....
@@@@@@@@@@@@@.@................@..........@@@@.@@.......@............@...@@@...............
@@@@@@@@@@@@....@......@...........@....@@@@@@@@.........@@...............@................
@@@@@@@@@@@.................@@.....@@@.@@@@@@@@@@@@@@@@..@@................................
@@@@@@@@@@@@................@@.....@@@@@@@@@@@@@@@@@@@@@@@........@........@.@@......@.....
@@@@@@@@@@@@.........@.....@@.......@@@@@@@@@@@@@@@@@@@@@@..@.............@@@@....@..@.....
@@@@@@@@@@....@.....................@@@@@@@@@@@@@@@@@@@@@@@@@..@..@......@@@@..@@@@@.....@@
@@@@@@@@@@...@@.@.......@@.@.......@@@@@@@@@@@@@@@@@@@@@@@@@@@........@@.@@@@..@@@@@@@..@@@
@@@@@@@@@@...@@@@.....@..@.........@@@@@@@@@@@@@@@@@@@@@@@@@@@@@....@...@@@@@@@@@@@@@@.@@@@
@@@@@@@@@@@@@@@@......@@..........@@@@@@@@@@@@@@@@@@@@@@@@@@@@@@@.@@....@@@@@@@@@@@@@@@@@@@
@@@@@@@@@@@@@@@.......@.............@@@@@@@@@@@@@@@@@@@@@@@@@@@@@@@@....@@@@@@@@@@@@@@@@@@@
@@@@@@@@@@@@@@@.......@..............@@@@@@@@@@@@@@@@@@@@@@@@@@@@@@@....@@@@@@@@@@@@@@@@@@@
@@@@@@@@@@@@@................@.......@@@@@@@@@@@@@@@@@@@@@@@@@@@@@@@@@@@@@@@@@@@@@@@@@@@@@@
@@@@@@@@@@@@@@....................@@@@@@@@@@@@@@@@@@@@@@@@@@@@@@@@@@@@@@@@@@@@@@@@@@@@@@@@@
@@@@@@@@@@@@@...@.................@@@@@@@@@@@@@@@@@@@@@@@@@@@@@@@@@@@@@@@@@@@@@@@@@@@@@@@@@
@@@@@@@@@@@@............@...@@.@@@@@@@@@@@@@@@@@@@@@@@@@@@@@@@@@@@@@@@@@@@@@@@@@@@@@@@@@@@@
@@@@@@@@@@@@@@@.....@...@..@@@@@@@@@@@@@@@@@@@@@@@@@@@@@@@@@@@@@@@@@@@@@@@@@@@@@@@@@@@@@@@@
@@@@@@@@@@@@@@..............@@@@@@@@@@@@@@@@@@@@@@@@@@@@@@@@@@@@@@@@@@@@@@@@@@@@@@@@@@@@@@@
@@@@@@@@@@@@@@@........@....@@@@@@@@@@@@@@@@@@@@@@@@@@@@@@@@@@@@@@@@@@@@@@@@@@@@@@@@@@@@@@@
@@@@@@@@@@@@@@.........@...@@@@@@@@@@@@@@@@@@@@@@@@@@@@@@@@@@@@@@@@@@@@@@@@@@@@@@@@@@@@@@@@
@@@@@@@@@@@@@@...........@@@@@@@@@@@@@@@@@@@@@@@@@@@@@@@@@@@@@@@@@@@@@@@@@@@@@@@@@@@@@@@@@@
@@@@@@@@@@@@@.@.........@@@@@@@@@@@@@@@@@@@@@@@@@@@@@@@@@@@@@@@@@@@@@@@@@@@@@@@@@@@@@@@@@@@
@@@@@@@@@@@@@.....@.....@@@@@@@@@@@@@@@@@@@@@@@@@@@@@@@@@@@@@@@@@@@@@@@@@@@@@@@@@@@@@@@@@@@
@@@@@@@@@@@@@..@.@@@@......@@@@@@@@@@@@@@@@@@@@@@@@@@@@@@@@@@@@@@@@@@@@@@@@@@@@@@@@@@@@@@@@
@@@@@@@@@@@@@..@@@@@@....@@@@@@@@@@@@@@@@@@@@@@@@@@@@@@@@@@@@@@@@@@@@@@@@@@@@@@@@@@@@@@@@@@
8
37 16 0
7 1 0
78 40 0
19 21 0
38 26 0
82 63 0
0 44 0
34 24 0

7 53 0
8 4 0
68 58 0
81 47 0
66 69 0
4 20 0
6 37 0
81 39 0
