width 62
height 62
@@@@@@@@@@@@@@.......@......@...@@@@@@@@@@@@@@@@@@@@@..@@@@@@@
@@@@@@@....@@.....................@@@@@@@@@@@@@@@@@@@.....@@@@
@@@@@@@.................@.........@@@@@@@@@@@@@@....@....@@@@@
@@@@@..............@.............@@@@@@@@@@@@............@@@@@
@@@@@@..@.............@@.........@..@@@@@@@@@@...@.....@@@@@@@
@@...@@....................@........@@@@@@@@@@@........@@@@@@@
@@..@@@......@....@@......@@.....@@@@@@@@@@@@....@.....@@@@@@@
@@..@.............@@......@@..@..@@@@@@@@@@@@......@@@@@@@@@@@
....@......@@.....@@@.@..........@@@@@@@.@@@@@@......@@@@@@@@@
...@.....@........@@@@@....@....@@@@..@...@@@@@@@....@@@@@@@@@
....@....@........@@@@@@@@...@..@@@@.........@@@......@@@@@@@@
.........@......@@@@@@@@@@@@....@@@...@...@...........@@@@@@@@
@...............@@@@@@@@@@@@.....@@...@................@@@@@@@
.......@..@@..@@@@@@@@@@@@@.......@....................@@@@@@@
........@@@@@@@@@@@@@@@@@@@@@.............@...........@@@@@@@@
........@@@@@@@@@@@@@@@@@@@@@@...............@...@.....@@@@@@@
........@@@@@@@@@@@@@@@@@@@@@@@@@..@...@.....@.....@@..@@@@@@@
..@......@@@@@@@@@@@@@@@@@@@@@@@@@@@...............@..@...@@@@
..@.....@@@@@@@@@@@@@@@@@@@@@@@@@@@@...@..........@@@.@.....@@
.........@@@@@@@@@@@@@@@@@@@@@@@@@@@..@@..........@@@.......@@
.........@@@@@@@@@@@@@@@@@@@@@@@@@@...@@..@@.@...@...........@
..@......@@@@@@@@@@@@@@@@@@@@@@@@@@..@.......................@
@.@....@.@@@@@@@@@@@@@@@@@@@@@@@@@@......@@@................@@
@@.....@.@@@@@@@@@@@@@@@@@@@@@@@@@@......@................@@@@
......@@...@@@@@@@@@@@@@@@@@@@@@@@@@......................@@@@
..@..@@@@..@...@@@@@@@@@@@@@@@@@@@@@.........................@
..@..@@@.....@@@@@@@@@@@@@@@@@@@@@@@.........................@
..@@.@@@.....@@@@@@@@@@@@@@@@@@@@@.@.....@@@...........@.....@
.@@..@...@..@@@@@@@@@@@@@@@@@@@.@@....@..@@@.................@
..@.........@@@@@@@@@@@@@@@@@@.....@@....@@@@............@....
........@@.@@@@@@@@@@@@@@@@@..@@......@..@@@.............@....
...........@@@@@@@@@@@@@...@..............@@......@@...@......
@............@@@...@@@....@...........@....@..@.@......@@.....
@@.................@@.................@@........@.............
....@..........@...............@@.....@.....@@................
...@@..@.@..............@......@...@.......@@@@@@@..........@@
...@@............@@........................@.............@.@@@
...@................@......................@.@...@..@....@@@@@
...........@@@@....................@.........@........@@@@@@@@
............@@@@@@@................@@........@......@@@@@@@@@@
........@...@@@@@@@@@...........................@@...@@@@@@@@@
...............@@@@....@..@.....................@..@@@@@@@@@@@
@@@..................@........@....................@@@@@@@@@@@
@@@.........@@@......@@@...........................@.@@@@@@@@@
@@@.........@@...........................@...........@@@@@@@@@
............@@..........................@@@.........@@@@@@@@@@
.........@..@.........@........@@.......@@.........@@@@@@@@@@@
...@.....@.....................@.........@@.@...@..@@@@@@@@@@@
@@@@@..@@@@...........@@@...............@@@@@.@@....@@@@@@@@@@
@@@@@@@@@@@@............@.@..............@@@@@@@....@@@@@@@@@@
@@@@@@@@@@@@......@....@.....@.........@@@@@@@@@@@@@@@@@@@@@@@
@@@@@@@.@@.......@@....................@@@@@@@@@@@@@@@@@@@@@@@
@@@@....................@@.............@@@@@@@@@@@@@@@@@@@@@@@
@@@@........@.....@....@@@.............@@@@@@@@@@@@@@@@@@@@@@@
@@.....................................@@@@@@@@@@@@@@@@@@@@@@@
@.......@.......................@.@....@@@@@@@@@@@@@@@@@@@@@@@
.....@....@................@@@@@@@@....@@@@@@@@@@@@@@@@@@@@@@@
..............................@@@@@....@@@@@@@@@@@@@@@@@@@@@@@
@......................................@@@@@@@@@@@@@@@@@@@@@@@
@..@@@........@@...@@.@@@@@@@...@.@@....@@@@@@@@@@@@@@@@@@@@@@
@..@@@@..............@@@@@@@@..........@@@@@@@@@@@@@@@@@@@@@@@
@@@@@@@@@.........@@@@@@@@@@@@....@.@.@@@@@@@@@@@@@@@@@@@@@@@@
8
15 11 0
42 42 0
39 45 0
9 8 0
53 36 0
5 3 0
25 41 0
20 51 0

3 6 0
24 4 0
1 24 0
38 60 0
0 9 0
12 41 0
60 28 0
50 44 0
