width 62
height 62
@@@@@@@@@@@@@@@@@@@@@@@@@@@@@@@@@@@@@@@@@@@@@@@@@@@@@@@@@@@@@@
@@@@@@@@@@@@@@@@@@@@@@@@@@@@@@@@@@@@@@@@@@@@@@@@@@@@@@@@@@@@@@
@@@@@@@@@@@@@@@@@@@@@@@@@@@@@@@@@@@@@@@@@@@@@@@@@@@@@@@@@@@@@@
@@@@@@@@@@@@@@@@@@@@@@@@@@@@@@@@@@@@@@@@@@@@@@@@@@@@@@@@@@@@@@
@@@@@@@@@@@@@@@@@@@@@@@@@@@@@@@@@@@@@@@@@@@@@@@@@@@@@@@@@@@@@@
@@@@@@@@@@@@@@@@@@@@@@@@@@@@@@@@@@@@@@@@@@@@@@@@@@@@@@@@@@@@@@
@@@@@@@@@@@@@@@@@@@@@@@@@@@@@@@@@@@@@@@@@@@@@@@@@@@@@@@@@@@@@@
@@@@@@@@@@@@@@@@@@@@@@@@..@@@@@@@@@@@@@@@@@@@@@@@@@@@@@@@@@@@@
@@@@@@@@@@@@@@@@@@@@@@@@.@@@@@@@@@@@@@@@@@@@@@@@@@@@@@@@@@@@@@
@@@@@@@@@@@@@@@@@@@@@@@@.@@@@@@@@@@@@@@@@@@@@@@@@@@@@@@@@@@@@@
@@@@@@@@@@@@@@@@@@@@..@..@.@@@@@@@@@@@@@@@@@@@@@@@@@@@@....@@@
@@@@@@@@@@@@@@@@@@@@.........@@@@@@@@@@@@@@@@@@@@@@..@.....@@@
@@@@@@@@@@@@@@@@@@@.....@....@@@@@@@@@@@@@@@@@@@@@@@.@....@@@@
@@@@@@@@@@@@@@@@@@@...........@@@@@@@@@@@@@@@@@.@@@.......@@@@
@@@@@@@@@@@@@@@@@@@@...........@@@@@@@@@@@@@@@@...........@@@@
@@@@@@@@@@@@@@@@@@@...........@@@@@@@@@@@@@@.@@.........@@@@@@
@@@@@@@@@@@@@@@@@@@....@......@@@@@@@@@@@@@@.@@........@@@@@@@
@@@@@@@@@@@@@@@@@@..............@@@@@@.............@...@@@@@@@
@@@@@@@@@@@@@@@@@@....@@@.....@@..@@@@.......@@@.....@@@@@@@@@
@@@@@@@@@@@@@@@@@.....@@.......@..........@...@@.......@@...@@
@@@@@@@@@@@@@@@........@.....@...@............@.............@@
@@@@@@@@@@@@@@.............@................@...............@@
@@@@@@@.....@@...@@............@@.@..........@@....@@.....@..@
@@@@@@@.....@@.@@@@............@@...........@@@....@@@.......@
@@@@@@@.@......@@...........................@@....@@@@@@....@@
@@@@@@..@.......@.......................@...@....@@@@@@@...@@@
@@@@........@..............@@..........@@.............@@....@@
@@.............@...........@@.......@@..@.@...........@......@
@@.............@........@..........@@@@.......................
@@@....@.@.................@.......@@@@@@.....................
@@@....@....@@@........@.....@@@.@@@@@@@@.................@...
@@@.........@@@.......@......@@@.@@@@@@@@@@.@.........@@@.....
@@@@.@@@..@..@@...............@@@@@@@@@@@@@@...........@@...@@
@@@@.........@@.............@......@@@@@@@@@..@.@............@
@@@@.........@@@....@..............@@@@@.........@.........@@@
@@@@@..@.........@.@...............@@@@@..............@......@
@@@@@@......................@@@@....@@........@@@.....@@.....@
@@@@@@.............@.......@@@@@................@.........@..@
@@@@@@...............@......@@@@................@............@
@@@@@............@..........@@@@.....@.@.......@@@.......@...@
@@@@........................@@@@@@@...@@@@.....@@@...@........
@@@..@@..@..........@....@@@@@@@@@@@@@@@@@....................
.@@........@.............@@@@@@@@@@@@@@@......................
...................@......@@@@@@@@@@@@@...............@.....@@
....................@..@...@@@@@@@@@@@@@.........@..........@@
....@.................@....@@@@@@@@@@@@@@@.........@........@@
@...@@................@.@..@@@@@@@@@@@@@@@@........@........@@
@...@@@@..@..................@@@@@@@@@@@@@....@....@.........@
@.....@........................@@@@@@@@@@...@..........@.....@
@@@@........@@@................@@@@@@@@@@........@......@.@@@@
@@@@.........@@.......@@@@@....@@@@@@@@@@...............@@@@@@
..........................@.....@@@@@@@@@........@@...........
.....@@@....@@....@.............@@@@@@@@@@....................
..@.....@...@@@........@........@@@@@@@@@.......@.............
........@....@@@..@.............@..@@@@@@@@....@....@........@
.............@@...@.....@..........@@@.@@@@.........@..@@....@
..@................................@@...@@@....@.............@
...@@.......@......@...............@@...@@@....@..........@@.@
............@...........................@...@..@@......@.@@@@@
@....@..@..@@@@@........@@@..............@......@.@......@@@@@
@@.........@@@@..........@@..@@.@.................@.....@@@@@@
@@@@........@@@@.........@@..@@@@......@@......@.......@@@@@@@
8
26 56 0
25 47 0
23 56 0
59 45 0
50 15 0
48 14 0
27 59 0
16 38 0

24 14 0
19 26 0
19 54 0
19 49 0
24 39 0
48 14 0
51 37 0
9 37 0
