width 62
height 62
@@@@@@@@@@@@@@@......@...@.....@@@..@@@@@@@@@@@@@@@@@@.....@@@
@@@@@@@@@@@@@@@@...............@@......@@@@@@@..@@...@.......@
@@@@@@@@@@@@@@@@............@......@..@@@@@@@.......@@..@@....
@@@@@@@@@@@@@@@@...@@.......@...@.....@@@@@@@...........@@....
@@@@@@@@@@...@@.............@@........@@@@@@@...........@@....
@@@@@@@@.....@@....................@..@@@@@@@.................
@@@@@@@......@........@@.@@........@..@@@@@@..@@....@.........
@@@@@@@...................@@@@........@@@@@.............@...@.
@@@@@@@.............@.....@@@@.........@..@.......@.....@...@.
@@@@@@@@...............@@..@@@...@.....@..@@.@@..@............
@@@@@@@@.............@@@@@@@@@..@.........@........@..........
@@@@@@@.....@@@@....@@@@@@@@@@....@...........................
@@@@@@.......@@@.@..........@@....@@......@......@...@........
@@@@@@.........@....@.......@@..@..@.....@@@@.......@@...@...@
@@@@@@@@.............@..@.......@.......@@@@@..@@..........@@@
@@@@@@@@@@......................@@....@@@@@@@@@@@@@..@@....@@@
@@@@@@@@@@@..@..@@@......@...........@@@@@@@@@@@@@@.@.....@@@@
@@@@@@@@@@@...................@@@@..@@@@@@@@@@@@@@@.@.....@@@@
@@@@@@@@@@........@.@...............@@@@@@@@@@@@@@@@.....@@@@@
@@@@@@@@@@......................@...@@@@@@@@@@@@@@@@@...@@@@@@
@@@@@@@@@@..........................@@@@@@@@@@@@@@@@....@@@@@@
@@@@@@@@@@........@...............@@@@@@@@@@@@@@@@@@@@@.@@@@@@
@@@@@@@@@@..........@@............@@@@@@@@@@@@@@@@@@@@..@@@@@@
@@@@@@@@@@..........@@@@..........@@@@@@@@@@@@@@@@@@@@...@@@@@
@@@@@@@@.......@@.....@@..........@@@@@@@@@@@@@@@@@@@@...@@@@@
@@@..@@@.@@@...@@...............@@@@@@@@@@@@@@@@@@@@@.@....@@@
@@.....@...@...............@....@@@@@@@@@@@@@@@@@@@@@......@@@
@@.........................@....@@@@@@@@@@@@@@@@@@@@@......@@@
@@@........@@..............@.....@@@@@@@@@@@@@@@@@@@@@@....@@@
@@@@@@.....@@........@...........@@@@@@@@@@@@@@@@..@@@@.......
@@@@@@......................@....@@@@@@@@@@@@@.....@@.........
@@@................@......@@.....@@@@@@@@@@@@@......@@........
@..@..........@..................@@@@@@@@@@@@@................
@..@..................@@............@@@@@@@@@@................
@..@@................................@@@@@@@@@.@@........@...@
..........@.....@.....@.@............@@@@@.@@@@@@..........@@@
@....@.....................@@.......@@@....@@@@@..........@@@@
@@.......@@....@....@.....@@@@@@....@@@......@@....@@.......@@
@@@@..@.............@....@@@@@@@....@@@..........@@@@...@....@
@@@@..@...@@.............@@@@@@@@@....@......@...@@@@@.......@
@@@@@.@@@.@@.........@...@@@@@@@@................@@@@.......@@
@@@@@@@@@..@@@@..@.........@.@@@@@......@.......@@@@@........@
@@@@@@@@@...@@@@..............@@@.....@@@@...@...............@
@@@@@@@@@....@@...@@...........@@.....@..@............@......@
@@@@@@@@@@@........@....@@@...@@@@@........................@.@
@@@@@.......@.@.........@.....@@@@@.............@...........@@
@@@@@@@.@...............@@@.....@@@@...@@@@@................@@
@@@@.......@.........@....@@@@..@@@..........................@
@@....@@.....@..............@@@.........@.....@........@..@..@
@@.........................@@@....@.......@@...........@@.@...
@@@................@....@..@@@....@....................@@.....
@@@@.....@@@@..........@@.@@@..............................@..
@@@@@..@@@@@@.....@....@....@..@...@.............@.........@..
@@@@@.....@@@..@..@...............@@................@......@..
@@@@@........................................@..@@............
@@@@@@..............@@@......................@.....@..........
@@@@@@.............@@@@.....@.................................
@@@@@@.............@@.@..................@.@..........@.......
@@@@@@....@...@..@....@.......@@.........@..................@.
@@@@..................@@@@.........................@@.........
@@@@......@@........@.@@@@..........@.@@...........@@@........
@@@@@@@@@@@.............@@..@@........@@..@.....@@@@@@..@...@@
8
55 12 0
17 19 0
34 52 0
34 37 0
38 55 0
17 31 0
35 11 0
9 9 0

24 22 0
11 8 0
37 57 0
57 7 0
33 14 0
35 61 0
26 35 0
39 58 0
