width 62
height 62
@@@@@@@@@@@@@@@@@@@@............@@@@..@@@@@@@@@@.........@....
@@@@@@@@@@@@@@@@@..............@@....@@@@@@@@@@..@............
@@@@@@.@@@@@@@@@@...@...........@.....@.@@@@@.........@.......
@@.@@@......@@@@....@..........@@@.......@@@@...........@@@...
...@@@.......@@........@@......@@@.........@@@@.@@......@@@...
.....@.......@@.........@.............@..@@@@@@..............@
@............@@..........................@@@.......@@........@
@............@@@.........@@@............@@...@......@........@
.......@@......@@........@@@..........@......@..@.......@@@@@@
.....@...@.....@@..@@....@@@.@.@@...........@@..@..@......@@@@
.........@.........@@...................@.................@@@@
.....@...@............@........@@@......@..@..@@...........@.@
..............@@......@........@@....@@....@...@@....@@......@
@@............................@@@@@@@@@........@@.......@@...@
@............@................@@@@@@@@@@.......@@............@
@..@.....@...................@@@@@@@@@@@@..@..................
@..@.........................@@@@@@@@@@@@@.@@.................
@...........@@...............@@@@@@@@@@@@@.@@.................
@..........@........@.@......@@@@@@@@@@@@@.@@.................
.....................@....@..@@@@@@@@@@@@..@@.........@....@..
.......................@..@@@@@@@@@@@@@@@...@............@...@
..........@...............@@@@@@@@@@@@@@.@..@..@@........@..@@
............@@@..@@..@....@@@@@@@@@@@..........@.....@.....@@@
..@..@@@@....@.......@....@@@@@@@@@@@@......@..@....@......@@@
......@@@....@............@@@@@@@@@@@@................@....@@@
.....@..................@.@@@@@@@@@@@@@.............@.........
........................@@@@@@@@@@@@....@...........@.........
......................@@@@@@@@@@@@@@........@@@.............@.
@@....................@@@@@@@@.@@@@@...@....@@..@@@....@......
@......................@....@..@@@@@@.@@....................@.
@..............@.@...@.........@@@@@@......................@@@
..........@@....................@@@@@..........@....@.....@@@@
................@..............@@@@@@.@........@@@..@.@...@@@@
@..............................@@@@@@@@@....@@@@@@@@@.....@@@@
@.........@.................@..@@..@@@@@....@@@@@@@@@....@@@..
@@@@@@....@..@.........@@...@..@@@.........@@@@@@@@@@.........
@@@@@@....@@@@@@..@....@@@.@@..@@@.........@@@@@@@@@@.........
@@@@@.....@@@@@@@@@@.@.@@@.....@@@.........@@@@@@@@@@@@@..@..@
@@@@@.....@@@@@@@@@@@@@@@......@@@...............@@@@@@.......
@@@@@@@@@@@@@@@@@@@@@@@@@@@@.@.......@...........@@@@.@.......
@@@@@@@@@@@@@@@@@@@@@@@@@@@@@@@...................@@@.........
@@@@@@@@@@@@@@@@@@@@@@@@@@@@@@@...............................
@@@@@@@@@@@@@@@@@@@@@@@@@@@@@@@.......@@@@................@@..
@@@@@@@@@@@@@@@@@@@@@@@@@@@@@@@.@.....@@@@.....@..@@..........
@@@@@@@@@@@@@@@@@@@@@@@@@@..@.@........@@@..@..@@@@@@@....@@@@
@@@@@@@@@@@@@@@@@@@@@@@@@@............@@....@@..@@@@@....@@@@@
@@@@@@@@@@@@@@@@@@@@@@@@@@..........@.....@.....@@@@@....@@@@@
@@@@@@@@@@@@@@@@@@@@@@@@@@@....................@@@.@@.....@@@@
@@@@@@@@@@@@@@@@@@@@@@@@@@@...................@@@@.....@@.@@..
@@@@@@@@@@@@@@@@@@@@@@@@........@................@@...........
@@@@@@@@@@@@@@@@@@@@@.@@..............@@@@....................
@@@@@@@@@@@@@@@@@@@@@....@...@@.......@....@..........@.......
@@@@@@@@@@@@@@@@@...@@...@...................................@
@@@@@@@@@@@@@@@@@.........@..@@@........@.....@@...@@...@.@..@
@@@@@@@@@@@@@@@@@.............@.........@@.@@......@@.@.@@@.@@
@@@@@@@@@@@@@@@@@..............@....................@@..@@@@@@
@@@@@@@@@@@@@@@..@.....@....@...........................@@@@@@
@@@@@@@@@@@@@@..@@@@..........................@@@...@....@@@@@
@@@@@@@@@@@@@@..@@..@@.......@................@@@...@....@@@@@
@@@@@@@@@@@@@@.................@...........@@@@@.........@@@@@
@@@@@@@@@@@@@@..........@.........@..@@@..@@@@@@.....@...@@@@@
@@@@@@@@@@@@@@.........@@@@.@@......@@@@@@@@@@@@........@@@@@@
8
0 23 0
41 48 0
28 57 0
23 1 0
52 15 0
43 41 0
54 20 0
0 32 0

38 47 0
0 25 0
54 41 0
20 37 0
41 4 0
15 20 0
0 24 0
28 2 0
