width 20
height 43
....................
....................
.............@......
............@.......
.....@..@...........
.@......@@........@.
.......@@.@...@.....
......@.....@.......
....@....@..........
..@...@......@...@..
..........@.........
....@..@.@...@..@...
...............@....
.........@........@.
...........@..@.....
....................
.....@...@.......@..
..........@.....@...
.........@..........
...@..@...@@....@.@.
.................@..
.........@..........
.....@....@..@.@....
......@..........@..
....................
......@...@..@.....@
...................@
..@..@..@....@.....@
..........@......@..
...........@........
...@..........@..@..
........@@.@........
.....@..............
.............@.@....
..................@.
.......@.......@....
......@.............
.........@..@.......
....@.........@.@...
........@...........
............@.......
....................
.............@......
6
17 11 0
7 31 0
18 35 0
12 29 1
14 41 1
18 2 1

14 19 0
19 16 0
12 35 0
13 29 1
8 36 1
11 12 1
