width 20
height 43
....................
..@.................
........@.@.........
......@......@.@....
...@..........@.@...
..@.......@.......@.
................@...
..........@......@..
.....@.@.@..........
...............@....
.......@..@.........
....@.......@.....@.
....................
..............@.....
.....@.@....@.......
...@..@.............
...........@........
.......@....@.......
....................
........@.@.@.......
..............@.....
.....@............@.
....................
.@......@.....@.....
.@..@....@...@......
....................
...@................
......@..@......@...
.............@......
..@.@...............
.........@......@...
....................
..............@.....
........@..@....@...
....................
...@.....@..@...@...
............@.......
...........@..@..@..
@.....@........@..@.
@......@............
@..........@.......@
@...@...............
@....@..............
6
19 24 0
17 14 0
6 18 0
17 33 1
4 28 1
15 6 1

5 34 0
18 15 0
19 7 0
2 14 1
5 38 1
1 42 1
