width 20
height 43
...............@....
...............@....
...........@........
....................
.........@......@...
.................@..
..............@.....
...........@......@.
@..@................
@......@..@.@.......
....@...............
.@.....@...@...@....
......@..@..........
...@.@..............
...@.........@......
....................
..@..@.............@
.@..@..@...@........
...............@....
...@...@.@.......@..
..@...........@.....
......@...@.........
........@........@..
....@...............
..@.......@..@......
.......@............
..............@..@..
.......@.......@....
.@.@..@.@...@.......
...........@..@.....
..@..@..@...........
..............@..@.@
....................
................@@..
.......@............
.....@......@......@
....................
....@..@...@.@...@..
................@...
@...................
.....@......@..@....
.......@......@.....
@@.......@..........
6
1 26 0
13 9 0
10 29 0
2 29 1
11 8 1
15 19 1

1 38 0
8 31 0
8 23 0
8 2 1
7 30 1
14 3 1
