width 50
height 50
@@@@@@@@@@@@@@@@@@@@@@@@@....@@.@@@@...@...@@.@@@@
@@@@@@@@@@@@@@@@@@@@@@@@@.....@...@@.....@.@....@@
@@@@@@@@@@@@@@@@@@@@@@@@....@....................@
@@@@@@@@@@@@@@@@@@@.@@.@..............@@...@...@@@
@@@@@@@@@@...@@@@@@...................@@..@@...@@@
@@@@@@@@.@...@..........@@....@.......@@@@@@@..@@@
@@@@@@@@................@@....@....@@@@@@.....@@@@
@@@@@@@@..........................@@@@@@@@...@@@@@
@@@@@@@@@..........................@@@@@@@...@@@@@
@@@@@@@....@.......................@@@@@@....@@@@@
@@@@......@................@......@.@........@@@@@
@@@.................@..@@@@@@.....@..........@@@@@
@@@............@....@...@@@@.........@.......@@@@@
@.@..........@...........@@@.................@@@@@
...........@............@@@@................@@@@@@
............................................@@@@@@
@..........@@..........@....................@@@@@@
@.@........@@@@....@@..@.................@....@@@@
@..........@@@@@..........................@..@@@@@
............@@@...........................@@@@@@@@
............@.............................@@@@@@@@
............................@...@..........@@@@@@@
.......................@.......@...@..@....@@@@@@@
@............@.........@..@...........@....@@@@@@@
@.@......................@@@..........@....@@@@@@@
@@@........................@@.....@...........@@@@
@...........................@@...@..........@..@@@
...@....@.@......@...@......@@...@@....@........@@
.........@@.@.@@............@@.............@....@@
@@@@@@@..@.....@.......................@@.......@@
@@@@@@.......@@......................@@...........
@@@@@@@...........@@@................@@.......@...
@@@@@@@.@........@.@@.........................@...
@@@@@@@@@@@..........@.............@........@....@
@@@@@@@@@@@........................@...@..@@@....@
@@@@@@@@@@.......@@.....@..........@@......@@....@
@@@@@@@@@@.....................@..@@@@.....@....@@
@@@@@@@@@@.....@............@@...@........@.......
...@@@@@@...................................@.....
......@@@.....@............@...@@.................
....@...@.....@............@@@..@@.......@........
...............@...........@@@@...................
...........................@@@....@@.@............
.......@..................@@@@.....@..........@@..
@.......@.................@@@@....@...........@@..
@@@.....@.....@...........@..@....@...............
@@@....@@..@..@@@...@............................@
@@@...@@@@@@@@@@@@......@....@...................@
@@@.@@@@@@@@@@@@@@......@....@@..................@
@@@@@@@@@@@@@@@@@@..@@@@@@....@......@@..@...@.@@@
8
37 4 0
7 40 0
45 43 0
23 27 0
24 23 0
12 36 0
22 14 0
8 25 0

36 3 0
2 40 0
42 33 0
11 19 0
44 49 0
43 8 0
34 33 0
28 45 0
