width 50
height 50
@@@@@@@@@@@........@.........@@@@@@@@@@@@@@@@@@@@@
@@@@@@@@@@@@.@.....@........@@@@@@@@@@@@@@@@@@@@@@
@@@@@@@@@@@.......@@......@@@@@@@@@@@@@@@@@@@@@@@@
@@@@@@@@@@@................@..@@@@@@@@@@@@@@@@@@@@
@@@@@@@@@@@@@.....@@..........@@@@@@@@@@@@@@@@@@@@
@@@@@@@@@@@@@@.....@...........@@@@@@@@@@@@@@@@@@@
@@@@@@@@@@@@@@.....@.........@.@@@@@@@@@@@@@@@@@@@
@@@@@@@@@...@@.....@@@........@@@@@@@@@@@@@@@@@@@@
@@@@@@@@....@@@@...@@........@@@@@@@@@@@@@@@@@@@@@
@@@@@@@@@...@@@@.......@.....@@@@@@@@@@@@@@@@@@@@@
@@@@@@@@@...@..@...............@@@@@@@@@@@@@@@@@@@
@@@@@@@@......................@@@@@@@@@@@@@@@@@@@@
@@@@@@@..........@.............@@@@@@@@@@@@@@@@@@@
@@@@@@@@.@.................@.......@@@@@@@@@@@@@@@
@@@@@@@@@@..............@.@........@@@@@@@@@@@@@@@
@@@@@@@@@@@@@@........@........@...@@@@@@@@@@@@@@@
@@@@@@@@@@@@@...@..............@....@@@..@@@@@@@@@
@@@@@@@@@@@@@.............................@@@@@.@@
@@@@@@@@@@@@@..@.................@.@....@@@@@@..@@
@@@@@@@@@@......@@...@@.........@@.@.@....@@@@...@
@@@@@@@@@.......@@...@@.........@@...@...........@
@@@@@@@@@.......@@@@..@.@.......@@..@@...@.......@
@@@@@@@@@...............@@..........@....@....@...
@@@@@@@@...............@........@............@....
@@@@@@........@.......@@@@@..................@....
@@@@@.................@@@@@@@@.........@....@@....
...@@................@@@@@@@@@@@....@@@...........
...@@......@@..........@@@@@@@@.....@......@......
...@@......@@@....@....@@...@@@............@@.....
...@@@@.........@......@@..@@@..@..........@@.....
..@@@@@.............@..................@@..@....@@
...@@@@@....@..@@........@.................@@@@@@@
......@@@......@@@.......@..@........@.......@@@@@
........@....@@@@@.......@...................@@@..
...@..........@.....@@......................@@@@..
..@@@...................@.....................@@..
...@@.......@@.@..................@...............
..........@@@@......@............@@@.........@....
..........@@@@............@......@@@@...@..@......
@..........@@@.........@.....@..@.......@.........
............@@..@.........@.......................
...........@@@..@........@@@...................@@@
@.........................@@.@@.................@@
................@........@@@.@@@....@.@......@...@
@.@............@........@@@@@@@@....@.@@.........@
@...@..................@@@@@@@@@@@@@..@@.......@..
@...@@@@...............@@@@@@@@@@@@@.@@@.......@..
..@@@@@@.@@@..@@....@@@@@@@@@@@@@@@@@@@@.......@@@
..@@@@@@@@@...@@@....@@@@@@@@@@@@@@@@@@@...@@@@@@@
@@@@@@@@@@....@@@@@@.@@@@@@@@@@@@@@@@@@@....@@@@@@
8
33 17 0
26 22 0
10 31 0
33 43 0
24 39 0
39 24 0
7 38 0
9 8 0

16 18 0
26 19 0
45 46 0
30 29 0
8 11 0
28 18 0
7 38 0
20 24 0
