width 50
height 50
@@@@@@@@@...........@......@@...@@.........@@@@@@@
@@@@@@@@@..@.....@....@.....@.@..@......@@..@@@..@
...@@@@@...@..........@@......................@.@@
....@@@@...@@..........@....................@.@.@@
.......@...@@@..............................@@....
......@@..@@@@.....................@.........@....
@....@@@.@@@@@....@.......................@@.....@
.....@....@@@@@@.......@..................@@......
............@..........@..................@@..@...
@.........................@.@@....@......@........
@.........................@.@@.@@@@@@@...@........
@..@@@...............@...@@.....@..@@@.........@@.
....@@...@@........@...............@@@...@.....@@@
...@@@@............@@@..@.........@@@@..@@.......@
@...@......@........@@..............@@@.....@.....
@......@.......@@@.@@..........@..........@@@....@
...............@@@.@...........@........@@@@@.....
...@...........@@..@..........@..@@.....@@@@@@@@@@
...@......@...@@................@@@...@@@@@@@@@@@@
@.......@@@@@@@@.........@@...@@@@@...@@@@@@@@@@@@
@.......@@@@@@@@.........@@@@.@@@@@@..@@@@@@@@@@@@
@@.......@@@@@@@.......@@.@....@@@@@..@@@@@@@@@@@@
@........@@@@@@@@...@..........@@@@@@@@@@@@@@@@@@@
@..@.....@@@@@@@@@@.......@@@@@@@@@@@@@@@@@@@@@@@@
...@.....@@@@@@@@@@@.....@@@@@@@@@@@@@@@@@@@@@@@@@
@@@@......@@@@@@@@@@@@@..@@@@@@@@@@@@@@@@@@@@@@@@@
@@@@......@@@@@@@@@@@@@@@@@@@@@@@@@@@@@@@@@@@@@@@@
@@@@......@@@@@@@@@@@@@@@@@@@@@@@@@@@@@@@@@@@@@@@@
@@@@@....@@@@@@@@@@@@@@@@@@@@@@@@@@@@@@@@@@@@@@@@@
@@@@@@...@......@@@@@@@@@@@@@@@@@@@@@@@@@@@@@@@@@@
@@@@............@@@@@@@@@@@.@.@@@@@@@@@@@@@@@@@@@@
@@@@............@@@@@@@@@@....@@@@@@@@@@@@@@@@@@@@
@@@@........@.@@@@@@@@@@@......@@@@@@@@@@@@@@@@@@@
@@@@...........@@@@@@@@..@......@@@@@@@@@@@@@@@@@@
@@@@............@@@@@@@@........@@@@@@@@@@@@@@@@@@
@@@..............@@@@@@@......@@@@@@@@@@@@@@@@@@@@
@................@@.@@.........@@@@@@@@@@@@@@@@@@@
........@........@@........@....@@@@@@@@@@@@@@@@@@
.@......@@.......@.........@...@@@@@@@@@@@@@@@@@@@
.....@...........@...........@.@@@@@@@@@@@@@@@@@@@
.@...@...@.@@..................@@@@@@@@@@@@@@@@@@@
.....@......@@................@@@@@@@@@@@@@@@@@@@@
....@@..............@@...@......@@@@@@@@@@@@@@@@@@
@@...................@..........@@@@@@@@@@@@@@@@@@
@.....................@@.......@@..@.@@@.@@@@@@@@@
......................@...........@@..@@.@@@@@@@@@
........................@@.........@.....@@@@@@@@@
....@....................................@@@@@@@@@
.........................@@......@@@....@@@@@@@@@@
.....................@@..@..@@..@@@@....@@@@@@@@@@
8
22 21 0
16 35 0
7 33 0
20 18 0
28 40 0
43 3 0
23 33 0
2 37 0

23 40 0
6 16 0
15 12 0
38 5 0
1 19 0
29 43 0
11 15 0
47 1 0
