width 50
height 50
@@@@@@@@@@.....@@@...@@@.....@@....@@@@@@@@@@@@@@@
@@@@@@@@@.......@@...@@@@@@..@@@...@@@@@@@@@@@@@@@
@@@@@@...........@@..@@@@@@...@.....@@@@@@@@@@@@@@
@@@@@.....@.....@....@@@@@.....@...@@@@@@@@@@@@@@@
@@@@.....@@....@@.....@@@.....@@.....@@@@@@@@@@@@@
@..@@@...@@@............@....@@@.....@@@@@@@@@@@@@
....@@...@@..................@@@.....@@@@@@@@@@@@@
.........@@..............@@..@@@@.....@@@@@@@@@@@@
..@......@@.............@@@....@@.....@@@@@@@@@@@@
...@......@@............@@@.@...@.@...@@@@@@@@@@@@
.@........@...........@.@.@...........@@@@@@@@@@@@
.................@@...@...............@@@@@@@@@@@@
....@................@@@..............@@@@@@@@@@@@
........@...........@@@@...@.........@@@@@@@@@@@@@
...........@.........@.....@........@@@@@@@@@@@@@@
...........@.@.......@.............@@@@@@@@@@@@@@@
............................@@.@..@@@@@@@@@@@@@@@@
............................@..@..@....@@@@@@@@@@@
....@@....................@....@.........@@@@@@@@@
@.@.....@.........................@.....@@@@@@@@@@
@.......@...@...@.......................@@@@@@@@@@
@@........@@@...@..........@@@@@.....@@@@@@@@@@@@@
@@...........................@@@.....@@@@@@@@@@@@@
@@...@@@...............................@@@@@@@@...
@@...@@...........................@.....@@@.@....@
@@@.@@@......@..@@................@.....@@.......@
@@@@@@@@........@@@@............@....@..@@@.@...@@
@@@@@@@.........@@@@....@.......@@..@@...@@.....@@
@@@@@@@.........@@@.....@...........@@@.@.@.......
@@@@@@@@......@.............@....@@@@.............
@@@@@@@@@...@......@@........@@@@@@@..............
@@@@@@@@....@...@...........@@@@@@@@.......@....@.
@@@@@@@@......@............@@@@@@@@@..............
@@@@@@@........@@@.........@@@@@@@@@.......@......
@@@@@@@........@@@........@@@@.@@@@@...........@@@
@@@@@@.........@@@........@@...@@@@@............@@
@@@@@@@@.......@@@.....@....@@.@@@@@............@@
@@@@@@@@@@.....@@@...............@.@@@..........@@
@@@@@@@@@@@..@@@@@.................@@@..........@@
@@@@@@@@@@.........................@@@@..........@
@@@@@@@@@..........................@@@....@......@
@@@@@@@@@.........@................@@@....@@......
@@@@@@@@@@@.........@.....@....@.@@@@@@@..........
@@@@@@@@@@................@.......@@@@@...........
@@@@@@@..........@........@.....@@@@@@......@@@@@@
@@@@@@@@@@@@@.......@..........@@.@@@@......@@@@@@
@@@@@@@@@@@@@@@....@.........@@@.....@.......@@@@@
@@@@@@@@@@@@@@@......@......@@@@.............@@@@@
@@@@@@@@@@@@@@.......@......@@@@.............@@@@@
@@@@@@@@@@@@@@@....@.....@.@@@@@@@...........@@@@@
8
26 26 0
46 32 0
20 8 0
30 8 0
8 23 0
24 11 0
24 26 0
13 11 0

22 28 0
10 25 0
23 6 0
22 32 0
40 41 0
11 7 0
23 34 0
13 13 0
