width 50
height 50
@@@@@@@@@@@@@@@@@@@@@@...@@@@@@@@@@@@@@@@........@
@@@@@@@@@@@@@@@@@@@@@......@@@..@@@@@@@@@........@
@@@@@@@@@@@@@@@@@@@@@......@@....@@@........@....@
@@@@@@@@@@@@@@@@@@@@@............@@......@@......@
@@@@@@@@@@@@@@@@@@@@@.............@..............@
@@@@@@@@@@@@@@@@@@@@.......@........@.............
@@@@@@@@@@@@@@@@@@@@..................@....@@.....
@@@@@@@@@@@@@@@@@@@............................@..
@@@@@@@@@@@@@@@@@@@....@.......@@..............@@@
@@@@@@@@@@@@@@@@@@@................@.....@@@@....@
@@@@@@@@@@@@@@@@@@@...@@.@@...............@@@.....
@@.@@@@@@@@@@@@@@@........@@..............@@@.....
@@.@@@@@@@@@@..@@@@.......................@@@.....
.@....@.@@@@...@@@@...........@@@@.........@@.....
.@......@@@@...@@.@...........@@@.................
.......@@@@.......@@..........@@..................
.......@@@@......@@@@@........@..............@.@..
..@....@@@........@@@@@...@....................@.@
......@@@.................................@@......
.@......@.....................@..............@...@
.........@.......@......@...............@.........
..............@.....@@..@@..................@..@@@
........................@@@@...........@@...@@@@@@
@@@.....................@@@@...........@@@@.@@@@@@
@@@@@.@@@......@......@.@@@........@...@@@@@@@@@@@
@@@@@@@@@@@@..@@@....@@........@@..@@@@@@@@@@@@@@@
@@@@@@@@@@@@@.@@@..................@@@@@@@@@@@@@@@
@@@@@@@@@@@@@..@........@.........@@@@@@@@@@@@@@@@
@@@@@@@@@@.@................@..@@@@@@@@@@@@@@@@@@@
@@@@@@@..@.@..................@@@@@@@@@@@@@@@@@@@@
@@@@@@@@.....................@@@@@@@@@@@@@@@@@@@@@
@@@@@@......@@...............@@@@@@@@@@@@@@@@@@@@@
@@@.........@@..............@@@@@@@@@@@@@@@@@@@@@@
@......@.@@@@@......@...@..@@@@@@@@@@@@@@@@@@@@@@@
........@@@@@@.@@...........@@@@@@@@@@@@@@@@@@@@@@
........@@@@@@...............@@@@@@@@@@@@@@@@@@@@@
.........@@....@.............@@@@@@@@@@@@@@@@@@@@@
.......@@@..........@........@@@@@@@@@@@@@@@@@@@@@
@@......@....................@@@@@@@@@@@@@@@@@@@@@
.....@.@@..............@@@....@@@@@@@@@@@@@@@@@@@@
..@.@@@@....@.........@@@@.......@@@@@@@@@@@@@@@@@
.@@@@@@@@.......@@...............@@@@@@@@@@@@@@@@@
@@@@@@@@@@@....................@..@@@@@@@@@@@@@@@@
@@@@@@@@@@.................@......@@@@@@@@@@@@@@@@
@@@@@@@@@@@..................@..@@@@@@@@@@@@@@@@@@
@@@@@@@@@@...@@................@@@@@@@@@@@@@@@@@@@
@@@@@@@@@@.......@...@.........@@@@@@@@@@@@@@@@@@@
@@@@@@@@@@.......@.@@..........@@@@@@@@@@@@@@@@@@@
@@@@@@@@@@@@@@@@.@@@@......@....@@@@@@@@@@@@@@@@@@
@@@@@@@@@@@@@@@@@@@@@@@.........@@@@@@@@@@@@@@@@@@
8
20 35 0
36 22 0
23 19 0
3 37 0
26 25 0
11 43 0
23 4 0
9 38 0

27 32 0
29 20 0
22 29 0
7 34 0
35 20 0
49 7 0
21 34 0
44 15 0
