width 50
height 50
@@@@@@@@@@.............@@@@..@......@...@......@@@
@@@@@@@@@@............@@@@@..@......@..........@..
@@@@@@@@@@@@.........@@@.......@@......@@.........
@@@@@@@@@@@...@........@........@.@..............@
@@@@@@@@@@...........@............@..@............
@@@@@@@@@@@@.......@@@............@.........@@....
@@@@.@@@@@@......@.......@.@@....@..........@@@...
@@@@....@@....................@@............@@@@@@
@...@...........@@............@@............@@@@@@
......................@............@.....@...@@@.@
...............@@..................@..........@...
..........@....@@@.@@@.....@.........@....@.......
..........@@@@@@@@.@@.............@..@............
.........@@@@@@@@@@@....@............@..@.......@.
.........@@@@@@@@@@@..........@@@...............@.
.......@@@@@@@@@@@@@...........@@...........@.....
.......@@@@@@@@@@@@@...........@........@......@@@
.......@@@@@@@@@@@@@.@@........@........@......@@@
......@@@@@@@@@@@@@@@@@@@@@..........@.........@@@
.....@@@@@@@@@@@@@@@@@@@@@@....@.@..@..........@@@
..@.@@@@@@...@@@@@@@@@@@@@@........@@...@....@@@@@
@......@@@@..@@..@@..@@@@@@......@@@@@@.....@@@@@@
@@....@@@...@....@@..@@@@......@@@@@@@@.....@@@@@@
@@....................@@@......@@@@@@@@@@@@..@@@@@
@@@@@.@...............@@@@.....@@.@@@@@@@@@@.@@@@@
@@@@@@@.....@.........@@@@........@@@@@@@@@@@@@@@@
@@@@@@@..................@........@@@@@@@@@@@@@@@@
@@@@@@@@........@....@......@.@....@@@@@@@@@@@@@@@
@@@@@@@@.............@......@@@....@@@@@@@@@@@@@@@
@@@@@@@@@..........................@@@@@@@@@@@@@@@
@@@@@@@@@@.........................@@@@@@@@@@@@@@@
..................@................@@@@@@@@@@@@@@@
.................@@.@.............@@@@@@@@@@@@@@@@
@.................................@@@@@@@@@@@@@@@@
@.................@@..@........@...@@@@@@@@@@@@@@@
.............@........@........@@.@@@@@@@@@@@@@@@@
.............@...............@@@..@@@@@@@@@@@@@@@@
@@.....@..@..@@....@..........@@@@@@@@@@@@@@@@@@@@
@@@.@........@...@.............@@@@@@@@@@@@@@@@@@@
@@@@@................@..@@@...@@@@@@@@@@@@@@@@@@@@
@@@@@................@..@....@@@@@@@@@@@@@@@@@@@@@
@@..................@@@......@@@@@@@@@@@@@@@@@@@@@
@.....................@...@@@@@@@@@@@@@@@@@@@@@@@@
@.....................@..@@@@@@@@@@@@@@@@@@@@@@@@@
..........@@.@....@...@@@@@@@@@@@@@@@@@@@@@@@@@@@@
@@.........@....@@@@@@@@@@@@@@@@@@@@@@@@@@@@@@@@@@
@@.@@...........@@@@@@@@@@@@@@@@@@@@@@@@@@@@@@@@@@
@@.@@.........@@@@@@@@@@@@@@@@@@@@@@@@@@@@@@@@@@@@
@..@..........@@@@@@@@@@@@@@@@@@@@@@@@@@@@@@@@@@@@
@.@@@@.....@..@@@@@@@@@@@@@@@@@@@@@@@@@@@@@@@@@@@@
8
39 17 0
38 2 0
25 31 0
17 7 0
5 42 0
24 41 0
10 28 0
21 36 0

24 2 0
32 29 0
12 42 0
13 34 0
49 1 0
24 9 0
14 9 0
16 39 0
