width 50
height 50
@@...@@........@@@@...@@@@....@@@@@@@@@@@@@@@@@@@@
@@...............@@...@.......@@@@@@@@@@@@@@@@@@@@
@@........@......@@..........@@@@@@@@@@@@@@@@@@@@@
@@..................@.......@@@@@@@@@@@@@@@@@@@@@@
@...............@.....@.......@@@@@@@@@@@@@@@@@@@@
...@..........................@@@@@@@@@@@@@@@@@@@@
.........................@...@@@@@@@@@@@@@@@@@@@@@
.......@...........@@.......@@@@@@@@@@@@@@@@@@@@@@
............@...@@.@@@......@@@@@@@@@@@@@@@@@@@@@@
.........@..@......@....@@@@@@@@@@@@@@@@@@@@@@@@@@
...........@@....@......@@@@@@@@@@@@@@@@@@@@@@@@@@
......@....@..........@@@@@@@@@@@@@@@@@@@@@@@@@@@@
............@.....@....@@@@@@@@@@@@@@@@@@@@@@@@@@@
@...........@.....@......@@@@@@@@@@@@@@@@@@@@@@@@@
......................@..@@@@@@@@@@@@@@@@@@@@@@@@@
......@...............@..@@@@@@@@@@@@@@@@@@@@@@@@@
.......@.........@@...@@.@@@@@@@@@@@@@@@@@@@@@@@@@
.....@@@@@@@...............@@@@@@@@@@@@@@@@@@@@@@@
....@@..@@@@...............@@@@@@@@@@@@@@.@@@@@@..
...@.@..@.@@..@@@.......@@.@@@@@@@@@@@@@.....@.@..
..@@.........@@@@..@........@@@@@@@@@@@@.....@....
@.............@@@@...@@...@..@@@@@@@@@@@..........
@......@.............@@@.@@..@@@@@@@@@@..........@
@@.....@.@....@......@@@....@@@@@@@@@@@..........@
@@..........................@@@@@@@@@@....@......@
@@....@.....................@@.@@@@@@............@
@...............@@.......@..@..@@@@@@@...........@
................@.......@@..@..@@@@@@@......@....@
.......@..............@@@@..........@@@@..........
@@..@..@......@..@.....@@...........@@@...@.......
@@.....@.....@.......@.@............@.............
@@...............@@...@@@.@....@...............@..
@@....@@.........@....@@@@@.@.....................
@.....@@................................@@......@.
................................@........@........
..@.......@..@...........@..@............@........
@...@@......................@.........@@@@.@......
...@@@@....................@@@@....@..@@@@.@@@....
@....@.......................@.....@@@@@@@@@@@@@@@
.............................@.....@@@@@@@@@@@@@@@
.........@.@.................@@..@@@@@@@@@@@@@@@@@
..@.........................@@@@@@@@@@@@@@@@@@@@@@
@@@........................@@@@@@@@@@@@@@@@@@@@@@@
@@@...........@........@@..@@@@@@@@@@@@@@@@@@@@@@@
@.......@..@@@@@@......@@..@@@@@@@@@@@@@@@@@@@@@@@
......@..@@@@@@@.......@@@@@@@@@@@@@@@@@@@@@@@@@@@
.@@..@...@@@@@........@@@@@@@@@@@@@@@@@@@@@@@@@@@@
@@.......@@@@@.........@@@@@@@@@@@@@@@@@@@@@@@@@@@
@@.......@@@@@.........@@@@@@@@@@@@@@@@@@@@@@@@@@@
@@@@.@@@.@@@@@@.......@@@@@@@@@@@@@@@@@@@@@@@@@@@@
8
13 0 0
8 35 0
9 31 0
27 39 0
15 35 0
7 47 0
15 1 0
39 32 0

21 20 0
47 20 0
27 0 0
2 0 0
12 21 0
49 19 0
23 8 0
3 0 0
