width 26
height 26
@@@@@@@@....@@.....@......
@@@@@@@@..................
...@@@@@......@...@@......
.@...@@@@................@
.....@...................@
@....@@..@.............@@@
@@...@@.@@.............@@@
@....@@@@@.@@@..@.........
@....@@@@@@@@...@......@@@
.....@@@@@@@@...@@........
..@....@@@@@@.........@.@@
.@@......@...@.......@@@@@
@@@...@.@............@@@@@
@@@@@................@@@@@
@@@@@@......@@.......@@@@@
@@@@@@...@@@.........@@@@@
@@@@@@...@@@...@@....@@@@@
@@@@@@....@@...@....@@@@@@
@@@@@.....@.........@@@@@@
@@@@@.................@@@@
@@@@@..................@@@
@@@@@.......@@..........@@
@@@@@........@............
@@@@@.....................
@@@@@..@........@@@@@@@...
@@@@@@.@@@.....@@@@@@@@...
8
17 3 0
12 24 0
6 13 0
25 1 0
4 10 0
13 4 0
1 8 0
13 3 0

2 2 0
17 21 0
16 22 0
20 0 0
22 5 0
10 21 0
9 13 0
9 12 0
