width 26
height 26
@@@@@@@@@@@@@@@...@.......
@@@@@@@@@@@@@@@....@......
.@@@@@@@@@@@@@@@..........
....@@@@@@@@@@@@..........
.@..@@@@@@.@@@@@..........
@....@@@@@................
@....@@@@@....@@..........
@....@............@.......
.....@................@...
..@.......................
@.........@......@@.......
..........@.....@.@.....@.
..@.@.....@@@@@...........
............@@@...........
.........@@.@@@..........@
.........@@@@@@@...@.....@
.........@@@....@..@......
....@.@...@@@......@@.....
......@...@...............
......@@..................
@...@@@...................
@@.@@@@...................
@@@@@@....................
@@@@@.........@..@.....@@@
@@@@@@...........@......@@
@@@@@@@@@@@@@.@@........@@
8
13 23 0
18 20 0
21 4 0
14 16 0
15 24 0
6 7 0
12 21 0
3 11 0

24 0 0
1 3 0
20 16 0
2 3 0
22 3 0
22 12 0
22 21 0
15 10 0
