width 94
height 94
@@@@@@@@@@@@@@@@@@.@@....@@@......@@@...@@@@@@...@.@@....@@@..@@@@@@@@@@@.@@@@@........@@@@@@@
@@@@@@@@@@@@@@@@@...@....@....@@@@@@....@@@@@@.@@@............@@@@@@@@@@..@@..@..@@.....@@@@@@
@@@@@@@@@@@@@@@@...@@@........@@@@@@.....@@@@@..@@............@@@@@@@@@@................@@@@@@
@@@@@@@@@@@@.....@...@........@..@@@.....@@@@@..@@@...........@@@@@@@@@@@..............@@@@@@@
@@@@@@@@@@@@...........@........@@@@.....@@@@@..@@@@...........@@@@@@@@@@..........@@..@@@@@@@
@@@@@@@@@@@@@..@........@........@@@...................@@....@.@@@@@@@@@.....@@........@@@@@@@
@@@@@@@@@@@@@@...................@@..........................@@@@@@@@@@@.....@@.........@@@@@@
@@@@@@@@@@@@@@...................@@...................@.......@@@@@@@@@@@................@@@@@
@@@@@@@@@@.............@@.......@........@..........@@@.....@@@@@@@@@@@@@.................@@@@
@@@@@@@@............@...........@@@.....@...........@@........@@@@.@@@@@@............@..@....@
@@@@@@.@........@.@.............@@.@....@............@@.......@@....@@@@@@.........@.@.......@
@@@@@@............@.@..........@...@....@............................@@@@@..............@...@@
@@@@@@..@@@@...@.....@@@...................@..........................@@@@.....@..........@...
@@@@@....@.@........@@@@...@.@@@.........@........@@....@...@@@......@@@@@...@@@.....@........
@@@@@@..............@@@@@@@@...@@@@...............@@....@@@@@@@@@........@...@.@@.............
@@@@@@............@.@@@@@@@@......................@....@@@@@@@@@@..............@....@@@.......
@@@@@@@........@....@@@@@@@@@..................@@......@@@@@@@@@.................@@@@@@.......
@@@@@@@@.....@......@@@@@...@...@..........@...........@.@@@@@..................@@@@@@@....@..
@@@@@..........@...@@@@@@.@@@.........@...@.....@@@......@@@@@........@....@....@@@@@@@...@...
@@@@@..............@@@@@@..@....................@@......@@@@........@...........@@@@@@@...@@.@
@@@@.......@........@@........@@........................@@@@@...................@@@@@@@@@@@@@@
@@@@@......@....@....@....@.......@.......................@@@...........@.......@@@@@@@@@@@@@@
@@@@@......@@@@@@....@@...@......@@...................@....@@.....@............@@@@@@@@@@@@@@@
@@@@@....@@@@@.....@.............................@@@..@@........@..............@@@@@@@@@@@@@@@
@@@@...................@.............@...........@@@@..@................@.........@@@@@@@@@@@@
@.@.......................................@......@.@@...................@@@.......@@@@@@@@@@@@
@.........................@........@@....@.....@.@.......................@@...@@@@@@@@@@@@@@@@
@...........@..@...@@.....@..@.....@@....@@...@@@@.............@@........@@@.@@@@@@@@@@@@@@@@@
@@@........@...@.................@.@@..@.@@.@@@@@...................@....@@..@@@@@@@@@@@@@@@@@
@@@........................@@......@@..@@@@@@@@@@@.....@.................@@..@@@@@@@@@@@@@@@@@
@@..@...................@.......@.......@@@@@@@@@........................@@..@@@@@@@@@@@@@@@@@
@@@@@.....@.................@@....@.....@@@@@@@.....@...@@@..................@@@@@@@@@@....@@@
...@.............@...@......@@.@...........@@@@@@@@@....@@@................@@@@@@@@@@@@...@@@@
................@@@@....@..@@@@@.@@..........@...@.@...............@.......@@@@@@@@@@@@...@@@@
........@...@..@@@@@........@@@@@@@.........@................................@@@@@@@@@@....@@@
..@..@.........@@@@@..@@@@@@@@@@@@.............@.@......@@@...........@.....@@@@@@@@@@@@...@@@
.@@......@...@.@@@@@@@@@@@@@@@@@@@@@@@....@.............@@@........@........@@@@@@@@@@....@@@@
@@@@.........@.@@@@@@@@@@@@@@@@@@@@@@@@@@@@..............@@......@@@..@..@..@@@@@@@@@@@...@@@.
@@@@@@.....@@@@@@@...@@@@@@@@@@@@@@@@@@@@@@...@..........@@.@.....@@......@@@@@@@@@@@@@...@...
@@@@@@.@...@@@@@@@...@.@@@@@@@@@@@@@@@@@@@@@.@@...@.........@.....@@......@@@@@@@@@@@@........
@@@@@@.......@@@@@.....@@@@@@@@@@@@@@@@@@@@...@.............@@@..........@.@@@@@@@............
@@@@@......@.@@@......@@@@@@@@@@@@@@@@@@@@....@.@...........@@@.............@@@@@@........@...
@@@@................@@@@@@@@@@@@@@@@@@@@@@.................@@@@@............@@@...........@...
@@@@@@.......@......@@@@@@@@@@@@@@@@@@@@@@......@.........@@@@@@.....@........................
.@@@@@..............@@@@@@@@@@@@@@@@@@@@@@.....@@@.........@@@@@@.........@@................@.
..@@@@..........@.....@@...@@@@@@.@@@@@@@@.....@........@..@@@@@..@....@...@.............@@@@@
...@@@@@........@@..........@@@@...@@@@@@.......@@.@@@@@@..@@@@@@.....@...................@@@@
.@.............@.............@@@..@@@@@@........@@@@@@@@@@@@@@@@..........................@@@@
...............@....................@@.........@@@@@@@@@@@@@@@@...........@@..............@@@@
...@...........@@@....@.......@@....@..........@@@@@@@@@@@@@@@@....@@..@.....@@............@@@
@......@........@@................................@@@@@@@@@@@@@.......@@.....@@........@...@@@
.....@.@.@....................@@@..................@@@@@@@@@@@@@@.............................
....@....@@........................@.@@.@.......@.@@@@@@@@@@@@@@@@@...................@.@@....
..........@..........@.........@.....@@.............@@.@@@@@@@@@.@@......@@..@........@@@@....
..........@@.........@.........@.....@@..................@@@@@@@.@@.........@@........@@@@...@
.....@@........@.....@...............@...@................@@@@..............@@@@.....@@@@@@...
@.@..................@.@........@....@@.@@@.@..............@@@.........@..@.@@@..........@@@..
@@@.................@@.@@................@@................@@..@..........@@@@@..............@
@@@@@...@..@.......................@.....@@..............@@.................................@@
@@@@@..@@@@@...........@...............@.................@...........................@........
@@@@@..@@@@@..@........@..@@@.........@.........@.............@..........................@@@@@
@@@@....@@@@@..........@.@@@..........@..........................................@.@.....@@@@@
@@@.....@@@@@@.@..@.@@.@@@@..@@@....@@..........................@...................@....@@@@@
@@@....@@@@@@@.@@......@@@@..@@@.........................................................@@@@@
.......@@.@@...@@.........@@@@@@@@.........................@.@...............@...........@@@@@
..........@@@@............@@@@@@@..........................@...@............@@.............@@@
....@@....@@@@..........@@@@@@@@@..................@.......@..............@@@@@@.@@.........@@
...@@@.............@@..@@@@@@@@@@........................@@@..............@@.@@..........@@.@@
@..@@@@............@......@@@@@@@.........@.....@............................@@@@....@......@@
@@@@@@...........@.........@@.@@@@...@@.......@..............@....@................@........@@
@@@..................@@...@....@@@............@...@.....................@@..................@@
@@@.............................@@...@........@.......................@@@...................@@
@@@@@......@....@@..........@.......@@@@.....@@........@.@....................................
@@@@@@.........@@@...................@@@............@.........@@@@@@@....................@....
@@@@@@.........@@@@....@@..@...........@.......................@@@@.................@....@@...
@@@@@...........@@@.@.@@@@.................@@@........@.......@@@@@........@....@@..@...@@@...
@@@@@............@@@@@@@@@@.....@@@@@@.......@.........@......@@@@.....@@......@..............
@@@@@....@@@........@@.@@@@......@....@......@.....@.......@............@...........@@.@......
@@@@@....@@@@@@@....@............@.................@.@..............................@@........
@@@@@...@@@@@@@@....@............@.................@.@@..................@@..........@.......@
@@@@@....@@.....................@.@..@..@............@............@.......@...@......@.......@
@@@@@....@........................@...@@@......@@...........................@@@@....@......@@@
@@@@@...................@............@@@@@@..@@@...........@@.......@@.........@...........@@@
@@@...........@.....................@@@@@@@..@@@.@........@@@.....@@@............@........@@@@
......@................................@.....@@@@@@@..@....@@.........@...@@.........@@@..@@..
.....@@.........................@@@.@@@@........@@@@........@.............@@.........@@@@.....
.....@@@@@@..........@........@@@....@@@@....@@@@@@@................@........@.........@@@...@
@@@..@..@@@@.............@@.........@@@@@@....@@@@@@...............@.................@@.......
@@@..@..................@@@........@@@@@.@@....@@@@@.........@@....@@.....@..........@@.......
@@..@@................@...@.........@@@...@.....@@@@...@...@@@.....@@....@......@@@@.......@@@
.........@..........@@@...@...@@....@@@@..@..........................@.......@@.@@@...@..@@@@@
......@.............@@@.@@@...@@@...@@@...........................@@@@..........@@......@@@@@@
....@.......@.@@@...@@@.@@@@@@@@@@..@@@.............@.............@@@@@..............@.@@@@@@@
@@@@@......@@@@@@@@@@@@@@@@@@@@@@@..@@@@@...........@.@@@.......@@@@@@......@@@..@......@@@@@@
8
12 18 0
56 17 0
13 60 0
62 18 0
10 70 0
69 40 0
54 28 0
9 70 0

77 1 0
69 16 0
6 31 0
18 23 0
64 32 0
10 90 0
55 66 0
57 41 0
