width 94
height 94
@@@...@@@@@@@@..@.......@@@.....@..@@@@.......@@.....@@@@@@@@@@@@@@@@@@@@@@@@@@@@@@@@@@@@@@@@@
@@....@@@@@@@@....@...@..@...@......@@...........@...@...@@@@@@@@@@@@@@@@@@@@@@@@@@@@@@@@@@@@@
@......@@@@@@@...@............................@@@@......@@@@@@@@@@@@@@@@@@@@@@@@@@@@@@@@@@@@@@
.............................@.............@..@@@@......@@@@@@@@@@@@@@@@@@@@@@@@@@@@@@@@@@@@@@
......@......................@......@@.........@@@...@...@@@@@@@@@@@@@@@@@@@@@@@@@@@@@@@@@@@@@
...@@@@@.....@....@@.............................@.......@@@@@@@@@@@@@@@@@@@@@@@@@@@@@@@@@@@@@
...@@@@......@.@..@............@......@@@................@@@@@@@@@@@@@@@@@@@@@@@@@@@@@@@@@@@@@
...@@@@@@....@................@@@.....@@@....@.....@@@...@@@@@@@@@@@@@@@@@@@@@@@@@@@@@@@@@@@@@
@@@@@@@@@@@...@@@@.@...........@......@@@.......@....@....@@@@@@@@@@@@@@@@@@@@@@@@@@@@@@@@@@@@
@@@@@@@@@@@@@@@@@@@@@@..........................@@...@..@.@@@@@@@@@@@@@@@@@@@@@@@@@@@@@@@@@@@@
@@@@@@@@@@@@@@@@@@@@@@@....@@@.............................@@@@@@.@@..@@@@@@.@.@@@@@@@@@@@@@@@
@@@@@@@@@@@@@@@@@@@@@@@@...........@....@@.................@@@..........@@......@@@@@@@@@@@@@@
@@@@@@@@@@@@@@@@@@@@@@@@@@...@........@@@@.....@........................@@......@@@@@@@@@@@@@@
@@@@@@@@@@@@@@@@@@@@@@@@@@..@@..........@......@...............@@......@@@....@@@@@@@@@@@@@@@@
@@@@@@@@@@@@@@@@@@@@@@@@....@@........................@................@@@.@..@@@@@@@@.@@@@@@@
@@@@@@@@@@@@@@@@@@@@@@@@............@..........@...........................@...@@@@@.....@@@@@
@@@@@@@@@@@@@@@@@@@@@@@@@@.........@@........................@...........@@@...@........@@@@@@
@@@@@@@@@@@@@@@@@@@@@@@@@@...@....@@@...@@.......@.........@@@.....@....@@@@.......@..@.@@@@@@
@@@@@@@@@@@@@@@@@@@@@@@@@@@..@....@@@...@@.......@.@.....@@@@.............................@@@@
@@@@@@@@@@@@@@@@@@@@@@@@@@@.......@@.................@..@@@@@@...........@...................@
@@@@@@@@@@@@@@@@@@@@@@@@@@@.@@..........................@@@@@@@.......@..@@......@............
@@@@@@@@@@@@@@@@@@@@@@@@@@@@@@...........................@@@@@@@.....@@..@..................@@
@@@@@@@@@@@@@@@@@@@@@@@@@@..............................@@@@@@@......@...@..................@@
@@@@@@@@@@@@@@@@@@@@@................@@..................@....@.....@@...........@............
@@@@@@@@@@@@@@@@@@@@@........@...........@....................................................
@@@@@@@@@@@@@@@@@@@@@.@.................@@@@@@.....@......@@@@.....................@@@........
@@@@@@@@@@@@@@@@@@@@@...@@@.............@@..@@.....@...@....@@......................@@@@@.@...
@@@@@@@@@@@@@@@@@@@@@....@..............@@...................@................@.......@@@@@@@.
@@@@@@@@@@@@@@@@@@@@@........................................@................@@....@@@@@@@@@@
@@@@@@@@@@@@@@@@@@@@......@.........@.........@@.......................@......@@@@@.@@@@@@@@@@
@@@@@@@@@@@@@@@@@@@@@..@@@..................@@@@................@@..@@.@....@.@@@...@....@@@@.
@@@@@@@@@@@@@@@@@@@@@.....@..........@@.....@@@.@.......@...................@@@@@........@....
@@@@@@@@@@@@@@@@@@@@@.................@.................@@.......@@.........@@@.........@.....
@@@@@@@@@@@@@@@@@@@@@.....@@@....@....@..........@...............@......@@@..@@..@@.@.........
..@.@@@@@@@@@@@@@@........@@....@....@..................................@@...@@@@@@...........
.....@@@@@@@@@@@@@........@@....@.........@@.........@..@@@@...........@....@@@@@@..........@.
.......@@@@@@@@@@@........@@.@@@@.........@@@@.......@@@@@@...@@.....@.@......@@.....@@@....@@
......@@@@@@@@@@.@.@......@@.@@@@@.....@@@@@@@@...@@@@@@@@@@..@@@@@..@........@@............@@
.......@@@@@@@@@.@..@@........@@.......@@@@@@.....@@@@@@@@@@@@@@@@.....@.................@....
.......@@@@@@@@@.@@...........@......@@@@@@@.....@@@@@@@@@@@@@@@@........................@....
............@@@@............@........@@@@@@@@@...@@@@@@@@@@@@...@...@..@@................@....
..........@.@@@......................@@@@@@@@@.......@@@@@@@@......@..........................
.......@..@.@@@..@....................@@@@@@@..........@@@@@@@....................@........@@@
................@@@...@....@.......@@.....@.................@@.@.........@@...@...@@......@@@@
..@..............@@.......@@.....@@@@@...@@......@.......................@@...@........@@@@@@@
...........@.............@....@@.@............@.........................@@@............@@@@@@@
.......@...@..@.....................@@@.................................@@@.......@.....@@@@@@
..@.....................@...........@@@@..@....................@....@..........@......@@@@@@@@
..@....@.................@@.........@@@@...@....@@......@.......@.........@.........@@@@@@@@@@
.......@...............@@@@@@......@@@@.........@....................................@@@@@@@@@
..@...@@................@@@@.........@...............@...............@...............@@@@@@@@@
@.@@@@@@................@@@@........................@............................@@@@@@@@@@@@@
@...@@@.................@@@@.@........@.............@...............@............@@@@@@@@@@@@@
@@@.@@@@...@............@@@@@@.@@@@@..@...@@........@.........@......@@@@.....@..@@@@@@@@@@@@@
@@@@@@@@@......@.........@@@@@@@@@@@@@.............@@.......@@.......@@@......@...@@@@@@@@@@@@
@@@@@@@@@@...............@@@@@@@@@@@@@................................@@......@.....@@@@@@@@@@
@@@@@@@@@@...............@@@@@@@@@@@...@@..............@............................@@@@@@@@@@
@@@@@@@@@@@..@.......@....@@@@@@@@@@@..@@..............@@@....@@.........@@........@@@@@@@@@@@
@@@@@@@@@............@...@@@@@.@@@@....@@........@@...@@....@.@....................@@@@@@@@@@@
@@@@@@@@@.................@@@..@@..@..............................................@@@@@@@@@@@@
@@@@@@@@@@@................@..................................@@@.............@...@@@@@@@@@@@@
@@@@@@@@@@@@......@............@..................@@...................@..@...@....@@@@@@@@@@@
@@@@@@@@@@@@@.@@...............@..............@@@@@...............................@@@@@@@@@@@@
@@@@@@@@@@@@@......................@......@@@@@@@@@@..............................@@@@@@@@@@@@
@@@@@@@@@@@@@...........@.@...............@@@@@@@@@@...@..........@@......@............@@@@@@@
@@@@@@@@@@@@@@.........@@@..........@.....@@@@@@@@@@@...................................@@@@@@
@@@@@@@@@@@@@@.@@..@.@@@@....@.....@@..@@..@.@@@@@@.....................................@@@@@@
@@@@@@@@@@@@@@@@@@@@@@@@@@.........@...@@.....@@@@@........@@@....................@......@@@@@
@@@@@@@@@@@@@@@@@@@@@@@@@@@@..................@@@@@......@@...........@@@@@.......@......@@@@@
@@@@@@@@@@@@@@@@@@@@@@@@@.....................@@@@..................@.@..............@.@@@@@@@
@@@@@@@@@@@@@@@@@@@@@@@@@.........@...@........@@@@......................................@@@@@
@@@@@@@@@@@@@@@@@@@@@@@@@..@@........@...@.@@@.@@...@...............@@............@......@@@@@
@@@@@@@@@@@@@@@@@@@@@@@@@.@@@@@@.@...........@.....@@.....@..................@.......@...@@@@@
@@@@@@@@@@@@@@@@@@@@@@@@@@@@@@@@@@............@...........@................................@@@
@@@@@@@@@@@@@@@@@@@@@@@@@@@@@@@@@.....................................................@@@..@@@
@@@@@@@@@@@@@@@@@@@@@@@@@@@@@@@@@......................................@....@@.............@@@
@@@@@@@@@@@@@@@@@@@@@@@@@@@@@@@@@@@.............@........................@..@@@@..........@@@@
@@@@@@@@@@@@@@@@@@@@@@@@@@@@@@@@@@@@@@@...@................................@@@@...@@....@.@@@@
@@@@@@@@@@@@@@@@@@@@@@@@@@@@@@@@@@@@@@@@..@.............@...@.........@..@@@@@....@........@@@
@@@@@@@@@@@@@@@@@@@@@@@@@@@@@@@@@@@@@@@@@@@........@.....................@@@@@@...........@@@@
@@@@@@@@@@@@@@@@@@@@@@@@@@@@@@@@@@@@@@@@@@@........@............@..@..@..@@@@@............@@@@
@@@@@@@@@@@@@@@@@@@@@@@@@@@@@@@@@@@@@@@@@..........@............@..@@...@@@@@.........@..@@@@@
@@@@@@@@@@@@@@@@@@@@@@@@@@@@@@@@@@@@@@@@@@.@@.....@@@@..........@@@@@.......@.........@@@@@@@@
@@@@@@@@@@@@@@@@@@@@@@@@@@@@@@@@@@@@@..............@..........@...@@@@...........@...@@@@@@@@@
@@@@@@@@@@@@@@@@@@@@@@@@@@@@@@@@@@@@@....@@.@......@..............@..@.............@@@@@@@@@@@
@@@@@@@@@@@@@@@@@@@@@@@@@@.@@@@@@@@@.....@@..@.........@@@@@@@....@.@..............@@@@@@@@@@@
@@@@@@@@@@@@@@@@@@@@@@@@.@..@@@@@..@...@..@@...........@@@@@@@..........@@........@@@@@@@@@@@@
@@@@@@@@@@@@@@@@@@@@@........@@@..........@..............@..@@@.........@@.....@@@@@@@@@@@@@@@
@@@@@@@@@@@@@@@@@@@@@.......@.....@...........@................................@@@@@@@@@@@@@@@
@@@@@@@@@@@@@@@@@@@@@@..................................................@@......@@@@@@@@@@@@@@
@@@@@@@@@@@@@@@@@@@@@@@@.........@...........@...........@...........@@@@...@...@@@@@@@@@@@@@@
@@@@@@@@@@@@@@@@@@@@@@@@@....@.@@@@....@...........@@.......@....@...@@@@.......@@@@@@@@@@@@@@
@@@@@@@@@@@@@@@@@@@@@@@@@@@@@@@@@@@@..............@@@@................@@@.....@.@@@@@@@@@@@@@@
@@@@@@@@@@@@@@@@@@@@@@@@@@@@@@@@@@@@.@@@.......@..@@@@@@@@@@.....@....@@@@....@@@@@@@@@@@@@@@@
8
56 84 0
12 46 0
46 39 0
42 2 0
32 12 0
43 28 0
19 34 0
73 39 0

25 6 0
38 36 0
35 29 0
38 66 0
79 55 0
56 24 0
34 26 0
9 51 0
