width 94
height 94
@@@@@@@@@@@@@@@@..@@@@@@@@...@@@@@@@@@@@@@@@@@@@@@@@@@@@@@@@@@@@@@@@@@@@@@@@@@@@@@@@@@@@@@@@@@
@@@@@@@@@@@@@@@......@@@@@...@@@@@@@@@@@@@@@@@@@@@@@@@@@@@@@@@@@@@@@@@@@@@@@@@@@@@@@@@@@@@@@@@
@@@@@@@@@@@@@@@......@@@@....@@@@@@@@@@@@@@@@@@@@@@@@@@@@@@@@@@@@@@@@@@@@@@@@@@@@@@@@@@@@@@@@@
@@@@@@@@@@@@@@@....@.@@@.....@@@@@@@@@@@@@@@@@@@@@@@@@@@@@@@@@@@@@@@@@@@@@@@@@@@@@@@@@@@@@@@@@
@@@@@@@@@@@@@@@...@@.@..........@@..@@@@@@@@@@@@@@@@@@@@@@@@@@@@@@@@@@@@@@@@@@@@@@@@@@@@@@@@@@
@@..@@@@@@...............@..........@@@@@@@@@@@@@@@@@@@@@@@@@@@@@@@@@@@@@@@@@@@@@@@@@@@@@@@@@@
....@@@@@................@....@@@@@....@@@@@@@@@@@@@@@@@@@@@@@@@@@@@@@@@@@@@@@@@@@@@@@@@@@@@@@
....@@@@@................@....@@@......@@@@@@@@@@@@@@@@@@@@@@@@@@@@@@@@@@@@@@@@@@@@@@@@@@@@@@@
......@........@........@@.............@@@@@@@@@@@@@@@@@@@@@@@@@@@@@@@@@@@@@@@@@@@@@@@@@@@@@@@
........@......@.........@.....@..@......@@@@@@@@@@@@@@@@@@@@@@@@@@@@@@@@@@@@@@@@@@@@@@@@@@@@@
....@.......@..@@.........@.....@@@....@@@@@@@@@@@@@@@@@@@@@@@@@@@@@@@@@@@@@@@@@@@@@@@@@@@@@@@
@.............................@@@@@....@..@@@@@@@@@@@@@@@@@@@@@@@@@@@@@@@@@@@@@@@@@@@@@@@@@@@@
@.........................@@@@@@@@.....@..@@@@@@@@@@@@@@@@@@@@@@@@@@@@@@@@@@@@@@@@@@@@@@@@@@@@
@............@.....@@.....@@@@@@@@@..@.......@@@@@@@@@@@@@@@@@@@@@@@@@@@@@@@@@@@@@@@@@@@@@@@@@
@@..............@...@@@@...@@@@@@@@..........@@@@@@@@@@@@@@@@@@@@@@@@@@@@@@@@@@@@@@@@@@@@@@@@@
@.............@@@...@@.....@@@@@@@............@@@@@@@@@@@@@@@@@@@@@@@@@@@@@@@@@@@@@@@@@@@@@@@@
@.....@.@...............@@@@@@@@..............@@@@@@@@@@@@@@@@@@@@@@@@@@@@@@@@@@@@@@@@@@@@@@@@
@.....@................@@@@@@@................@@@@@@@@@@@@@@@@@@@@@@@@@@@@@@@@@@@@@@@@@@@@@@@@
.....@@............@....@@@@@@..@@@..........@@@@.@@.@@@@@@@@@@@@@@@@@@@@@@@@@@@@@@@@@@@@@@@@@
..........................@@....@.......@@...@@@@.....@@@@@@@@@@@@@@@@@@@@@@@@@@@@@@@@@@@@@@@@
.......@@..........@......@@@......@...@@.@....@@.....@@@@@@@@@@@@@@@@@@@@@@@@@@@@@@@@@@@@@@@@
.....@.@@..........@@..............@......@...@@@..@@@@@@@@@@@@@@@@@@@@@@@@@@@@@@@@@@@@@@@@@@@
...@@@..@.@........@.............@.................@@@@@@@@@@@@@@@@@@@@@@@@@@@@@@@@@@@@@@@@@@@
.@...@....@........@............@...@..............@@@@@@@@@@@@@@@@@@@@@@@@@@@@@@@@@@@@@@@@@@@
...............@@@@@@...................................@@@@@@@@@@@@@@@@@@@@@@@@@@@@@@@@@@@@@@
..............@@@@@@@................................@@@@@@@@@@@@@@@@@@@@@@@@@@@@@@@@@@@@@@@@@
..@@@.@.@.......@@@@@..............................@@@@@@@@@@@@@@@@@@@@@@@@@@@@@@@@@@@@@@@@@@@
.@@...............@@@@.............................@@@@@@@@@@@@@@@@@@@@@@@@@@@@@@@@@@@@@@@@@@@
@@@@@@...........@@@@@....................@.......@@@@@@@@@@@@@@@@@@@@@@@@@@@@@@@@@@@@@@@@@@@@
@@@@@@@......@..@.@@@@...@.@....................@@@@@@@@@@@@@@@@@@@@@@@@@@@@@@@@@@@@@@@@@@@@@@
@@@@@@@@....@@....@.@@@....@@@@@................@@@@@@@@@@@@@@@@@@@@@@@...@@@@@@@@@@@@@@@@@@@@
@@@@@@@@@@.................@@@@@................@@@@@@@@@@@@@@@@@@@@@@@.......@@@@@@@@@@@@@@@@
@@@@@@.@.......@............@@@................@@@@@.@@@@@@@@@@@@@@@@@........@@@@@@@@@@@@@@@@
@@@@@......................@@@@.@@.............@@@@..@@@@@@@@@@@@@@@@@...@@...@@@@@@@@@@@@@@@@
@@@@@......@....@..........@@@@@@@......................@@@@@@@@@@@@@......@...@@@@@@@@@@@@@@@
@@@@@@.....@..........@.....@@@@...................@....@@@@@@@@@@@@@@.....@...@@@@@@@@@@@@@@@
@@@@@@@.......@.............@@@@@.................@@...@@@@@@@@@@@@@...........@@@.@@@@@@@@@@@
@@@@@@@@...@..................@@@.......@@........@....@@@@@@@@@@@@@...............@@...@@@@@.
@@@@@@@@@.....@.....@@@.......@@@.......@@.....@@.......@@@@@@@@@@@@......@........@..........
@@@@@@@@@.....@@@..@@@@.......@@@......@@@.......@...@..@@@@@@@@@@@@@.............@.........@@
@@@@@@@@@.@.@@@@@...........................@@..........@@@@@@@@@@@@@.......@.........@.......
@@@@@@@@@@@@@@@@@....................@@................@@@@@@@@@@@@........@...........@......
@@@@@@@@@@@@@@@@..@....@@............@@....@...@...@.....@@@@@@..@..................@@.@.@.@..
@@@@@@@@@@@@@@@@@..@...@@..@@......................@.......@.............@...........@..@@@...
@@@@@@@@@@@@@@@@@...@...@..................@@.......@...........@.......@@...............@...@
@@@@@@@@@@@@@@@@.....@..@........@@.........@.........@.........@@@....@@@....@@...........@@@
@@@@@@@@@@@@@@@@..@.....@@...@...@@.........@.......@.............@....@@......@@.........@@@@
@@@@@@@@@@@.@@@@@@.......@@.....@@@@...............................@..@@@@...............@@@@@
@.@@@.....@.@@@@@@@@.....@@.@...@@@@@@........@...........@@@.........@@@@.........@.....@@@@@
..@.@.........@@@@@@.....@@@@..@@@@@@@......@....@@.........@@.....@.....@..@....@@.......@@@@
..........@...@..........@@@@@@@@@@@@@@@@..@....@.@@@.......@@...........@........@@....@..@@@
......................@..@@@@@@@@@@@@@@@@@@@@.@...@@@@@@..@@@.......................@@.....@@@
......................@.@@@@@@@@@@@@@@@@@@@@@.....@@@@@@@@@@@@......................@@.....@..
...........................@@@@@@@@@@@@@@@@@@..@..@@@@@@@@@@@.........@@....@@.....@@.........
...........................@@@@@@@@@@@@@@@@@@....@@@@@@@@@@@@@@@.....@@@............@.........
........@.............@@@@@@@@@@@@@@@@@@@@@@@@...@@@@@@@@@@@@@@......@@.......................
...@...........@.......@@@@@@@@@@@@@@@@@@@@......@@@@@@@@@@@@......@@@@........@@.............
.........@..............@@@@@@@@@@@@@.@@@........@@@@@@@@@@@@......@@@@.@...@@.@..............
.........@@.@......@@.....@@@@@@@@@...@@@........@@@@@@@@@@@@........@.........@.@@...........
.........@@...............@@@@@@@@@...@@@........@@@@@@@@.......@.@@.......@..................
.....@.........@...@......@@@@..@@.....@@@...@.@@@@@@@@@@.........@@......@@......@@@@@@@@..@@
...........@@..@.................@.......@..@@@@@@@@@@@@@..........@@@@@@.@@@.@@..@@@@@@@@@@@@
.............................@@............@@@@@@@@@@@@@@...........@@........@@..@@@@@@@@@@@@
.........................@..@@@@@@@.......@@@@@@@@@@@@.@@.................@........@@@@@@@@@@@
..@..........................@@@@@@.....@@@@@@@@@@@@@..@@..@..@.@.@.................@@@@@@@@@@
@@@@.............@..@........@@@........@@@@...@@..@@................@.....@@....@..@@@@@@@@@@
@@@@....@@.........@@@.......@@@@@@@........................@.......................@@@@@@@@@@
@@@@@@........@...@@@@@.....@@@@@@@@............@.....@............................@@@@@@@@@@@
@@@@..........@.@.@.........@@@@@@@@.......@.............@....@....................@@@@@@@@@@@
.@@.............@.@..........@..................@...@..............................@@@@@@@@@@@
.............@@@@..............................@@...@........@....@.........@@......@@@@@@@@@@
.....................@...........@.....@@....@..@...@....@@@@@@............@@........@@@@@@@@@
..........@.........@@.........@.............@...............@@...@........@@@.......@@@@@@@@@
...............................@@..........@....@..........................@@@.......@@@@@@@@@
...@..................@...@...@@@.....@.........@..........................@@@@...@..@@@@@@@@@
.................@.....@@.@..@@@@..@.@@...@..@................................@@.....@@@@@@@@@
..........................@..@@@...@..............@..........@..@..@...................@@..@@@
...........@..........@...@..@...........@@@.............................@....@.......@@@..@@@
................@.........................@@...........................................@@..@@@
.@.............@@..........@..............@@...............@@...............................@@
@@@.@..................@..@@@...................................................@...........@@
@@@@...@.........@........@@@....................@...............@..........................@@
@@@@@...@@....@............@@....@@@..........@..................@@...................@@...@@@
@@@@@.........@..@@.......@@@@@@@@@@......................................@@@......@@@@@..@@@@
@@@@@@....................@@@@@@@..@@......@...@@.............@.............@@....@@@@@@@.....
@@@@@@...................@@@@@@@...................................@........@@.@@.@@..@@......
@@@@@@@...........@@@.@@..@@@@@............................@...............@@@@@@.....@@......
@@@@@@....@................@@@@...@@@.........@@@@@@..............@..@.....@@@@......@........
@@@@@@@....................@@@@@@@@@@.....@.@@@@@@@@@@@@..........@@.......@@@@.....@.......@.
@@@@@......................@@@@@@@@@@@@..@@@@@@@@@@@@@@........@@@@@@@.@............@.........
@@@@@@....@..........@....@@@@@@@@@@@@@@@@@@@@@@@@@@@@........@@@@@@@@....@...................
@@@@@@..............@......@@@@@@@@@@@@@@@@@@@@@@@@@@@........@@@@@@@@........................
@@@@@@@@..........@@......@@@@@@@@@@@@@@@@@@@@@@@@@@@@.@@@@..@@@@@@@@@.........@..@...........
@@@@@@@@..........@@.....@@@@@@@@@@@@@@@@@@@@@@@@@@@@@@@@@@.@@@@@@@@@@@..@@@@.@@@@@@@@...@....
8
14 37 0
49 77 0
53 41 0
52 76 0
23 23 0
74 31 0
67 80 0
33 42 0

28 37 0
1 8 0
31 46 0
55 43 0
15 62 0
8 93 0
68 84 0
89 87 0
