width 94
height 94
.......@@@@@@@@@@@..@.....@.......@.............@@@@@@@@@@@@@@@@@@@@@@@@@@@@@@@@@@@@@@@@@@@@@@
.....@@@@@@@@@@@@@...............@@..............@@@@@@@@@@@@@@@@@@@@@@@@@@@@@@@@@@@@@@@@@@@@@
.@...@@@@@@@@@@.....................@..........@@@@@@@@@@@@@@@@@@@@@@@@@@@@@@@@@@@@@@@@@@@@@@@
.....@@@@@..@@@........@@........................@@@@@@@@@@@@@@@@@@@@@@@@@@@@@@@@@@@@@@@@@@@@@
......@@@@......@@...@..@@.......................@@@@@@@@@@@@@@@@@@@@@@@@@@@@@@@@@@@@@@@@@@@@@
.......@@.......@@@.....@@@@....@......@.........@@@@@@@@@@@@@@@@@@@@@@@@@@@@@@@@@@@@@@@@@@@@@
.....@.@........@@@...@@@@@@...........@@...@@@@@@@@@@@@@@..@@@@@@@@@@@@@@@@@@@@@@@@@@@@@@@@@@
.@.......@.@.....@@....@....................@@@@@@@@@@@@@@..@@@@@....@@@@@@@@@@@@@@@@@@@@@@@@@
...............@@@@@..................@@@@...@@@@@@@@@@@@@....@.......@@@@@@@@@@@@@@@@@@@@@@@@
@......@.@.........@...................@@..@@@@@@@@@@@@@@@............@@@@@@@@@@@@@@@@@@@@@@@@
...................@.....@............@.......@@@.@@@@@@@@.............@@@@@@@@@@@@@@@@@@@@@@@
@..@@.......@..............@@@@........@...........@@@@@@..............@@@@.@@@@@@@@@@@@@@@@@@
@@@@@.......@..................@....@....@@@.........@@...@..............@@..@@@@@@@@@@...@@@@
@@@@.............@.............@.......@@@@....@..@..@..@.........@@......@.@@@@@@@@@@@@...@@@
@@@@........@..................@....@..@@@@@.........@.........@.......@@...@@@@@@@@@@@@@..@@@
@........@..@...........@.................@@@...@....@........@.............@.@@..@..........@
..........@........@......................@@..@@@...........@.............................@..@
............@..@.........@...............@@@.@@@@..................@...........@@...........@@
@..........@@.......................@....@@@@@@@.............@......@..........@@............@
..........@.@...........@................@@@@@@@.............@...@@.@@@@..@...@@@@............
...............@@..........@.............@@@@@@@@@...@@.....@....@.............@.....@...@..@@
.........@......@..................@....@@@@@@...@..@@@@...@@@@....@.................@@..@@@@@
........@@.@...........................@@@@@@@......@@.....@@@@....@.........@.....@..@..@@@@@
........@@.........@@@................@@@..@@...@@.........@@@@.......................@...@@@@
........@@....@....@@@..@.....@..@....@...@@@...............@@@@@.....................@....@@@
.@@.......@......................@@.....@@@@@.@.....@@@....@@..@....@@.....................@@@
................@@@...@..........@@@....@..........@@@@@...@@.@@@.@@@@..@..................@@@
................@@....@@@@@@.......................@@@@@@...@...@@@@@@@.....................@@
..........@...........@@@@@@..................@@...@@@@@@.......@@@@@@@..................@@.@@
......@..............@@@@@@@..........@@@@....@@@@@@@@@@@@.........@@........@.@.........@@@@@
......@...............@@@@@@..........@@@@@@..@@@@@@@@@@@@..............................@@@@@@
.@...........@........@@@@@@............@@@@@@@@@@@@@@@@@@........................@.....@@@@@@
@@..@........@.......@@@@@@@@..........@@@..@@@@@@@@@@.@@....@...................@@.....@@@@@@
@@..@....@..........@@@@.@@@...@@@@@.....@..@@@@@@@@@@..@........................@@..@.@@@@@@@
@@..................@@@....@...@.@@.........@@@@@@@@@@.....@....@........@@@.....@...@@@@@@@@@
@@.@..........@@.@.........@...@.@......@@@@@@@@@@@@@@.....@...........@@@@@.........@@@@@@@@@
@@...........@@@@@.............@..........@..@@@@@@@@@...........@...@@@@@@@.........@@@@@@@@@
@..........@.@@@@@....@@@@...................@@@@@@@@.................@@@@@..@@@..@....@@@@@@@
...........@.@@@@@...@@@@...............@....@@@@@@@@....@....@..@....@@@....@@.........@@@@@@
......@.......@@@@...@@@@....................@@@@@@@@@@@@@....@..........@.............@@@@@@@
...........@@@@@@@...@@@@....@................@@@@@@@@@@@@.....@......@....@...........@@@@@@@
...........@@@@@@@....@@@........@....@.......@@@@@@@@@@@@....@@@@@@.................@@@@@@@@@
...........@@@@@@@.....@@....................@@@@@@@@@@@@@......@@@@................@@@@.@@@@@
..@....@@@@@@@@@@......@@......@.............@@@@@@@@@@@@@....@@@@@@@..............@@@@@.@@@@@
.....@@@@@@@@@@@@@....@@@@@@.....@@@.@.@@@@@@@@@@@@@@@@@@@@@@@@@@@@@@......@@..@@@@@@@@..@@@@@
..@.@@@@@@@@@@@@@......@@@@@.........@.@@@@@@@@@@@@@@@@@@@@@@@@@@@@@@....@........@@........@@
.....@@@@@@@@@@.....@@@@@@@@...........@@@@@@@@@@@@@@@@@@@@@@@@@@@@@@.......@@@..............@
.....@@@@@@@@......@@@@@@@@@...........@@@@@@@@@@@@@@@@@@@@@@@@@@@@@@......................@@@
.@@..@@@@@@@......@@@@@@@@@@.........@@..@@@@@@@@@@@@@@@@@@@@@@@@@@@@.........@.........@...@@
..@.....@@@@..@..@@@@@@@@@@@..............@@@@@@@@@@@@@@@@@@@@@@@@@.....................@@.@@@
...@...@@@@@@......@@@@@@@@.@.............@@@@@@@@@@@@@@@@@@@@@@@@@.............@@@......@@@@@
...@...@@@@@........@@@@@@@.....@.........@@@@@@@@@@@@@@@@@@@@@@@@@......@@.....@@@......@@@@@
..@@....@.@@@.......@@@@....@@..@..........@@..@@@@@@@@@@@@@@@@@@@@....@@@@....@@...........@@
..@.....@.@.........@@.@.......................@@@@@@@@@@@@@@@@@@@@@.....@@@...@@...........@@
...........................@@..............@....@@@@@@@@@@@@@@@@@@@......@@@.............@@@@@
.....@..............@..@.@........@@..@@...@.@.@..@@@@@@@@@@@@@@@@.......@.@.............@@@@@
.....@@@@..................................@..........@@@@@@@@@@@....@..........@@.......@@@@@
......@@@@........@@.......@...@@......@...@............@@@@@@@@....@@..................@@@@@@
............@@...@@@.........@..@........@.@.............@..@@@@@................@.@.....@@@@@
..................@@.........@..@.@......@@@@....@@........@@@......@......@@..@.........@@@@@
.@......@..............@..........@.......@@.....@........@@........@..@.....@@..........@@@@@
@@......@..@@@@..@.@................@.....................@@@..........@.@....@..@.......@@@@@
@@..@.....@@@....@@@........@...............@.......@@................@@@@@@.............@@@@@
......@@@@@@@@@.............................@......@...................@...@....@........@@@@@
@......@.@@@@@@.......@..................................@.............@@@..@.........@..@@@@@
@...@....@@@@@@@...........@.........................@.@@................................@@@@@
@........@@@@@@@..........@@.................@..@....@..@...@.............@..............@@@@@
.....@...@@@@@.@......@....@...@..................@.@............................@....@@.@@@@@
..........@@@@..........@@..............@..........@@...@...@@........@.@........@@@.@@@@@@@@@
.......@@@@@@@@.............................................@...........@.......@@@@@@@@@@@@@@
....@@@@@@@@@@@@@..@@@....@....@........................@......................@@@@@@@@@@@@@@@
...@@@@@@@@@@@@@@..@@...@....@@@........................@..@@@...............@@@@@@@@@@@@@@@@@
@..@@@@@@@@@@@@@@.@@@.......@@............@@@....@.........@@@.........@....@@@@@@@@@@@@@@@@@@
...@@@@@@@@@@@@@@...@........................@@............@@@@.@.........@.@@@@@@@@@@@@@@@@@@
@...@@...@@@@@@....................@....@@@@.@@........@...@@@...............@.@@@@@@@@@@@@@@@
....@@...@@@@@@.............@.@....@..@@@@@@@..........@...@............@@.......@@@@@@@@@@@@@
........@@@..........@@..........@@@@@@@@@@@@........@...............@...@.......@@@@@@@@@@@@@
..@.....@.@..........@..@@......@@@@@@@@@@@@@.@@..............@.............@@@.@@@@@@@@@@@@@@
.....................@..@.......@@@@@@@@@@@@@@@@...................@.........@@.@@@@@@@@@@@@@@
..........@@@@.......@....@.....@@@@@@@@@@@@@@@@........@.....@....@.....@@.@@@@@@@@@@@@@@@@@@
..........@@@@....@.............@@@@@@@@@@@@@@@@...........@..@..........@@@@@@@@@@@@@@@@@@@@@
..@@.......@@@..................@@@@@@@@.@@@@@@...............@.....@.....@@@@@@@@@@@@@@@@@@@@
...........@@@@........@.........@.@@@@..@@@@@@..............................@@@@@@@@@@@@@@@@@
........@...@@@.........................@@@@@@......@@...........@.@@@........@@@@@@@@@@@@@@@@
............@@@.......................@.@@@@@@......@@@....@....@@@@@@..@.....@@@@@@@@@@@@@@@@
............@...@............@.......@..@@@@@@@@.@@@@@@.@........@@@@@@@@@@@@@@@@@@@@@@@@@@@@@
@@.@@..@.................................@@....@@@@..............@@@@@@@@@@@@@@@@@@@@@@@@@@@@@
@@@@...@.................@......@@.......@.......@@.........@....@@@...@@@@@@@@@@@@@@@@@@@@@@@
@@@@....@..........@..........@@@@@....@.@........................@@..@@@@@@@@@@@@@@@@@@@@@@@@
@@@@...............@...@.......@@@@..................................@@@@@@@@@@@@@@@@@@@@@@@@@
@@@@.........@.....@.........@@@@@@@@....@...................@@@......@@@@@@@@@@@@@@@@@@@@@@@@
@@@@@@@....................@@@@@@@@@@@...@.@............@@@@@@@@..@@....@@@@@@@@@@@@@@@@@@@@@@
@@@@@@@....................@@@@@@@@@@@................@.................@@@@@@@@@@@@@@@@@@@@@@
@@@@@@@....................@@@@@@@@@@@.......................@@.........@@@@@@@@@@@@@@@@@@@@@@
8
28 90 0
39 64 0
8 14 0
41 28 0
85 55 0
32 72 0
50 62 0
37 6 0

56 69 0
20 68 0
17 30 0
69 91 0
12 31 0
67 10 0
32 68 0
24 72 0
