width 94
height 94
@@@@@@@@@@@@@@@@@@@@@@@@@@@@@@@@@@@@@@@..........@.....@@@@@@@@@@.......@.@.......@....@@@@@@@
@@@@@@@@@@@@@@@@@@@@@@@@@@@@@@@@@@@@@@@@...............@@@@@@.............@......@@......@@@@@
@@@@@@@@@@@@@@@@@@@@@@@@@@@@@@@@@@@@@@@........@@......@@@@@..................@@@...@....@@@@@
@@@@@@@@@@@@@@@@@@@@@@@@@@@@@@@@@@@@@@....................@@@@.................@@.........@@@@
@@@@@@@@@@@@@@@@@@@@@@@@@@@@@@@@@@@@@..................@....@@@..............@@@@.........@@@@
@@@@@@@@@@@@@@@@@@@@@@@@@@@@@@@@@@@@@@..@........@...@@.....@@@..............................@
@@@@@@@@@@@@@@@@@@@@@@@@@@@@@@@......@......@....@..........@@@..@............................
@@@@@@@@@@@@@@@@@@@@@@@@@@@@@@@.@...@@@@@....@........@..@@.@@@...............................
@@@@@@@@@@@@@@@@@@@@@@@@@@@@@@......@@@....@.@.......@....@.@@@@..@..........................@
@@@@@@@@@@@@@@@@@@@@@@@@@@@@@@......@@@@...@@@.....@........@@@@......@.............@@@@......
@@@@@@@@@@@@@@@@@@@@@@@@@@@@........@@@....@@@...........@.@@@@@.....@@.......@......@@@......
@@@@@@@@@@@@@@@@@@@@@@.@@@@..........@.....@......@@.......@@@@........@@.....@..........@@...
@@@@@@@@@@@@@@@@@@@@....@@@..........@..................@..@@@@@..............................
@@@@@@@@@@@@@@@@@@@@.....................................@@@@@@@@@@...@@....@@...............@
@@@@@@@@@@@@@@@@@@@@........................@@@..........@.@@@@@@@@@...@@...@@@@@...@.......@@
@@@@@@@@@@@@@@@@@@@.......@........@.....@.................@@@@@@@@@..........@@@@..........@@
@@@@@@@@@@@@@@@@@@@.......@..@.@.........@..............@..@@@@@@@..@....@@....@@@...........@
@@@@@@@@@@@@@@@@@@@......@...........@@....@@@.........@@...@@@@@@........@....@@............@
@@@@@@@@@@@@@@@@@@@...............@@@.@...@@@@.......@@........@@...........@..@@........@@...
@@@@@@@@@@@@@@@@@@@@@...@@.........@@................@@........@..............@@@..@@.@......@
@@@@@@@@@@@@@@@@@@@@@@@......@.....@@@...@...........@@.....@.................@@..............
@@@@@@@@@@@@@@@@@@@@@@@@...........@@@...@......@...........@................................@
@@@@@@@@@@@@@@@@@@@@@@@...........@@.....@@................................................@@@
@@@@@@@@@@@@@@@@@@...@............@@.....@@@.....@.......@................@....@@..........@@@
@@@@@@@@@@@@@@@@.....@.............@@....................@................@@@@..@@@.......@@@@
@@@@@@@@..@@......@..........@.....@@.............@......@......................@@........@@@@
@@@@@@@@..............@.............@............@@...@..............@..................@.@@@@
@@@@@@@@@@.....@..............................................@@........@.................@@@@
@@@@@@@@@@@...................................................@@@@..................@.....@@@@
@@@@@@@@@@.....................................@@............@@@@@.@........@@@.....@@...@@@@@
@@@@@@@@@@......@...........................................@@@@@@@@@@@.....@@@@..@@@@@@@@@@@@
@@@@@@@@..........@.............................@@.........@@@@@@@@@@........@@@...@@@@@@@@@@@
@@@.@@@@......@@@@@.............................@@.........@@@@@@@@@@........@@@....@@@@@@@@@@
@@...@@@@....@@@@@@@@@............@.............@.......@..@@@@@@@@@@@@..@@@@@@.....@@@@@@@@@@
@@...@@@@....@@@@@@@@@@@..@.......@.........@...@........@@@@@@@@@@@@@@@.@@@@@@...@@@@@@@@@@@@
....@@@@.....@@@@@@......@.....................@@....@...@@@@@@@@@@@@@@@.@@@@@@@@@@@@@@@@@@@@@
@...........@@@@@@@......@@.@@@@@....@...@@.....@@.......@@@@@@@@@@@@@@@@@@@@@@@@@@@@@@@@@@@@@
............@@@@@@@......@..@@@@@@@......@@@@.@.@@........@@@@@@@@@@@@@@@@@@@@@@@@@@@@@@@@@@@@
@.............@@@@..........@@@@@@@......@@@....@.........@@@@@@@@@@@@@@@@@@@@@@@@@@@@@@@@@@@@
@..............@............@@@@@........@...............@@@@@@@@@@@@@@@@@@@@@@@@@@@@@@@@@@@@@
@......................@....@@@@@........@...........@...@@@@@@@@@@@@@@@@@@@@@@@@@@@@@@@@@@@@@
@...@@@................@....@............@....@@@...@@@@.@@@@@@@@@@@@@@@@@@@@@@@@@@@@@@@@@@@@@
@...@@@.@@@.............................@@..@@@@@...@@@@@@@@@@@@@@@@@@@@@@@@@@@@@@@@@@@@@@@@@@
....@@@@@@@...........@....@............@...@....@...@@@@@@@@@@@@@@@@@@@@@@@@@@@@@@@@@@@@@@@@@
....@@@@@@@@@.................................@.....@@@@@@@@@@@@@@@@@@@@@@@@@@@@@@@@@@@@@@@@@@
@@..@@@@@@@@@@@@..@@@.............................@.@@@@@@@@@@@@@@@@@@@@@@@@@@@@@@@@@@@@@@@@@@
@@@@@@@@@@@@@@@....@@.............@.................@@@@@@@@@@@@@@@@@@@@@@@@@@@@@@@@@@@@@@@@@@
@@@@@@@@@@@@@@@....@@............@................@..@@@@@@@@@@@@@@@@@@@@@@@@@@@@@@@@@@@@@@@@@
@@@@@@@@@@@@@@@..@@@..................................@@@..@@@@@@@@@@@@@@@@@@@@@@@@@@@@@@@@@@@
@@@@@@@@@@@@......@....................@@..........@@......@@@@@@@@@@@@@@@@@@@@@@@@@@@@@@@@@@@
@@@@@@@@@.........@..........@.............................@@@@@@@@@@..@@@@@@@@@@@@@@@@@@@@@@@
@@@@@@@@@.........@......@@...............................@@@@.@@@@@@..@@@@@@@@@@@@@@@@@@@@@@@
....@@@@@..@.@@..........@@......@@........................@@@..........@@@@@@@@@@@@@@@@@@@@@@
.....@@@@@...@@..............@.............................@@@...........@@@@@@@@@@@@@@@@@@@@@
......@@@.....@...............................@.....@.......@............@@@@@@@@@@@@@@@@@@@@@
......@@..@................@....@.......@.....@.....................@@...@@@@@@@@@@@@@@@@@@@@@
...................@@......@....@...........@.........@@@@...........@....@@@@@@@@@@@@@@@@@@@@
.......@.......@@@@@.......@...............@@@.@@........@@............@.@@@@@@@@@@@@@@@@@@@@@
................@@@@.................@@......@...........@@@.............@@@@@@@@@@@@@@@@@@@@@
.........@.......@@.@@@@.............@@.....@........@@.@@@@@@...........@@@@@@@@@@@@@@@@@@@@@
.................@...@@....@..@..........................@@@@@...........@@@@@@@@@@@@@@@@@@@@@
..@..@@@....@.........@@.............@...................@@@@@....@.......@@@@@@@@@@@@@@@@@@@@
..@..........@@......@@@@..........................@....@@@@@@.......@....@@..@@@@@@@@@@@@@@@@
@@@.........@@.......@@...@..................@.....@....@@@@@@@@@....@.......@@@@@@@@@@@@@@@@@
@@@.......@@@@@......@@..............@..........@.......@@@@@@@@@@.......@..@@@@@@@@@@@@@@@@@@
@@@@.....@@@@@.....@@@..........@...........@...........@@@@@@@@@............@@@@.@@@@@@@@@@@@
@@.......@@@@.......@@@@.........@.......................@@@@@@@@.........@..@@@..@@@@@@@@@@@@
@@@.@.....@@@@@.....@@@@.................................@@@@@@@...........@..@...@@@@@@@@@@@@
@...........@@@@......@@.......@@.....@.....@.......@.@@@@@@@@.....................@@@@@@@@@@@
..............@@.....@@@@.....@.......@...@.@@..@.......@@@@@.......................@@@@@@@@@@
.....................@@@..............@.....@@@.........@@@..........@@............@@@@@@@@@@@
.@@@...............................@@@@@....@...@@......@@@.........@@@...............@@@@@@@@
@@........@........................@@@@@@@@@@...@@@.....@@@..........@.................@@@@@@@
@......@....@..............@@@.....@@@@@@@@@@....@@@..........................@@........@@@@@@
............................@@@@@...@@@@@@@@@......@...@..................@..@@@@@......@@@@@@
.....@@............@........@@@@@@.@@@@@@@@.......@@@.......@@@........@......@@@........@@@@@
@.................@..@@...@@@@@@@.....@.@@........@@........@@@.............@@@..........@@@@@
.@........@@@@@@@............@@@@.@@@...................................@...@@@....@@@...@@@@@
.......@..@@@@@@@............@@@...@@@@.............@@.......@..............@@.....@@@@..@@@@@
..@.......@@@@@@@.............@@.@..@....@...............@..........@..............@@@@@@@@@@@
...........@@@@.@..............@....@@@................@.......@..............@......@@@@@@@@@
.............@@......................@@...@....@...............@..................@..@@@@@@@@@
.@............@...@......@...........@@......@@@...@@......@..@@.......@.............@@@@@@@@@
...........@........@@............@@@@@............@..@....@@.@@........@@.......@...@.@@@....
..@....@..@..@....................@@@@.....@...........@...@@@@@@@......@@@.@@.....@...@@.....
.....@..@.........@..........@.....@.........@.............@@@@@@@..@...@@....@.@.......@..@..
@....@@@............................................@........@@@@@@.....@@.............@@.....
@....@@@..............@...........@....@......................@@@@..........@@......@........@
@.@@...@.................@.....@....................@.@.@.....@@.......................@..@.@@
@@@................@..@.@@@@..@@...............................@@.........................@@.@
@@@@@............@@@@...@@....@@@@.@........@......@.....@....@......@......@@@...............
@@@@@@..........@@@@@.........@@@..@...............@@..............@.......@@@@..............@
@@@@@@@@......................@@@.............@.....@@.......@.....@@......@@@@..............@
@@@@@@@@..........@@..........@@@@@...@@.....@@........@@.......@.@@@.......@@@...@.@@@@...@@@
8
74 28 0
61 87 0
43 20 0
73 5 0
51 10 0
80 80 0
67 53 0
76 80 0

17 93 0
63 74 0
69 21 0
88 75 0
41 2 0
93 9 0
76 12 0
58 55 0
