width 94
height 94
@@@@@@@@@@@@@@@@@@@@@@@@@@@@@@@@@@@@@@@@@@@@@@@@@@@@@@@@@@@@@@@@@@@@..@@@@@@...@@........@@@@@
@@@@@@@@@@@@@@@@@@@@@@@@@@@@@@@@@@@@@@@@@@@@@@@@@@@@@@@@@@@@@@@@@@@@....@@@@.......@@...@@@@@@
@@@@@@@@@@@@@@@@@@@@@@@@@@@@@@@@@@@@@@@@@@@@@@@@@@@@@@@@@@.@@@.........@@@@@...........@@@@@@@
@@@@@@@@@@@@@@@@@@@@@@@@@@@@@@@@@@@@@@@@@@@@@@@@@@@@@@@@@..............@@@@@....@..@......@@@@
@@@@@@@@@@@@@@@@@@@@@@@@@@@@@@@@@@@@@@@@@@@@@@@@@@@@@@@@@@.@...........@@@@@...............@@@
@@@@@@@@@@@@@@@@@@@@@@@@@@@@@@@@@@@@@@@@@@@..@@@@@@@@@@@@@.............@@@@...@@.@@........@@@
@@@@@@@@@@@@@@@@@@@@@@@@@@@@@@@..@@@@@@@@@@...@@@@@@@@@@@@@@@.........@@@@@...@@.@..@@.....@@@
@@@@@@@@@@@@@@@@@@@@@@@@@@@@@@@..@@@@@@@@@.@.@@@@@@@@@@@@@@@@@..@......@@@....@@.@..@@....@@@@
@@@@@@@@@@@@@@@@@@@@@@@@@@@@@@@....@@@@@.....@@@@@@@@@@@@@@@......@....@@.................@@@@
@@@@@@@@@@@@@@@@@@@@@@@@@@@@@@@@..@@@@@@..@..@@@@@@@@@@@@@@@........................@.....@@@@
@@@@@@@@@@@@@@@@@@@@@@@@@@@@@@@@..@@@@......@@@@@@@@@@..@@@....................@@..@@.....@@@@
@@@@@@@@@@@@@@@@@@@@@@@@@@@@.@.@@.@@@@.....@@@@@..@.....@@.....@.................@.....@..@@@@
@@@@@@@@@@@@@@@@@@@@@@@@@@@@..............@@@@@@.................@@..@....................@@@@
@@@@@@@@@@@@@@@@@@@@@@@@@@@@@@......@@..@..@@@@@..................@........................@@@
@@@@@@@@@@@@@@@@@@@@@@@.@...........@......@.............@.........................@.......@@@
@@@@@@@@@@@@@@@@@@@@@@@.................@................@....@@.............@..@@.@@...@...@@
@@@@@@@@@@@@@@@@@@@@@@@.....................@......@...........@.................@@@@@@@@@@@@@
@@@@@@@@@@@@@@@@@@@@@@@.....................................@..@..@........@.....@@@@@@@@@@@@@
@@@@@@@@@@@@@@@@@@@.....................................@.....@@..@.@....@......@@@@@@@@@@@@@@
@@@@@@@@@@@@@@@@@@@@@.......@.............................@...@@@@@@.....@@.@...@@@@@@@@@@@@@@
@@@@@@@@@@@@@@@@@@@@@...@@...............@.....@@@@..........@@@@...........@......@@@@@@@@@@@
@@@@@@@@@@@@@@@@@@@@@@.@@@@..................@.@@@.........@...@@@@@........@......@@@@@@@@@@@
@@@@@@@@@@@@@@@@@@@......@@.....................@@.........@@...@@@.................@@@@@@@@@@
@@@@@@@@@@@@@@@@@@@......@.......@..............@@.@.....@@@....@@@.@..............@@@@@@@@@@@
@@@@@@@@@@@@@@@@@@@.................@........@..........@@......@@@...............@@@@@@@@@@@@
@@@@@@@@@@@@@@@@.@@......@..............@......................@@@@@...............@@@@@@@@@@@
@@@@@@@@@@@@@@@@.........@@@...........................@@......@@@@@@.........@.@..@@@@@@@@@@@
@@@@@@@@@@@@@@@@.........@@@@@.........@@..@...........@@......@@@@@@....@.........@@@@@@@@@@@
@@@@@@@@@@@@@@@........@.@@@@@........@@...........@...@@@.......@@@@@..@@......@@.@@..@@@@@@@
@@@@@@@@@@@@.@@@.........@@@@@.........................@............@@.................@@@@@@@
@@@@@@@@@@@@.@@@....@....@@@@...................................@@@....................@@@@@@@
@@@@@@@@@@...@@@..@......@@@@..........@...@.......................@.............@.....@@@@@@@
@@@@@@@@@@...@@.........@@@@@.......................@.........@@@@...............@@..@@@@@@@@@
@@@@@@@@@@@..............@@@@@......@.....@@...........@......@@@.................@@..@@@@@@@@
@@@@@@@@@@..........@@@@@@@@@.............@@@@@@@....@@...............................@@@@@@@@
@@@@@@@@@@..........@@@@@@@@@@..@.....@@..@@@@@@@.....@..@..................@......@....@@@@@@
@@@@@@@@@@......@....@@@..@@@@............@@@@.............@................@......@.......@@@
@@@@@@@@@............@.....@@@..@.....................@.....................@...........@...@@
@@@@@.....@..........@@....@....@........................................@....@.............@@
@@@@@@...@@@...@@....@@@....................@.....@@.......@@...............................@@
@@@@@@@@@@@@.........@@@..............@....@@@....@..............................@....@......@
@@@@@@@@@@@@...@@@..........................@.................@......................@@....@@@
@@@@@@@@@@@@....@@..........................................@....@@.......@@...............@@@
@@@@@@@@@@@@.....@....@.....................................@...@@@@@.....@@@..@............@@
@@@@@@@@@@@@@....@@..@@.@..@....................................@@@@@.....@.........@......@@.
@@@@@@@@@@@@..........@@...@.@............................@@.....@@@.@.............@..........
@@@@@@@@@@.@@@........................................@..@@@......@@.........................@
@@@@.@@@@@..@......@.............@@@.............@@.....@@@@..@..@@@..........................
@@..............@................................@@.....@@@.....@@...@.@..........@...........
@@...............@...................@..................@@@@..@...................@....@......
@@@@@.....@........@..............@..@@..................@@@..................................
@@@@@..............@.....................................@.......................@............
@@@@@..............@@..............@....................@@.@.........................@@@......
@@@@...............@.....@.......@@@...@..........@@@@..@@................@..@.......@@@......
@@@@..............................@@@@@@.........@@@@@@......@........@.@.....................
@@@.........@....@.....@........@@@@@@@@...............................@@..........@.....@....
..@.@............@@...........@...@@@@@@......................@@......@@@@@.......@...@@@@@@@.
....@@.@..........................@@@@@...................@.......@..@@@@...........@@@@@@@@@@
.....@..@..@@.....................@@@@.....@...@...........@......@@............@...@@@@@@@@@@
...........@......................@@@@.......................@...@@@......@.....@...@@@@@@@@@@
.........................@........@@@@@@........@..@.@@.........@@@.......@........@@@@@@@@@@@
@..@.............................@@@@@@@....@.......@@@......@@@@@@@......@...@......@@@@@@@@@
@.....@....@....................@@@@@@@@@..........@@@@......@@@@@@@@@@@...@..........@@@..@@@
...........@@...................@@@@@@@@@..@.......@@.........@@@@@@@@................@@...@@@
..............@...................@@@@@@@..........@@....@.....@@@@@@......................@@@
@@...............@.@............@@@@@@@@@@@........@@..........@@@@@@..@................@..@@@
@@......@@......................@@@@@@@@@@@@.......@@@.@@......@@@@@...............@........@@
........@@@....................@@@@@.@@............@@@.@@...@@@@@@@.....@...................@@
......@........@@..@..@............................@@@@@@@@@@@@@@@@.........................@@
...@....@......@@.@...@@................@@........@@@@@@@@@@@@@@@@@.........@..............@@@
@..@@@.........@@@@...@.....@...........@@@.......@@@@@@@@@@@@@@@...............@.......@..@@@
@@@@@@.@......................@@...@@..@@@@@@@.@@@@@@@@@@@@@@@@@@@@.....................@@@@@@
@@@@@@.@@...........@.........@@@.@@@@.@..@@@@@@@@@@@@@@@@@@@@@@@@@.....................@@@@@@
@@@@@@@@@...........@@....@...@@@@@@.....@@@@@@@@@@@@@@@@@@@@@@@@@...@@............@....@@@@@@
@@@@@@@@@@@@@......@@@.........@@@@......@@@@@@@@@@@@@@@@@@@@@..@@.........@............@@@@@.
@@@@@@@@@@@@@@..@@@@@@@..@...@.@@@@.......@@@@@@@@@@@@@@@@@@@@..@..................@@....@@...
@@@@@@@@@@@@@@...@@@@@@..........@...@....@...@@@@@@@@@@@@@@@@@............@@............@@@..
@@@@@@@@@@@@@@@..@@@@@........@...........@....@@@@@@@@@@@@@................@............@..@.
@@@@@@@@@@@@@@@@@@@@@@@@@@.@....................@@@@@@@@@@@@..................................
@@@@@@@@@@@@@@@@@@@@@@@@@@@@@........@@.........@@@@@@@@@@@@@..............@.................@
@@@@@@@@@@@@@@@@@@@@@@@@@@@@@@@..................@@@@@@@@@@@@....................@......@.....
@@@@@@@@@@@@@@@@@@@@@@@@@@@@@@...................@@@@@@@@@@@@.........@.@@@@@...@@............
@@@@@@@@@@@@@@@@@@@@@@@@@@@@@................@@@@@@@@@@@@@@@@...........@@@@@@@.@@.........@@@
@@@@@@@@@@@@@@@@@@@@@@@@@@@@@................@@@@@@@@@@@@@@@@...........@@@@@@@@@@@@@@.....@@@
@@@@@@@@@@@@@@@@@@@@@@@@@@@@@.........@.....@@@@@@@@@@@@@@@@....@..@....@@@@@@@@@@@@@@@@..@@@@
@@@@@@@@@@@@@@@@@@@@@@@@@@@@......@@@.@....@@@@@@@@@@@@@@@@@@.....@@..@.@@@@@@@@@@@@@@@@@@@@@@
@@@@@@@@@@@@@@@@@@@@@@@@@@@@.....@@@@@@@@@.@@@@@@@@@@@@@@@@@@.........@.@@@@@@@@@@@@@@@@@@@@@@
@@@@@@@@@@@@@@@@@@@@@@@@@@@@@.....@@@@@@@@@@@@@@@@@@@@@@@@@@@@........@@@@@@@@@@@@@@@@@@@@@@@@
@@@@@@@@@@@@@@@@@@@@@@@@@@@@@.@@@@@@@@@@@@@@@@@@@@@@@@@@@@@@@@@.....@@@@@@@@@@@@@@@@@@@@@@@@@@
@@@@@@@@@@@@@@@@@@@@@@@@@@@@@@@@@@@@@@@@@@@@@@@@@@@@@@@@@@@@@@@.....@@@@@@@@@@@@@@@@@@@@@@@@@@
@@@@@@@@@@@@@@@@@@@@@@@@@@@@@@@@@@@@@@@@@@@@@@@@@@@@@@@@@@@@@@@@....@@@@@@@@@@@@@@@@@@@@@@@@@@
@@@@@@@@@@@@@@@@@@@@@@@@@@@@@@@@@@@@@@@@@@@@@@@@@@@@@@@@@@@@@@@@@@.@@@@@@@@@@@@@@@@@@@@@@@@@@@
@@@@@@@@@@@@@@@@@@@@@@@@@@@@@@@@@@@@@@@@@@@@@@@@@@@@@@@@@@@@@@@@@@@@@@@@@@@@@@@@@@@@@@@@@@@@@@
@@@@@@@@@@@@@@@@@@@@@@@@@@@@@@@@@@@@@@@@@@@@@@@@@@@@@@@@@@@@@@@@@@@@@@@@@@@@@@@@@@@@@@@@@@@@@@
8
74 16 0
75 32 0
18 54 0
54 33 0
41 42 0
31 86 0
22 50 0
3 66 0

64 35 0
33 60 0
37 33 0
53 30 0
62 42 0
87 80 0
44 53 0
41 39 0
