width 20
height 21
@@@@................
@...................
............@.......
...@............@...
......@..@.....@....
..@..@....@.........
......@....@.@......
........@.......@...
.@.................@
......@.........@..@
.@............@.....
.................@..
.........@.@........
.@..@.........@.....
...@.@.........@....
@.........@.........
....................
....................
....................
..........@.........
...........@........
6
7 19 0
18 7 0
15 11 0
8 14 1
14 17 1
15 19 1

17 20 0
6 19 0
15 18 0
9 14 1
10 3 1
16 19 1
