width 20
height 21
.........@@.........
.@............@..@..
....@...@..@........
..............@.....
.......@............
.........@.@........
..................@.
....................
.......@............
......@...@....@@...
.........@..........
..............@.....
..@...@..@..........
....................
.............@......
..@.@.@.............
...........@....@...
...@..@.......@.....
....@.......@.......
....................
.........@..........
6
10 2 0
14 20 0
8 13 0
18 14 1
5 11 1
1 11 1

19 5 0
4 5 0
7 14 0
19 10 1
7 15 1
16 5 1
