width 20
height 21
..............@@....
....................
@......@.@..........
@..............@....
.............@...@..
..@..@..............
...@......@.........
..@.......@...@.....
...@.......@........
...@....@........@..
.........@..........
@...................
@...................
@.......@..@........
@@@..........@...@..
.@@..@.............@
................@...
.........@..........
.@.........@........
....................
.......@............
6
14 13 0
17 17 0
4 9 0
2 8 1
7 16 1
16 14 1

9 15 0
19 4 0
17 18 0
4 15 1
5 14 1
4 20 1
