width 20
height 21
.........@..........
...@................
....................
......@....@....@...
.....@..............
....................
..@.................
......@.........@.@.
.....@@.@....@......
@.....@.....@@..@...
....@...@..@........
...@@@..............
....@@.........@....
.@..@..@..@.......@.
...........@...@....
....................
............@.......
.....@.......@......
..@.................
....................
....................
6
15 9 0
8 17 0
10 0 0
13 6 1
8 1 1
12 11 1

14 8 0
0 13 0
9 3 0
18 20 1
15 19 1
0 19 1
