width 20
height 21
...............@@@@@
..............@.....
...@.@............@.
..@....@.......@....
........@...........
.............@......
...@........@.@.....
.......@........@...
.....@.....@.....@..
..@...@.............
................@.@.
..........@....@....
....................
.@......@...........
...@..@.............
.@..........@.......
..@......@..........
............@.......
...........@........
.......@.......@....
....@..............@
6
19 19 0
16 17 0
0 11 0
9 14 1
16 11 1
5 16 1

4 2 0
7 11 0
19 8 0
17 17 1
15 13 1
6 19 1
