width 20
height 21
@...................
.....@.........@....
...........@........
......@..@..........
.....@........@.....
.@....@.............
..@....@..@.........
..........@.........
....@...........@...
....................
....................
..@....@............
.@.@................
..............@.....
..........@.@.......
...@.....@.....@....
....................
....@.@.......@.@...
@...........@.......
....................
....................
6
3 14 0
6 10 0
16 5 0
6 13 1
17 4 1
9 12 1

4 9 0
5 10 0
1 16 0
12 0 1
16 11 1
15 17 1
