width 20
height 21
....................
.......@.....@......
...@.....@..........
.......@......@.....
..........@..@......
.@.......@.......@..
.....@..............
...@...@............
..@...@@....@.......
...........@.@...@..
...@......@.........
.......@.@........@.
.................@..
...........@........
.@....@.............
........@....@@@@...
.@..................
................@...
.............@......
@@@.....@.......@...
@...........@.@@....
6
6 16 0
19 18 0
8 9 0
13 11 1
9 6 1
7 19 1

14 13 0
14 7 0
19 20 0
0 0 1
19 19 1
5 9 1
