width 20
height 21
............@.......
........@...........
@...............@...
.......@............
..@............@....
......@.@..@....@...
....................
.@......@....@..@...
....................
..@...........@.....
...@......@....@....
.................@..
....................
.....@..@...........
.........@......@...
@..@................
.......@............
....@......@.@......
...@................
..............@.....
...................@
6
6 9 0
19 11 0
8 15 0
17 12 1
13 5 1
9 9 1

18 19 0
4 11 0
12 13 0
5 9 1
13 5 1
7 5 1
