width 20
height 21
............@.......
.........@..........
............@.......
.........@..........
......@.............
...................@
.......@...........@
..@.....@.....@.....
.......@.@.....@..@.
.....@......@.......
..@.................
...@...........@....
........@...........
....@...@...........
@.......@...........
@...................
............@.@..@..
@...................
......@.....@....@..
..............@.....
....................
6
4 1 0
16 18 0
18 4 0
13 4 1
18 19 1
10 3 1

18 14 0
19 20 0
19 8 0
19 16 1
18 9 1
0 20 1
