width 37
height 37
@@@@@@@@@@@..@@@@@............@@.@...
@@@@@@.@@....@@@@@............@......
@@@@.........@@@.@............@..@...
@@@..........@@......................
@@@.......@@.@.......@.@.............
@@.....................@@@..........@
........................@@@.........@
...................@....@@@.........@
..........@@...........@@@@........@@
@...@@.....@.............@@........@@
@.................@......@....@.@..@@
..................@@.......@.....@@@@
........@@@..@...............@..@@@@@
.....@@@@@@..@..............@@@@@@@@@
.....@@@@@@..@.........@....@@@@@@@@@
.....@@@@@.............@....@@@@@@@@@
....@@@.@@............@...@@@@@@@@@@@
....@@@..@.......@.........@@@@@@@@@@
....@@...@@......@@@........@@@@@@@@@
.................@@@....@...@@@@@@@@@
.................@@....@....@@@@@@@@@
.........@@......@@........@@.@@@@...
...@.....@.................@..@@.....
@@.@........@@...@...............@...
@@.@...............@.........@@.@@...
@@....................@......@@.@....
@......................@.....@@.@....
@.....................@@.@@.....@@@@.
@@.....@.........@....@@@@.......@@@@
.@..............@@..@@@..@.......@@@@
...................@@@@.......@...@@@
...........@.@...@@@@@@...........@@@
.................@@@@@............@@@
..........@.....@@@@@@@@............@
.........@@...@.@@@@@@@@@@...........
..........@@..@@@@@@@@...@.....@@.@..
.....@....@@@@@@@@@@@...........@@@..
8
2 15 0
7 29 0
13 9 0
4 19 0
17 9 0
24 14 0
19 21 0
28 22 0

3 17 0
36 0 0
36 36 0
19 2 0
12 17 0
16 7 0
36 1 0
34 24 0
