width 37
height 37
@@@@@@@@@.........@@@@@@@@@@@@@@@@@@@
@@@@@@@@@.........@@@@@@@@@@@@@@@@@@@
@@@@@@@@@@@@.......@@@@@.....@@@@@@@@
@@@@@@@@@@@@@...............@.@@@@@@@
@@@@@@@@@@@@@@...@.@........@...@@@@@
@@@@@@@@@@@@@@................@@@@@@@
@@@@@@@@@@@@@@.............@@.@@@@@@@
@@@@@@@@@@@@@..............@@@@@@@@@@
@@@@@@@@@@@@@.............@@@@@@@@@@@
@@@@@@@@@@@@...@..........@@..@@@@@@@
@@@@@@@@......................@@@@@@@
@@@@@@@@.......................@@@@@@
@@@@@@@@..........@............@@@@@@
@@@@@@@@@....@@@@@@.............@@@@@
@@@@@@@@@@......@@@..............@@@@
@@@@@@@@@.........@@..@..........@@@@
....@@@@.....@@...@@@@@.........@@@@@
..@@.........@@@..@..@@@........@@@@@
.............@@@.......@@.......@@@@@
......@........@.................@@@@
.......@@@......@....@...........@@@@
.......@........@........@....@......
............@@@......................
............@@@..@...................
.....@@@....@@@............@.........
@.........@@@@@..@@..................
@.........@@@@@..@@@@@@@.............
..........@@@@@@@@@@@@@@...@@........
@@.....@@..@@@@@@@@@@@@@.............
@@...@@@@..@@@@@@@@@@@@@.............
@@@@@@@@@@@@@@@@@@@@@@@@...........@@
@@@@@@@@@@@@@@@@@@@@@@@@@...........@
@@@@@@@@@@@@@@@@@@@@@@@@@.........@..
@@@@@@@@@@@@@@@@@@@@@@@@@....@.......
@@@@@@@@@@@@@@@@@@@@@@@@@@@..@.@.....
@@@@@@@@@@@@@@@@@@@@@@@@@@@@....@....
@@@@@@@@@@@@@@@@@@@@@@@@@@@...@....@@
8
16 26 0
11 22 0
21 18 0
32 20 0
28 30 0
22 9 0
19 9 0
26 15 0

22 21 0
10 22 0
20 18 0
15 2 0
29 31 0
30 19 0
27 36 0
8 25 0
