width 37
height 37
.@@@@@@@...@@@@@@@@@@@@@@@@@@@@@.....
.@@@@@@...@@@@@@@@@@@@@@@@@@@........
.@@@@@....@@@@@@.@@@@@@@@@@@@........
.....@.....@@@@@...@@@@@@@@@........@
.........@@@@@@..@@@@@@@@@@@.........
...@@....@@@@@@..@@@@@@@@@@..........
.........@@@@@.@.@@@@@@@@@@@@........
..@@......@@@.....@@@@@@@@...........
..@..........@....@@@@@@@@...........
.@@..............@@@@@@@............@
..................@@@@@@.....@@@....@
....................@@@@..........@@@
....................@@@@..........@@@
....................@@@@.........@@@@
...........@@@..........@....@..@@@@@
@@......@..@...........@.........@@@@
@@....@................@.....@...@@@@
@@..@...@@@......................@@@@
@.........@.........@.............@@@
@@.........@@@.....@..............@@@
@@.........@@@.....@.....@.@......@..
@@@........@.......@....@@..........@
@@@@...............@@@..@@.........@@
@@@................@@@...........@@.@
@@@@@..............@.....@..........@
..................@......@...........
..................@.@...@..........@.
@.@@........@@......@@@........@@@...
@@@@@@............@.@@@@@@@....@@....
@@@@@....@@....@......@.@@@.......@@.
@@..@...................@@@.......@@@
@@..@.........@.........@...........@
@.....@@@........@..........@@......@
@......@@@..................@@.......
@@@....@@@..................@@.....@.
@@@....@@@..@@....@........@@@@@..@@@
@@@....@@@..@@..@@@.......@@@@@..@@@@
8
11 11 0
32 9 0
16 24 0
35 5 0
5 19 0
32 36 0
0 9 0
3 19 0

13 23 0
4 23 0
6 6 0
4 25 0
28 13 0
28 28 0
6 12 0
13 25 0
