width 37
height 37
@@@@@@@@@@@@@@.....................@@
@@@@@@@@@@@@@......................@@
@@@@@@@@@@@@@.......................@
@@@@@@@@@@@@@...@...@...............@
@@@@@@....@.........@.@..............
..@@@@..............@........@.......
....................@................
@...@..........@@@@.@..........@.....
..@..............@@@@@...............
..@@@@....@.......@@@@@@...........@.
@.@@@@....@@...@..@@@...............@
....@@............@@@.@..............
....@.@@....@..................@..@..
...@@.......@.......@................
..@@@@....@..@........@..............
....@.....@...........@..............
.........@............@....@@........
.......@.@@...........@............@.
@..@....@@@.............@.........@@@
..@@....@.@.......................@@@
..........@....................@....@
@@.........@....@@...................
@@............@..@..................@
@................@...........@@...@@@
@................@............@@..@@@
@................@..........@@@@.@@@@
.........@...............@.........@@
..............@.....@@@.@...........@
...@..................@.......@.....@
...@@...........@..................@@
@@@@@@...............................
@@@@@.........@@@..........@....@...@
@@@@@..........@@..@......@....@@@@@@
@@@@@@@................@..@....@@@@@@
@@@@....................@@@@@@@@@@@@@
@@@@....................@@@@@@@@@@@@@
@@@@@...............@...@@@@@@@@@@@@@
8
13 32 0
18 0 0
32 7 0
30 10 0
23 0 0
24 6 0
28 20 0
15 17 0

17 30 0
5 27 0
18 29 0
17 9 0
22 3 0
18 28 0
21 35 0
30 5 0
