width 20
height 10
................@...
....@...............
@......@..@...@.....
............@.......
....................
...........@........
......@.@.....@..@..
...........@........
...............@....
.............@......
6
4 9 0
15 3 0
4 4 0
19 7 1
19 3 1
1 2 1

0 0 0
0 9 0
19 9 0
9 7 1
10 6 1
1 2 1
