width 20
height 10
....................
..............@..@..
....................
....................
.......@.@..@.....@.
....................
................@...
......@.............
.......@......@@@.@@
@..@........@@@@@@@@
6
2 5 0
16 1 0
8 6 0
4 3 1
9 6 1
1 8 1

1 5 0
17 4 0
19 0 0
1 0 1
6 3 1
17 8 1
