width 20
height 10
....@...............
.@...@.......@..@...
....@....@..........
...@........@@@.....
....................
............@...@...
....................
.............@......
..@.....@.......@...
.........@@@........
6
1 0 0
1 5 0
2 3 0
2 6 1
0 4 1
15 4 1

9 3 0
12 2 0
14 8 0
11 1 1
0 6 1
12 0 1
