width 20
height 10
......@@...........@
...@...............@
....................
..........@.........
.......@.@...@.@....
........@.@.........
.....@...........@..
.............@@...@@
.....@......@@@..@@@
........@...@@@..@@@
6
19 4 0
14 6 0
0 2 0
14 3 1
2 0 1
13 2 1

0 9 0
18 3 0
15 9 0
1 1 1
17 5 1
0 3 1
