width 86
height 86
.@@@@@@@@@@@@@@@@@@@@@@@@@@@@@@@@@@@@@@@@@@@@@@@@@@@@@@@@@@@@@@@@@@@@@@@@@@@@@@......@
.@@@@@@@@@@@@@@@@@@@@@@@@@@@@@@@@@@@@@@@@@@@@@@@@@@@@@@@@@@@@@@@@@@@@@@@@@@@@.@......@
.@@@@@@@@@@@@@@@@@@@@@@@@@@@@@@@@@@@@@@@@@@@@@@@@@@@@@@@@@@@@@@@@@@@@@@@@@@@@........@
..@@@@@@@@@@@.@@@@@@@@@@@@@@@@@@@@@@@@@@@@@@@@@@@@@@@@@@@@@@@@@@@@@@@@@@@@@@.........@
..@@@...@@@@@.@@@@@@@@@@@@@@@@@@@@@@@@@@@@@@@@@@@@@@@@@@@@@@@@@@@@@@@@@@@@@@@........@
..@.......@@...@@@@@@@@@@@@@@@@@@@@@@@@@@@@@@@@@@@@@@@@@@@@@@@@@@@@@@@@@@@@@@......@@@
..........@...@@@@@@@@@@@@@@@@@@@@@@@@@@@@@@@@@@@@@@@@@@@@@@@@@@@@@@@@@@@@@@.......@@@
..............@@@@@@@@@@@@@@@@@@@@@@@@@@@@@@@@@@@@@@@@@@@@@@@@@@@@@@@@@@@@@@.......@.@
@......@@......@@@@@@@@@@@@@@@@@@@@@@@@@@@@@@@@@@@@@@@@@@@@@@@@@@@@@@@@@@@@@@........@
......@@@@..@.....@@@@@@@@@@@@@@@@@@@@@@@@@@@@@@@@@@@@@@@@@@@@@@@@@@@@@@@@@@.........@
......@...........@@@@@@@@@@@@@@@@@@@@@@@@@@@@@@@@@@@@@@@@@@@@@@@@@@@@@@@@.@.........@
@@@...@@.........@@@@@@@@@@@@@@@@@@@@@@@@@@@@@@@@@@@@@@@@@@@@@@@@@@@@@@@@@...........@
@@@...............@@@@@@@@@@@@@@@@@@@@@@@@@@@@@@@@@@@@@@@@@@@@@@@@@@@@@@@@.......@....
@@...@.............@@@@@@@@@@@@@@@@@@@@@@@@@@@@@@@@@@@@@@@@@@...@@.@@@@@@@..@.........
@@..........@@@@@..@@@@@@@@@@@@@@@@@@@@@@@@@@@@@@@@@@@@@@@@@@......@@@@@........@@....
............@@@@...@@@@@@@@@@@@@@@@@@@@@@@@@@@@@@@@@@@@@@@@@@.....@@@@@....@...@@@....
..@.......@@@@@......@@@@@@@@@@@@@@@@@@@@@@@@@@@@@@@@@@@@@@@@.....@@..@@......@.......
@@@........@@@@.....@@@@@@@@@@@@@@@@@@@@@@@@@@@@@@@@@@@@@@@@.................@@@......
@@@...@@...@@@@.@...@@@@@@@@@@@@@@@@@@@@@@@@@@@@@@@@@@@@@@@@...............@@.........
@@@........@@@@@@...@@@@@@@@@@@@@@@@@@@@@@@@@@@@@@@@@@@@@@@@...@..........@@.....@@...
@.......@..@@@@@@@..@@@@@@@@@@@@@@@@@@@@@@@@@@@@@@@@@@@@@@..@..@.............@...@@@@.
@.........@@@@@@@....@..@@@@@@@@@@@@@@@@@@@@@@@@@@@@@@@@@@.....@@...........@@@@@@@@@@
.....@.......@@@.....@..@@@@@@@@@@@@@@@@@@@@@@@@@@@@@@@@@@.....@............@@@@@@@@@.
.....@@......@@@........@@@@@@@@@@@@@@@@@@@@@@@@@@@@@@@@..................@......@@@..
@@@..........@@@.........@@@@@@@@@@@@@@@@@@@@@@@@@@@@@@@.....@.......@............@...
@@@...@@@.....@@@@.......@.@@.@@@@@@@@@@@@@@@@@@@@@@@@@@.......................@......
@@@...@@@@....@@@@@@@.........@@@@@@@@@@...@@@@@@@@@@@@@..............@............@.@
@@@......@....@@@@@@@..........@@@@@@@@@....@......@@@......@.........@..@............
@@@.........@@@@@@..............@@@@@@@@..@........@..............@...@@..............
@........@..@@@@................@@@@@@@@....@..........@@..............@@.............
@..........@@@@@.................@@@@@@@....@..........................@@.......@.....
@.......@..................@....@@@@@@@@....@..............@..@.......................
@...@.........@.@@.@...@@.......@@@@.......................@@.......@@@.........@.@@..
@@@@@........@..@@@....@@@@@@@@@@@..............@@@.@......@.......@@@@@@..@......@...
@@@.@....@.......@@@..@@@@@@@@.@@................@@@................@@@@@@@@......@...
..@......@........@@@....@@@@@....@......@.......@@@.@..............@@@@@@@.......@...
..@....@@@.......@@@.....@@@@.....@..@..@@@..........@..........@@...@@@@@@..@@...@...
.......@@@.@..............@@@..@........@.......................@@..@@@@@@@..........@
.......@@@.........@.........................@@@.@..............@@..@@@@@@....@@@@...@
...@...............@@........................@@@@@............@@@@@@@@@@@@@...@@@@@..@
@..................@@@...................@..@@@@@@.............@@@@@@@@@@@@...@@@@@@@@
....@....@....@...@@.@.........................@@@@@@@@@......@@@@@@@@@@@@@...@@@@@@@@
....@...@@@.......@@........@.......@..........@@@@..........@@@@@@@@@@@.......@@@@@@@
....@...@@@.......@@...........@.@.@@...@@@@................@@.@@@@@@@@@@@@@@@.@@@@@@@
...@@..............@@@@......@@@@@@.....@@@@@@@.............@....@@@@@@@@@@@@@@@@@@@@@
...@@........@........@.....@@@@@@.......@@@@@.....................@@@@..@@@@@@@@@@@@@
@..@@............@@..@@......@@@@@@@..@@@@@@@@..@............@....@@@@@..@@@@@@@@@@@@@
....@............@@..........@@@@@@@@@@@@@@@@@.@.....@@@@..@......@@@@@..@@@@@@@@@@@@@
@...........@....@@....@.....@@@@@@@@@@@@@@@..........@@........@@@@@....@@@@@@@@@@@@@
@@@..............@.............@@@@@@@@@@@@@....@.....@..@.....@@.@@@.....@@@@@@@@@@@@
@.@.....@@....@@...............@@@@@@@@@@@@@......@.............@.@......@@@@@@@@@@@@@
..............@@..................@@@@@@@@@@@@.....@.......@......@.....@@@@@@@@@@@@@@
.@.............................@....@@@@@@@@...@..............@........@@@@@@@@@@@@@@@
.@@.......@................@@..@@...@..@@@@@@.................@.......@@@@@@@@@@@@@@@@
...............................@@......@@@@@@.........................@@@@@@@@@@@@@@@@
..@..................@@@@.............@@@@@@@@@............@...........@@@@@@@@@@@@@@@
.....@@..............@@@@..........@@@@@@@@@@@@............@...@.......@@@@@@@@@@@@@@@
.....@@......@........@@..............@@@@@@@.................@........@@@@@@@@@@@@@@@
.....@@......@......@.................@@@@@@@@@..@............@@@.....@@@@@@@@@@@@@@@@
@......@..@................@@@..@@......@@@@@@@............@@@@@@@....@@@@@@@@@@@@@@@@
@.........@.........@@@...@@@@@..@......@@@.....@...........@@@@@@@@@@@@@@@@@@@@@@@@@@
..@@@......@........@@@......@@@@@..............@...........@@@@@@@@@@@@@@@@@@@@@@@@@@
.................@.@@@@......@......@.............@....@@....@@@@@@@@@@@@@@@@@@@@@@@@@
....@........@@..@@@@@@....@@@..@.........@.................@@@@@@@@..@@@@@@@@@@@@@@@@
....@@@.....@@@@@@@@@@...@@@@..........@@...................@.@@@@@..@@@@@@@@@@@@@@@@@
....@@.......@@@@@@@@@@..................@@...................@.....@@@@@@@@@@@@@@@@@@
...........@.@@@@@@@@........@@@.................@..............@.@.@@@@@@@@@@@@@@@@@@
@..............@@@@@@........@...................@..............@@@.....@@@@@@@@@@@@@@
.............@@@@@@@@..............@.........@@..@@..............@......@@@@@@@@@@@@@@
......@@@.....@@@@@@@@@......................@@..@....................@@@@@@@@@@@@@@@@
...@..@@@@....@@@@@@@@@.@...........@@@..@...@@@......................@@@@@@@@@@@@@@@@
......@@@@.....@@@@@@@@@..........@.@@............@@.........@.....@.@@@@..@@@@@@@@@@@
......@@@@...@...@@...............@@.@.......................@@.@@...@@....@@@@@@@@@@@
......@@.........@@................@..................@......@@@.............@@@@@@@@@
.....@@..........@@........@..........@.....@@@@............@@.......@.......@@@@@@@@@
@@...@@.....................@..........................@....@................@.@..@@..
@@.@@@@@@............@.................@.@..........@@@@..............................
@@@@@@@@@@@@.@....@@@............@............@@.....@@@@@@...........................
@@@@@@@@@@@@@....@@@@..@.....................@@@@....@@@@@@.............@@@...........
@@@@@@@@@@@@@....@@@@.@@@..................@.@@@@@@@.@@@@@@.............@@@..........@
@@@@@@@@@@@@@@..@@@@@@@@@@@.@..............@@@@@@@@@@@@@@@@............@......@.......
@@@@@@@@@@@@@@@@@@@@@@@@@@@......@.......@.@@@@@@@@@@@@@@@@............@..............
@@@@@@@@@@@@@@@@@@@@@@@@@@@....@............@@@@@@@@@@@@@@@...........@@..............
@@@@@@@@@@@@@@@@@@@@@@@@@@@.................@@@@@@@@@@@@@.........@@@@................
@@@@@@@@@@@@@@@@@@@@@@@@@@@.....@..........@@@@@@@@@@@@@@@......@@@@@@@...............
@@@@@@@@@@@@@@@@@@@@@@@@@@@@........@....@@@@@@@@@@@@@@@@@@....@@@@@@@@..@.@..@..@@..@
8
53 72 0
58 23 0
51 46 0
62 20 0
71 24 0
42 37 0
41 26 0
4 19 0

61 77 0
68 23 0
2 15 0
77 84 0
40 38 0
81 3 0
85 84 0
0 7 0
