width 86
height 86
@@@@@@@@@@@@@@@@@@@@.............@...........@@.@.....@...@......@@@.@@@@@@@@....@@@@@
@@@@@@@@@@@@@@@@@@@@...@.................................@@......@@...@@@@@@@..@@@@@@@
@@@@@@@@@@@@@@@@@@@@@..@@...........@@@@@.................@.....@@......@@@....@@@@@@@
@@@@@@@@@@@@@@@@@@@@@...@@............@....@@...................@@.....@@@@@...@@@@@@@
@@@@@@@@@@@@@@@@@@@@@@@@@@@...........@@......................@...........@.....@@@@@@
@@@@@@@@@@@@@@@@@@@@........@@@@..@@...@.....@@.....@@..........................@@@@@@
@@@@@@@@@@@@@@@@@@@@@........@@@.@@..@@@......@......@...@........@....@......@@@@@@@@
@@@@@@@@@@@@@@@@@@@@@@..@.....@@.@@@@@@@@............@.......@@.............@....@@@@@
@@@@@@@@@@@@@@@@@@@@@@...........@@@@@@@@@@@.................@@...@...............@@@@
@@@@@@@@@@@@@@@@@@@@@@............@@@@@@@@@@.........................@@@...........@@@
@@@@@@@@@@@@@@@@@@@@@@........@...@@@@@@@@@......................@...@@@@....@...@@@@@
@@@@@@@@@@@@@@@@@@@@@@............@@@@@@.............................@@@.........@@@@@
@@@@@@@@@@@@@@@@@@@@@@......@.....@@@@@@..............@.............@@@@.........@@@@@
@@@@@@@@@@@@@@@@@@@@@@....@......@@@@@@@@......@@........@.@.......@@............@@@@@
@@@@@@@@@@@@@@@@.@@@@@......@....@@@@@@@@.......@..........@.@.....@..............@@@@
@@@@@@@@@@@@@@@@....@@@.....@......@@@@@@...@.@@@@................................@@@@
@@@@@@@@@@@@@@@@.................@.@@@@@@........@...........@..........@...........@@
@@@@@@@@@@@@@@@@.....@...........@.....@@@..@.@.............@@..........@.............
@@@@@@@@@@@@@@@@...........@.....@.....@@@@...@@.......@....@..@......................
@@@@@@@@@@@@@@@@..................@............@@......@....@..@.........@......@.....
@@@@@@@@@@@@@@@..............................@.@@@.@.............@..............@....@
@@@@@@@@@@@@@@.............@....................@@@@.....@............@....@....@....@
@@@@@@@@@@@@@@...@....@@..........................@.........@..................@@.@.@@
@@@@@@@@@@@@.....@...........@..............@..................@..........@....@@...@@
@@@@@@@@@@@@.................@@@@...........@.........@..@.............@@@..@..@@.....
@@@@@@@@@@@@...............@@...@........................@........@@...@@@@@@@@@...@..
@@@@@@@@@@@@...@@@@.........@..............@.........@............@@...@@@@@@@@@..@@@@
@@@@@@@@@@@@@....................@.........@@......@...........@@@.....@@@@@@@@@..@@@@
@@@@@@@@@@@@@.........@......@...@..........@...................@.......@@@@@@@@.@@@@@
@@@@@@@@@@@@..........@@..............@@.....@..........................@@@@@@@@@@@@@@
@@@@@@@@@.....@.....@.@@..@.@@@.......@@.............@@@.........@.....@@@@.......@@@@
@@@@@@@@@@@......@@...@@...@@@.........@..@............................@@@..........@@
@@@@@@@@@@@.......@........@@@.....................@..................................
@@@@@@@@@@@@...............@@@..@.........@..............@...........@................
@@@@@@@@@@@.........@@@@...@@..........@.................@........................@@@@
@@@@@@@@@@....@.....@@.......@@........@............................@@.........@@@@@@@
@@@@@@@@........................................@..@..............@.@..........@@@@@@@
@@@@@@@@.......@.@...........@....................@..@.........@....@..........@@@@@@@
@@@@@@@..@............................@..............@.....@@@@@.........@.......@@@@@
@@@@@...@@.......@@...@......................@...@....@..@.....@............@....@@@@@
@@@@@@..@.......@@@...@..@.@.......@..@....@....@@....@...................@@@@...@@@@@
@@@@@@@.....@.@@@@...@@@@@..@..............@@..........@..................@@....@@@@@@
@@@@@@.....@@.@@@@..@@@@@...@...........@..@@.......@......@.@@....@......@@@@@@@@@@@@
@@@@........@.@@@@@@@@@@....@..............@@.................@.............@@@@@@@@@@
@@@@........@.@@@@@@@@@....@.........................@.................@@...@@@@@@@@@@
@@@@..........@@@@@@@@@..............@....@..@@....@.............@.......@@@@@@@@@@@@@
@@@@...........@@@@@@@@......................................@@.........@@@@@@@@@@@@@@
@................@@@@@.........@.....@.@@...........@.................@.@@@@@@@@@@@@@@
@....@@...........@@@@....@@...@.....@@@@.....@.....@...@.............@@@@@@@@@@@@@@@@
.....@@...........@@@@..............@@@@@......@.............@........@@@@@@@@@@@@@@@@
..............@@@..@@@..............@..@@@...@@@.............@.........@@@@@@@@@@@@@@@
@....@@.........@..@@@...@...................@@@...@....@@............@@@@@@@@@@@@@@@@
...@.........@....@@@@.......@................@@................@.....@@@@@@@@@@@@@@@@
..........@.@.....@@@@...@@......@........@..@@@@@....................@@@@@@@@@@@@@@@@
...@@.@....@@.....@@.@@.............@@.......@@@@@..............@.....@@@@@@@@@@@@@@@@
...........@@........@@......................@@@@@.@...@@@....@@@@@@@@@@@@@@@@@@@@@@@@
..........@@@........@.............@@@......@@@@@@.@@@..@@....@@@@@@@@@@@@@@@@@@@@@@@@
..................................@@@@.@.....@@@@@@@@@..@@....@@@@@@@@@@@@@@@@@@@@@@@@
.................@........@.@@....@.........@@@@@@@@@@..@@@@@@@@@@@@@@@@@@@@@@@@@@@@@@
......@@@.......@........@.@@@@@...........@@@@@@@@@@@@..@@@@@@@@@@@@@@@@@@@@@@@@@@@@@
......@@..............@..@..@@...............@@@@@@@@@@...@.@@@@@@@@@@@@@@@@@@@@@@@@@@
...@@..@..@@.......@..@.......................@@@@@@@@.........@@@@@@@@@@@@@@@@@@@@@@@
...@@...............@.@@..@@..............@...@@@@@@@...........@@@@@@@@@@@@@@@@@@@@@@
...@@@@....@.@...@@.....@@@...............@@@@@@@@@@@..........@@@@@@@@@@@@@@@@@@@@@@@
...@@@.@.........@......@@@....@......@...@@@@@@@@@.....@@@@@@@@@@@@@@@@@@@@@@@@@@@@@@
.@@@@@...........@......@@@...............@@@@@@@@@.....@@@@@@@@@@@@@@@@@@@@@@@@@@@@@@
.......................@@@@...............@@............@@@@@@@@@@@@@@@@@@@@@@@@@@@@@@
..@......@.............@@@@@...........................@@@@@@@@@@@@@@@@@@@@@@@@@@@@@@@
.......................@@@@@...........................@@@@@@@@@@@@@@@@@@@@@@@@@@@@@@@
....@@@@.@...@..........@@@@...........................@@@@@@@@@@@@@@@@@@@@@@@@@@@@@@@
@@@.@@@@@@...@.........@@@@@......@@...........@@@......@@@@@@@@@@@@@@@@@@@@@@@@@@@@@@
@@@@@@@@.........@.......@@@...@............@..@@.......@@@@@@@@@@@@@@@@@@@@@@@@@@@@@@
@@@@@@@..........@@@......@@...........@@@..@@@@@.......@@@@@@@@@@@@@@@@@@@@@@@@@@@@@@
@@@@@@.....@@.............@..@.......@..........@.@.......@@@@@@@@@@@@@@@@@@@@@@@@@@@@
@@@@@@@..@..@..................@..@@@@@........@@@@.@......@@@@@@@@@@@@@@@@@@@@@@@@@@@
@@@@@@@.......@........@.@........@@@@@....................@@@@@@@@@@@@@@@@@@@@@@@@@@@
@@@@@@..........@......@...@@...@@@@@@@.@..................@@@@@@@@@@@@@@@@@@@@@@@@@@@
@@@@@..................@......@...@@@@@................@@@.@@@@@@@@@@@@@@@@@@@@@@@@@@@
@@@@@@@@@@....@..........@........@@@@...................@@@@@@@@@@@@@@@@@@@@@@@@@@@@@
@@@@@@@@@@@.......@...........@@@..@@@....@.......@@......@@@@@@@@@@@@@@@@@@@@@@@@@@@@
@@@@@@@@@@@........@@.........@...................@@@......@@@@@@@@@@@@@@@@@@@@@@@@@@@
@@@@@@@@@@@........................@..........@@@@@@@@.....@@@@@@@@@@@@@@@@@@@@@@@@@@@
@@@@@@@@@@@...@..........@....................@@@@@@@...@.@@@@@@@@@@@@@@@@@@@@@@@@@@@@
@@@@@@@@@@@@.......@@@....@....@..............@@@@@@@..@@@@@@@@@@@@@@@@@@@@@@@@@@@@@@@
@@@@@@@@@@@..........@.@.......@@............@.@@@@@@@@@@@@@@@@@@@@@@@@@@@@@@@@@@@@@@@
@@@@@@@@@@@.......@.@@@@..........@...@........@@@@@@@@@@@@@@@@@@@@@@@@@@@@@@@@@@@@@@@
8
32 7 0
37 35 0
37 53 0
16 63 0
38 80 0
57 18 0
38 58 0
59 62 0

44 0 0
13 24 0
34 28 0
37 17 0
54 33 0
14 83 0
71 13 0
22 3 0
