width 86
height 86
@................@@@.@@@@@@@....@@@@@@@@@@@@@@@@@@@@@@@@.@@..@@@@@@@@@@@@@@@@@@@@@@@@@
..............@...@@..@@@@@@....@@@@@@@@@@@@@@@@@@@@@@@@.@...@@@@@@@@@@@@@@@@@@@@@@@@@
.........@....@@......@@@@@@@....@@@@@@@@@@@@@@@@@@@@@@@.....@@@@@@@@@@@@@@@@@@@@@@@@@
@.......@@..............@@@@.....@@@@@@@@@@@@@@@@@@@@@@@@...@@@@@@@@@@@@@@@@@@@@@@@@@@
@@...@@.@@.........@....@@.@.....@@@@@@@@@@@@@@@@..@@@@......@@@@@@@@@@@@@@@@@@@@@@@@@
@@.....................@@@.@......@@@@@@@@@@@@.@@...@........@....@@@@@@@@@@@@@@@@@@@@
@...............@....@...@......@@@@..@@@@@@@.....@@@......@......@@@@@@@@@@@@@@@@@@@@
@..@............@.............@.@@@..@@@@@@@..@.@.@.@.....@....@....@@@@@@@@@@@@@@@@@@
@@@@@.......@@.............@@........@@@@@@.....@..............@.....@@@@@@@@@@@@@@@@@
@@@@@@......@@@..................@......@.@.........@................@@@@@@@@@@@@@@@@@
@@@@@@......@@@@..@......@......................@...@@..@.............@@@@@@@@@@@@@@@@
@@@@@@.......@@.....................................@@@@@..............@@@@@@@@@@@@@@@
@@@@@@......@@@.@............@...................@.@@@@.................@@@@@@@@@@@@@@
@@@@@@..@@..@@@@@@@...................@............@@@@..................@@@@@@@@@@@@@
@@@@@@..@@@@@@@@@@@....@@....................@....@@@@.........@.......@@@@@@@@@@@@@@@
@@@@@@@@@@@@@@@@@@@@....@@@@@@@..............@....@.@.................@@@@@@@@@@@@@@@@
@@@@@@@@@@@@@@@@@@@.....@@@@@.........@......@@@....@................@@@@@@@@@@@@@@@@@
@@@@@@@@@@@@@@@@@.......@@@@@.....@.@@.......@..........@@...........@@@@@@@@@@@@@@@@@
@@@@@@@@@@@@@@@@@.......@@@..................@.........@@@@.@......@@@@.@@@@@@@@@@@@@@
@@@@@@@@@@@@@@@@@@......@@.............@.................@@@@......@@@@........@@@@@@@
@@@@@@@@@@@@@@@@@@@@...............@@......@..............@@........@..........@@@@@@@
@@@@@@@@@@@@@@@@@@@@...............@@......@........@..@@@@.............@@..........@@
@@@@@@@@@@@@@@@@@@@...@...@..@...@@@....@@@@....@@.....@@@@@.........@..@............@
@@@@@@@@@@@@@@@@@@@..............@@@...@@@@@@@...@.....@@@@@...................@...@@@
@@@@@@@@@@@@@@@@@@@...............@..@@@@@@@@@.@.@......@.@@................@..@..@@@@
@@@@@@@@@@@@@@@@@@@...............@....@@@@@@@......@.@@@..@..................@@..@@@@
@@@@@@@@@@@@@@@@@@@@@@@....................@@@........@@...@@@...............@@@@@@@@@
@@@@@@@@@@@@@@@@@@@@@@@.@@@............@...@@@.............@@..@@........@@..@@@@@@@@@
@@@@@@@@@@@@@@@@@@@@@@@@@@..............@.@@............@.......@..............@@@@@.@
@@@@@@@@@@@@@@@@@@@@@@@@@@@..........................@.........................@.@@@..
@@@@@@@@@@@@@@@@@@@@@@@@@@@..........................@@.@............@.........@..@@@.
@@@@@@@@@@@@@@@@@@@@@@@@@@@@@...........@@@.............@............@@..@..@.........
@@@@@@@@@@@@@@@@@@@@@@@@@@@@.......@....@@@...........@...@......@.@@@...............@
@@@@@@@@@@@@@@@@@@@@@@@@@@@......@.@@.......@........@....@........@.........@....@@.@
@@@@@@@@@@@@@@@@@@@@@@@@@@@@.......@@........................................@....@@@.
@@@@@@@@@@@@@@@@@@@@@@@@@@@@....................@@.....@@.........................@...
@@@@@@@@@@@@@@@@@@@@@@@@@@@@...........@.............@.....@......@...................
@@@@@@@@@@@@@@@@@@@@@@@@@@...@......@................@@........@..@@....@.............
@@@@@@@@@@@@@@@@@@@@@@@@@@@..........................@@...@.@....@@@...@@@..@.........
@@@@@@@@@@@@@@@@@@@@@@@@@@@.........................@@@..........@@.....@@............
@@@@@@@@@@@@@@@@@@@@@@@@@@@.....@@@.@@......@@...@..............@....@.@..............
@@@@@@@@@@@@@@@@@@@@@@@...........@.....@@@@@@@@.@@@.................@................
@@@@@@@@@@@@@@@@@@@@@@...@@@..............@@@@@@@@@@...........@...................@@.
@@@@@@@@@@@@@@@@@@@@@@....@@..........@@..@@@@@@@@@@.@@............................@@@
@@@@@@@@@@@@@@@@@@@@@@.....................@@@@@@@@@@@.......................@......@@
@@@@@@@@@@@@@@@@@@@@.....@@....@...@......@@@@@@@@@@@@@@.............@.......@@....@@@
@@@@@@@@@@@@@@@@@@@....@@@............@..@...@@@@@@@@@..@............@......@@@....@@@
@@@@@@@@@@@@@@@@@@...............@....@..@....@@@@@..................@.............@.@
@@@@@@@@@@@@@@@@@@.@.......@..........@......@@.........................@.............
@@@@@@@@@@@@@@@@@..@@......@.......@@........@..............@@@....@..........@.@.....
@@@@@@@@@@@@@@@@@@.@.@@...........@@..........@...@@...@...........@@@........@@@.....
@@@@@@@@@@@@@@@@@@@@.........@.........@...............@...............@..@...@@@@@@@@
@@@@@@@@@@@@@@@@@@@@...................@@.......@......@........@......@@..@@@@@@@@@@@
@@@@@@@@@@@@@@@@@@@@........@..@......@@@..............@@..............@...@@@@@@@.@@@
@@@@@@@@@@@@@@@@@@@................@...................@@.............@@@..........@@@
@@@@@@@@@@@@@@@@@@@............@...@@...............@..@@@@.@.........@@..............
@@@@@@@@@@@@@@@@@.................@@.....@@.........@..@@@@@@@........@..........@....
@@@@@@@@@@@@@@@@........@.................@........@@@@@@@@@@@......@@....@...........
@@@@@@@@@@@@@@@....@.................................@@@@@@..@.@...................@@.
@@@@@@@@@@@@@@@@...@@.....................@.....@.........@.................@@@@......
@@@@@@@@@@@@@@@@@@..@....@...@................@...........................@@@@@@...@@.
@@@@@@@@@@@@@@@@@............................@@....@.....................@@@@@@@@@@...
@@@@@@@@@@@@@@@@..........................@..@@.......................@..@@@@@@@@@@.@@
@@@@@@@@@@@@@@@@..@@@.......@..@@.@@..........@.......@..............@@.@@@@@@@@@@@@@@
@@@@@@@@@@@@@@@@@@@@@@@@...@@...........@........@....@..............@@@@@@@@@@@@@@@@@
@@@@@@@@@@@@@@@@@@@@........@...........@@@@.....@....@@..........@@.@@@@@@@@@@@@@@@@@
@@@@@@@@@@@@@@@@@@@@.@@.@..@@............@@..........@@@...@..@..@@@.@@@@@@@@@@@@@@@@@
@@@@@@@@@@@@@@@@@@@@.@@.@........@.@.....@@......@.........@..@@@@@@@@@@@@@@@@@@@@@@@@
@@@@@@@@@@@@@@@@@@@@...............@@.@@@@@@........@.....@..@@@@@@@@@@@@@@@@@@@@@@@@@
@@@@@@@@@@@@@@@@@@@@@..............@@@@@@@@@..................@@@@@@@@@@@@@@@@@@@@@@@@
@@@@@@@@@@@@@@@@@@@@@@.......@......@@@@@@@..........@.........@@@@@@@@@@@@@@@@@@@@@@@
@@@@@@@@@@@@@@@@@@@@@@@@..............@@@@...............@......@@@@@@@@@@@@@@@@@@@@@@
@@@@@@@@@@@@@@@@@@@@@@@@.......@@@@...@@@@.........@@...........@@@@@@@@@@@@@@@@@@@@@@
@@@@@@@@@@@@@@@@@@@@@@@........@@@@@.@@@@........@@@@......@...@.@@@@@@@@@@@@@@@@@@@@@
@@@@@@@@@@@@@@@@@@@@@.@...@.....@@@@@@@..........@@@@............@@@@@@@@@@@@@@@@@@@@@
@@@@@@..@@@@@@@@@@@@.........@@.@@@@@@@............@...@.........@@@@@@@@@@@@@@@@@@@@@
@@@@@@....@@@@@@@@@@.........@@@@@@@@@@..........................@@@@@@@@@@@@@@@@@@@@@
@@.............@......@.....@@@@@@@@@@@.......@.........@@@........@@@@@@@@@@@@@@@@@@@
@.....@@@.....@......@@.....@@@@@@@@@@@..........@......@@@.......@@@@@@@@@@@@@@@@@@@@
@.....@@@@.....................@@@@@@@@..........@.....@@..........@@@@@@@@@@@@@@@@@@@
@.....@@@@...@.................@@@@@@@@...@@@......................@@@@@@@@@@@@@@@@@@@
......@@@@@@@@..................@@@@@@@.@@@@@......................@@@@@@@@@@@@@@@@@@@
.....@@@@@@@@@.....@...............@@@...@@@@.....@@@@.....@.@.....@@@@@@@@@@@@@@@@@@@
.....@@@@@@@@@@....................@@@...@@@......@@@..@@..@.......@@@@@@@@@@@@@@@@@@@
......@@@@@@@@@...@.............@..@@@...@@@@...@@@@@@@@@...........@@@@@@@@@@@@@@@@@@
....@@@@@@@@@@@@..@@..@@@.@....@@..@@@@..@@@@@@@@@@@@@@@@............@@@@@@@@@@@@@@@@@
8
49 32 0
32 2 0
48 37 0
52 60 0
23 74 0
57 12 0
48 66 0
82 48 0

80 60 0
27 60 0
56 42 0
19 57 0
69 27 0
42 29 0
20 5 0
38 82 0
