width 86
height 86
@@@@@@@@@@@@@@@@@@@@@@@@@@@@@@@@@@@@@@.@@..@@@@@@@@@@@@@@......@@@@@@@@@@@@@@@@@@@@@@@
@@@@@@@@@@@@@@@@@@@@@@@@@@@@@@@@@@@@@..@@..@.....@@@@@@@@......@@@@@@@@@@@@@@@@@@@@@@@
@@@@@@@@@@@@@@@@@@@@@@@@@@@@@@@@@@@@...@@..@@....@@@@@@@@......@@@@@@@@@@@@@@@@@@@@@@@
@@@@@@@@@@@@@@@@@@@@@@@@@@@@@@@@@@@..............@@@@@@....@.....@@@@@@@@@@@@@@@@@@@@@
@@@@@@@@@@@@@@@@@@@@@@@@@@@@@@@@.................@@@@@............@@@@@@@@@@@@@@@@@@@@
@@@@@@@@@@@@@@@@@@@@@@@@@@@@@@@@.................@@@@@..........@@@@@@@.....@@@@@@@@@@
@@@@@@@@@@@@@@@@@@@@@@@@@@@@@@@@......@....@........@@........@.............@@@@@@@@@@
@@@@@@@@@@@@@@@@@@@@@@@@@@@@@@@@@@.............@..............@@@..........@@@@@@@@@@@
@@@@@@@@@@@@@@@@@@@@@@@@@@@@@@@@@...........@................@@@..@.........@@@@@@@@@@
@@@@@@@@@@@@@@@@@@@@@@@@@@@@@@.@@.................@@..........@@............@@@@@@@@@@
@@@@@@@@@@@@@@@@@@@@@@@..@@@.......................@..........@@@.........@@@@@@@@@@@@
@@@@@@@@@@@@@@@@@@@@@@...........@.................@.........@@@@...@.......@@@@@@@@@@
@@@@@@@@@@@@@@@@@@@@@@........@.@@.................@........@@@@..@.........@@@@@@@@@@
@@@@@@@@@@@@@@@@@@@@@@@......@@..@...@............@@......@@@@@..............@@@@@@@@@
@@@@@@@@@@@@@@@@@@@@@@@......@@...................@........@@@@......@.......@@@@@@@@@
@@@@@@@@@@@@@@@@@@@@@@......@@@.........@..................@@@..@............@@@@@@@@@
@.@@@@@@@@@@@@@@@@@@@@......@@@.......@......................@...........@@@@@@@@@@@@@
@.....@@@@@@@@@@@@@@@@.............@..@..............@..@@@..@...........@@@@@@@@@@@@@
@...@.@@@@@@@@@@@@@@@....@........................@@@@@@@@..@............@@@@@@@@@@@@@
......@@@@@@@@@@@@@@@...@@.......................@@@@@@@@@@........@@@@..@@@@@@@@@@@@@
......@@@@@@@@@@@@@@@@@@@@........@..............@@@@@@..@........@@@...@@@@@@@@@@@@@@
.@..@.@@@@@@@@@@@@@@@@@@@@......................@@@@@@..@........@@@@...@@@@@@@@@..@@@
..@@@..@@@@..@@@@@@@@@@@@@..@............@....@.@@@@@@.....@@@@..@@@@...@@@@@@@....@@@
.@.....@@@..@@@@@@@@@@@@@@@@@........@....@@@@@@@@@@@.........@@@@@@....@.@@.....@.@@@
@@@...@@....@@@@@@@@@@@@@@@@@@.........@.........@@@......@.....@@@@@..............@@@
@@@............@@@@@@@@@@@@@@.....................@@.....@@.....@@@@@..............@@@
@@................@@@@@@@@@@@.....@@.....@....................@.@@@@...............@@@
@@@.................@..@@.@@@............@.........................@........@@@@....@@
@@@@................@..@@.@.....@...........@...........@.......@.............@@....@@
@@@@.....@............................@....@@......@@@@.........@@@@...........@......
@@@@...........................@....@@@@@...........@@@@..@......@.........@@@....@...
@@@@.............@......@............@@@............@@@@.............@............@...
@@@@..@.............@................@@@@@..........@@@@.......@.....@@...............
@@@@@.@@......@...@@......@...........@@@@...........................@@@.............@
@@@@@@@@......@@@@@@.........@....................@...........@@......................
@@@@@@@@@.....@..........@......@.....................@@@@@...............@....@@.....
@@@@@@@@@@...................@......@.................@@@@@@@...............@.........
@@@@@@@@@@.........................@...@.............@@@@@@@@.....@....@@.............
@@@@@@@@@.............@..............@.@.............@@@@@@@@@.......@@@..............
@@@@@@@@..............@..@.@@.........@@@..............@.@@@@.........@@..............
@@@@@@@@......@@.........@@@..........................@@...@@@.........@..............
@@@@@@@@@@@..@...@.........@..........................@@...@@@....@...................
@@@@@@@@@@@..@...............@.......................@@@..............................
@@@@@@@@@@@@..............................@........@@@@@.............@.@.....@@.......
@@@@@@@@@@@@....@...@@.@.............................@@@...............@@...@@..@@....
@@@@@@@@@..@...@@...@@...............@@...............@@........................@.....
@@@@@@@@...@@.....@.@@...@.......................@@@..@@@@@..@........................
@@@@@@@@..........@@@@..@@@@.......@.......@........................................@.
@@@@@@@@..........@@.@....@@@@@..@.@..........................@..........@@.@.........
@@@@@@@@..@.......@@.....@@@@@@@@@............................@@.....................@
@@@@@@@@@...........@..@@@@@@@@@@.....................................@....@@.........
@@@@@@..@................@@@@@.....................@....@.......@@@@@@.........@@.....
@@@@@@....................@.......@@@...................@...@.....@@@@@@.@@....@@.....
@@@@@............@................@@@@...........@@@@@@...........@@@@.........@......
@@@@..................@.@...@.....@@............@@@@@@@@...........@@..........@......
@@@..@.......@....@.....@@@........@....@@@@@@..@@@@@@@@......................@@@.....
@@....@..............@...@@@.@@..........@..@@@@@@@@@@@@@@...........@.........@......
@@.....@.........@......@@@...........@@.....@@@@@@@@@@@.........@.............@@.....
@..................@.....@@..@....@@@@@@@....@@@@@@@@@@@....@..@.@.................@@@
@........@.........@@@...@@@.@@..@@@@@@@@@...@@@@@@@@@@@@@..@.............@........@@@
..............@@@.......@@@@........@@@@@@@@@@@@@@@@@@@@@@..@@............@...@....@@@
...@@.......@.@@@..........@...........@@@@@@@@@@@@@@@@@@@@@@.................@@...@@@
.........@.....@@....@.......@@.......@@@@@@@@@@@@@@@@@@@@@@@@.....@..........@@.@@@@@
.....@..@@@@.........@....@@@@@@@.....@@@@@@@@@@@@@@@@@@@@@@@@.....@..........@@.@@@@@
.......@@@@@.........@@....@@@@@@@....@@@@@@@@@@@@@@@@@@@@@@@@@..........@@@@@@@@@@@@@
........@@@@...............@@@@......@@@@@@@@@@@@@@@@@@@@@@@@@@..........@@@@@@@@@@@@@
.........@@@@...................@....@@@@@@@@@@@@@@@@@@@@@@@@@@.@@..@@@@@@@@@@@@@@@@@@
.........@@@@@@.........@......@@@@..@@@@@@@@@@@@@@@@@@@@@@@@@@@@@...@@@@@@@@@@@@@@@@@
...@.....@@@@@......@..........@@@@..@@@@@@@@@@@@@@@@@@@@@@@@@@@@@..@@@@@@@@@@@@@@@@@@
@..@........@@@.............@@..@@@@@@@@@@@@@@@@@@@@@@@@@@@@@@@@@@@@@@@@@@@@@@@@@@@@@@
@@.........@@@......@.....@.@@@@@@@@@@@@@@@@@@@@@@@@@@@@@@@@@@@@@@@@@@@@@@@@@@@@@@@@@@
@@@............@..........@@@@@@@@@@@@@@@@@@@@@@@@@@@@@@@@@@@@@@@@@@@@@@@@@@@@@@@@@@@@
@@@@..............@@......@@@@@@@@@@@@@@@@@@@@@@@@@@@@@@@@@@@@@@@@@@@@@@@@@@@@@@@@@@@@
@@@.......................@@@@@@@@@@@@@@@@@@@@@@@@@@@@@@@@@@@@@@@@@@@@@@@@@@@@@@@@@@@@
@@.........................@@@@@@@@@@@@@@@@@@@@@@@@@@@@@@@@@@@@@@@@@@@@@@@@@@@@@@@@@@@
@@.......@...............@.@@@@@@@@@@@@@@@@@@@@@@@@@@@@@@@@@@@@@@@@@@@@@@@@@@@@@@@@@@@
.@..@.....@..@............@@@@@@@@@@@@@@@@@@@@@@@@@@@@@@@@@@@@@@@@@@@@@@@@@@@@@@@@@@@@
...@@.................@@@..@@@@@@@@@@@@@@@@@@@@@@@@@@@@@@@@@@@@@@@@@@@@@@@@@@@@@@@@@@@
...@@@@@..............@@@@@@@@@@@@@@@@@@@@@@@@@@@@@@@@@@@@@@@@@@@@@@@@@@@@@@@@@@@@@@@@
@..@@@@@..@@.........@@@@@@@@@@@@@@@@@@@@@@@@@@@@@@@@@@@@@@@@@@@@@@@@@@@@@@@@@@@@@@@@@
@@@@@@@@........@....@@@@@@@@@@@@@@@@@@@@@@@@@@@@@@@@@@@@@@@@@@@@@@@@@@@@@@@@@@@@@@@@@
@@@@@@@@.............@@@@@@@@@@@@@@@@@@@@@@@@@@@@@@@@@@@@@@@@@@@@@@@@@@@@@@@@@@@@@@@@@
@@@@@@@@.............@@@@@@@@@@@@@@@@@@@@@@@@@@@@@@@@@@@@@@@@@@@@@@@@@@@@@@@@@@@@@@@@@
@@@@@@@@@....@....@@..@@@@@@@@@@@@@@@@@@@@@@@@@@@@@@@@@@@@@@@@@@@@@@@@@@@@@@@@@@@@@@@@
@@@@@@@@@@@@@@....@@@@@@@@@@@@@@@@@@@@@@@@@@@@@@@@@@@@@@@@@@@@@@@@@@@@@@@@@@@@@@@@@@@@
@@@@@@@@@@@@@@...@@@@@@@@@@@@@@@@@@@@@@@@@@@@@@@@@@@@@@@@@@@@@@@@@@@@@@@@@@@@@@@@@@@@@
8
40 22 0
37 44 0
48 38 0
67 17 0
17 46 0
18 82 0
54 11 0
74 58 0

48 15 0
65 55 0
15 81 0
45 39 0
73 9 0
9 76 0
47 32 0
50 15 0
