width 86
height 86
@@@@@@@@@@@@@@@@@@@@@@@@@@.....@@@@@@@@@@@@@@@@@@@@@@@@@@@@@@@@@@@@@@@@@@@@@@@@@@@@@@@
@@@@@@@@@@@@@@@@@@@@@@@@@@..@@@@@@@@@@@@@@@@@@@@@@@@@@@@@@@@@@@@@@@@@@@@@@@@@@@@@@@@@@
@@@@@@@@@@@@@@@@@@@@@@@@@@..@@@@@@@@@@...@@@@@@@@@@@@@@@@@@@@@@@@@@@@@@@@@@@@@....@@@@
@@@@@@@@@@@@@@@@@@@@@@@@@....@@@@@@@@@...@@@@@@@@@@@@@@@@@@@..@@@@@@@@@@@@@@@@....@@@@
@@@@@@@@@@@@@@@@@@@@@@@@@....@.@@@@.......@@@@@@@@@@@@@@@@@@....@@@@@@@@@@@@@@...@@@@@
@@@@@@@@@@@@@@@@@@@@@@@@.........@@....@@@@@@@@@@@@@@@@@@@@@........@@@@@@...@...@@@@@
@@@@@@@@@@@@@@@@@@@@@@@@@@@.............@@@@@@@@@@@@@@@@@@@@@.......@@@.............@@
@@@@@@@@@@@@@@@@@@@@@@@@@@@@.....@@.......@@@@@@@@@@@@@@@@@@........@@@.............@@
@@@@@@@@@@@@@@@@@@@@@@@@@@@@.....@@......@@@@@@@@@@@@@@@@@@@@.......@@.............@@@
@@@@@@@@@@@@@@@@@@@@@@@@@@@@...............@@@@@@@@@@@@@@@@@@@......@@.@.........@.@@@
@@@@@@@@@@@@@@@@@@@@@@@@@@@@@..@...........@@@@@@..@@@@@@@@@@@......@@@@.....@.......@
@@@@@@@@@@@@@@@@@@@@@@@@@@@@................@@@@.......@@@@@@@.....@............@.....
@@@@@@@@@@@@@@@@@@@@@@@@@@@..............@..@@..........@@@@@..........@@....@..@@....
@@@@@@@@@@@@@@@@@@@@@@@@@@@...............................@@@..........@@..@@@.@@.....
@@@@@@@@@@@@@@@@@@@@@@@@@@@@.............@@@@.............@@@..................@@.....
@@@@@@@@@@@@@@@@@@@@@@@@@@@............@@@............................................
@@@@@@@@@@@@@@@@@@@@@@@@@@@@...........@@@@..@........................................
@@@@@@@@@@@@@@...@@@@...@.................@@........................@@@@..............
@@@@@@@@@@@@@@......@...@......@@@@@@.....@@....@......@............@@..@............@
@@@@@@@@@@@@@@....................@@@.........@@@...@.@@...........@@@..@@@...........
@@@@@@@@@@@@@@...............@....@@@.......@.@@..@@@..............@@@...@............
@@@@@@@@@@@@@@@@@...........@@....@@@@@........@......@@@..........@@@........@.......
@@@@@@@@@@@@@@@@..@@@........@@.@@@@@@@@@.....@@.......@@..........@@@.@.............@
@@@@@@@@@@@@@@@@@.........@@.@@@@@@@@@@@@@.........................@@......@@.@......@
@@@@@@@@@@@@@@@@@.........@@...@@@@@@@@@@@@........@..............................@@@@
@@@@@@@@@@@@@@@............@@..@@@@@@@@@@@@@..@....@@@.............@..............@@@@
@@@@@@@@@..@@@...............@@@@@@@@@@@@@@.@@@@@.....@......@@....@.......@......@@@@
@@@@@@@@@.@.@@...............@@@@@@@@@@@@@...@@@@.............@@....................@@
@@@@@@@@@...........@@.....@.@@@@@@@@@@@@@@@....@.................................@@@@
@@@@@@@@..@........@@......@@@@@@@@@..@@@@@@...............@@......@....@......@....@@
@@@@@@....@@@.........@..@.@@@@@@@@@..@@.....@@@...@@.....@...@@@@.@@.@......@..@@..@@
@@@@....@.@@@@.@.......@....@@@@@@@@.@@......@...@...@...@...@@@@..@................@@
@@@@...........@@@@....@..@@@@@@@@...@......................@@@@@.......@...........@@
@@@@...........@@@@..@.......@.@@@@...@...........@.@......@@@@@@.................@.@@
@@.............@@@......@.........@.....@...........@.......@@@@.......@@@..........@@
@.@.............@.....@@@@..............@.......@..........@@@@.........@@..........@@
..........@...........@@.........................@.......@.@@@@...@......@..........@@
.........................................@..........@@@@@..@@@.....................@@@
....@.............@......................@..........@@@@@...........@..........@@.....
...............@..@.@.....@.......@............@.....@@@.......@@..............@@...@@
........@......@..@.@.....@.......@............@@....@@@.......@@.@.........@..@....@@
........@.........@@@.......@@......@..........@@.....@........@@...........@@........
...................@@..............@..........@@@....@@.....................@@........
......@........@@..........................@@..@.....@@@@......@......................
.........@..........@.@.....................@.........@.....................@..@@...@.
@.............................@@@@@......@........................@.@@..@@@...........
..................@..@........@@@@.................@..............@......@.....@......
...@..@@.@@@.....@@..@.@...@@@@.@@....@@.......@.........@....@.............@@@@@@..@@
.......@@@@@....@@@@@@@@@@@@@@..@.................@@....@@...@@@...@........@@.@@@@@@@
........@@@@.....@@@@@@@@@...@.....................@..@@@@@@.@@@...............@@@@@@@
@@..@@@.@@@@@@...@.....@.....@.....................@@@@@@@@@@@@@...............@@@@@@@
@@@@@@@@@@@@@..........@.....@..@@@.........@@..@..@@@@@@@@@@@@@@.@............@@@@@@@
@@@@@@@@@@@.....................@@@.........@.....@@@@@@@@@@@@@@@@@...@@.........@@@@@
@@@@@@@@@@@......................@@..@...............@@@@@@@@@@@@@@...@.........@@@@@@
@@@@@@@@@@@@.....@...............@@@@..............@@@@@@@@@@@@@@@@..............@@@@@
@@@@@@@@@@@@..........@..........@@@.....@........@@@@@@@@@@@@@@..@.............@@@@@@
@@@@@@@@@@.......................@@@@@@@@@@@@.....@@@@@@@@@@@@@.................@@@@@@
@@@@@@@@@...@.....@..............@@@@@@@@@@@@.....@@@...@@@@@............@.....@@@@@@@
@@@@@@@@@...@....@@@..@@.....@@...@@..@.@@@...........@.................@....@@@@@@@@@
@@@@@@@@@.....@.@@@@..............@@....@@@...................................@@@@@@@@
@@@@@@@@@.........@@...........@..@.....@@@......@...........................@@@@@@@@@
@@@@@@@...........@.....................@........@..@......@......@@..@@...@@@@@@@@@@@
@@@@@@@@@.....@@@@@.....................@@.........................@..@.....@@@@@@@@@@
@@@@@@@@@@@@.....@@@.....@....@.......@..@.........................@..@.....@@@@@@@@@@
@@@@@@@@@@@@@@................@.................@......@.@@..................@@@@@@@@@
@@@@@@@@@@@........@.....................@......@........@@.@...............@@@@@@@@@@
@@@@@@@@@@@@...................@@...............@......@@@@@@.........@.....@@@@@@@@@@
@@@@@@@@@@.....@@.............@@@...................@@@@@@@@@.........@@.....@@@@@@@@@
@@@@@@@@@@............@..@.......@.....@............@@@@@@@@@@@...........@..@@@@@@@@@
@@@@@@.@@................@...........................@@..@@@@@@@.............@@@@@@@@@
@@@@@.....................@@@...............@.@@.....@...@@@@@@@@............@@@@@@@@@
@@@@....@..@................@.........@@.............@...@@@@@@@@............@@@@@@@@@
@@@@.@..@@@.................@...@.@.............@@......@@@@@@@@.......@.@@@..@@@@@@@@
@@.@....@@@...@......@......@...........................@@@@@@@@.........@@@@.@@@@@@@@
@...@..............................@...@..................@@@.@@.........@@@@@@@@@@@@@
@.............@............................................@.............@@@@@@@@@@@@@
.........@....@@...........@@.......@@...@@................@............@@@@@@@@@@@@@@
.............@@@@.....................@@@@...................@........@@@@@@@@@@@@@@@@
@@@...@@..............................@@@@............................@@@@@@@@@@@@@@@@
@@@..@@......................@@.......@@@@........@@.....@............@@@.@@@@@@@@@@@@
@@@.@@@@@@@....@.@@....@@@@@@.........@@@................@..................@@@@@@@@@@
@@@@@@@@@@@......@@@...@@@@@...........@@@@..@......@@................@.....@@@@@@@@@@
@@@@@@@@@@@...........@@@@@@......@.....@@@@@@...@............@..@@...@......@@@@@@@@@
@@@@@@@@@...........@.@@@@@@....@@@@...@@@@@@@...@............@...............@@@@@@@@
@@@@@@@@@........@@@@@@@@@@@@.....@@@@@@@@@@@@.........@@....@@......@@.......@@@@@@@@
@@@@@@@@@...@@@.@@@@@@@@@@@@@...@@@@@@@@@@@@@@..........@@........@..@@..@@@@@@@@@@@@@
8
46 45 0
38 81 0
65 65 0
35 68 0
72 37 0
47 14 0
76 84 0
15 74 0

52 84 0
58 32 0
26 0 0
24 21 0
59 32 0
48 12 0
69 26 0
61 43 0
