width 86
height 86
@@@@@@@@@@@@@@@@@@@@@@@@@@@@@.................@@@@@@@...........@@.......@@@@@@@@@@@@@
@@@@@@@@@@@@@@@@@@@@@@@@@@@@.............@.....@@@...............@..@.....@@@@@@@@@@@@
@@@@@@@@@@@@@@@@@@@@..@@@@@@...@.........@.....@@@.............@@@..@...@.@@@@@@@@@@@@
@@@@@@@@@@@@@@@@@@.@..@@@@@@...@................@....................@@@@@@@@@@@@@@@@@
@@@@@@@@@@@@@@@@@@....@@@@@..............@..................@........@@@@@@@@@@@@@@@@@
@@@@@@@@@@@@@@@@@@@....@@@@.................................@........@@@@@@@@@@@@@@@@@
@@@@@@@@@@@@@@@@@@@@@..@.......@@@.....................@....@@@.....@..@@@@@@@@@@@@@@@
@@@@@@@@@@@@@@@@@@@....@...............................@@.@@@@@.@........@@@@@@@@@@@@@
@@@@@@@@@@@@@@@@@@@.....................................@@@@@@@@@@@@.@@@...@@@@@@@@@@@
@@@@@@@@@@@@@@@@@@@@.....@............@.@...............@@@@@@@@@@.........@@@@@@@@@@@
@@@@@@@@@@@@@@@@@@@.....@@............@.@@.........@....@@@@@@@@@@.....@.....@@@@@@@@@
@@@@@@@@@@@@@@@@@@.......@............@............@@@@@@@@@@@@@@@............@@@@@@@@
@@@@@@@@@@@@@@.............@.....................@@@@@@@@@@@@@@@@....@@........@@@@@@@
@@@@@@@@@@@@@..........@...@...@@................@@@@@@@@..@@@@@@@.@@.......@@@@@@@@..
@@@@@@@@@@..@..@...........@...@.......@@........@@@@@@@...@@@@@@@...........@@@.@@@..
@@@@@@@..@....@@......@...............@....@......@@@@@@....@@@@@@....................
@@@@@@@....................@.................@@@@.@@@@@@...@@@@@@@@@@.....@@......@...
@@@@@@@............@..............@......@..@..@@....@@...@@@@@@@@@@@@.....@..........
@@@@@@............@@........@............@..@@............@@@@@@@@@@@@......@.........
@@@@@@@......@@@@@@@.@@@....@............@@.@@@@@...@.....@@@@@@@@@@........@.....@...
@@@@@@@@..@@@@@@@@@@...@@@@.@...@.@@.....@@@@@@@@@..........@@@@@@@@..@....@..........
@@@@@@@@...@@@@@@@@@@..........@@.@@@..@@@@@@@@@@@...@.....@@@@@@@@@..................
.@.........@@@@@@@@@@.........@..@@@@.@@@@@@@@@@@@.........@@@@@@@@@@......@@.........
...........@@@@@@@@@.............@@@@@@@@@@@@@@@@@........@@@@@@@@@@.......@@...@@@...
.@........@@@@@@@@@...............@@@@@@@@@@@@@@@@@@.......@@@@@@@@@@@@....@@@@.......
@@@........@@@@@@@@..............@@@@@@@@@@@@@@@@@@@@@......@@@@@..@@@........@.......
@@.........@@@@@@@@..............@@@@@@@@@@@@@@@@@@@@.......@.@.....@@................
@@..@......@@@@@@@@..............@@@@@@@@@@@@@@@@@@@@.....@..........@@.......@.......
@...@.......@@@@@................@@@@@@@@@@@@@@@@@@@@...@...........@@@......@@.......
@.@........@@@@@@.............@@@@@@@@@@@@@@@@@@@@@@@...@.......@....@@......@@.......
.........@..@@.@@@..@......@@@@@@@@@@@@@@@@@@@@@@@@@@@@@@@......@@...@@....@@.........
.............@............@@@@@@@@@@@@@@@@@@@@@@@@@@@@@@@@.....@@@........@@@........@
..@..........@..@@...@....@@@@@@@@@@@@@@@@@@@@@@@@@@@@@@@@@@@@@@@.....................
..@.............@@..@@....@@@@@@@@@@@@@@@@@@@@@@@@@@@@@@@@@@@@@@@@....................
.....................@....@@@@@.@@@@@@@@@@@@@@@@@@@@@@@@@@@@@@@@@................@....
.........................@@@@@..@@@@@@@@@@@@@@@@@@@@@@@@@@@@@@....................@@@@
@.@@@...........@.......@.@.........@@@@@@@@@@@@@@@@@@@@@@@@@@......@@.......@...@@@@@
@@@@@@.........@..@.......@.........@@..@@@@@@@@@@@@@@@@@@@@@....................@@@@@
@@@@@@@@@...........................@@..@@@@@@@@@@@@@@@@@@@....@@@......@@..@....@@@@@
@@@@@@@@@...@@...........@@.........@@..@@@@@@@@@@@@@@@@@......@@@.@@@..@@..@........@
@@@@@@@@...........................@@..@@@@@@@@@@@@@@@@@@.....@@@@.@@@.....@.........@
@@@@@@@@@..............@.....@.....@.....@@@@@@@@@@@@@@@@......@@@@@@@.....@.....@.@..
@@@.@@@...................@@.@...@.......@@@@@@@@@@@@@@@@......@@@....................
@@..@@@.......@@.........@@...@..........@@@@@@@@@@@@@@@@......@@@@@.................@
@@...@@......@@@.........@@@@............@@@@@@@@@@@@@@@@.......@@....................
@@.@...............@...@.@@@@........@...@@..@@@@@@@@@@@@@............................
@@@@.........@...........@@@@@...............@@@@@@@@@@@@@@.....................@.....
@@.......................@@@@@.................@@@@.@@@@@@@@@.........................
@@..@...................@@@@@@@@..@@@...@......@@@..@@..@@@........@..........@......@
@@@.........@............@..@@@...@@@...............@@............@@..................
@@@...............................@@@..........................@....@.................
@@@@.@.@.@@..@...@..@........@....@@@............@.....@@@@@...@...............@@.....
@@@@@@@@............@...@@@.@@@........@...............@@@..............@@@...@@@@...@
@@@@@@@@@@..............@@@@@@@..@........@..........@.........@@@.@..@@@@@..@@@@@@@@@
@@@@@@@@@@..............@@@@@@@........@....@@.................@@@....@@@@@@@@@@@@@@@@
@@@@@@@@@@..@..........................@....@@...................@....@@@@@@@@@@@@@@@@
@@@@.@@@@@......@................@@........@.......@.......@.......@..@@@@@@@@@@@@@@@@
@@@@...@@@...@@@..........@.....@@@..........@.....@...............@.@@@@@@@@@@@@@@@@@
@@@@....@@..@@@@...........@@@..@@@@..@.........@@@@@................@@@@@@@@@@@@@@@@@
@.......@@...@.@............@@@@@@...@..............@....@@@...@@....@@@@@@@@@@@@@@@@@
........@@...@......@....@...@@@@@......@.@@@.....@..........@.......@@@@@.@@@@@@@@@@@
........@.@....@....@.........@@@@@.......@@@@@.......@@..............@@@...@@@@@@@@@@
..........................@...@@@@.......@@@@@@..@.............@.....@@@@@...@@@@@@@@@
.......@...@......@................@..@@@@@@@@.........@..........@....@.....@@@@@@@@@
@@@.................................@@@@@@@@..........@..........@..@........@@@@@@@@@
@@@...@@............................@@@@.............@@@.@..@................@@@@@@@@@
@@....@@....@.....@.......................@....@.....@@@.........@...@.....@@@@@@@@@@@
@.............@...............@@.............@..@@@.....@.@................@@@@@@@@@@@
@.............@..........@....@@................@@@@............@@@....@@....@@@@@@@@@
@.............................@@....@...........@@@..@@.......@..@.....@.....@@@@@@@@@
.......@................@.....@...@@@...........@@@@@@@....@..........@.........@@@@@@
.....@@@.....@........@@@.@........@@@............@@@@............@@.@@.@.......@@@@@@
.......................@.............@@.............@@...@.....@@...............@@@@@@
.....@...@.........@.....@.....@@..@................@@...............@@@.........@@@@@
.@...................................................@@@.............@@@.....@...@@@@@
...@....................................@@...@@......@@@.@...........@@@.....@...@@@@@
....................@.@...@.@@..@@@.....@@...............@...........@@@.....@@@@@@@@@
....................@.@.....@...@@......@@...............@...........@@@..@@.@@@@@@@@@
@@.@......@@..........@......@@@@@@@@..@@@.....@.@....@...............@...@@@@@@@@@@@@
@...@....@@@@@..@@.............@@@@@@..............@.......@.........@@@@.@@@@@@@@@@@@
@.........@@@@@@@@...........@@@@@@@@.@.....@...@@@@..@..............@@@@@@@@@@@@@@@@@
@.........@@@@@@@@........@@.@@@@@@@@..........@..@.......@@@.@..@@.@@@@@@@@@@@@@@@@@@
@.........@@@@@@@@......@@@@@@@@@@@@@@.......@............@......@@@@@@@@@@@@@@@@@@@@@
...........@@@@@@......@@@@@@@@@@@@@@@..................@@@......@@@@@@@@@@@@@@@@@@@@@
..............@@@@.....@@@@@@@@@@@@@@@@.................@@@....@.@@@@@@@@@@@@@@@@@@@@@
@.@@@.........@@........@@@@@@@@@@@@@@@@.@@@......@@....@@@......@@@@@@@@@@@@@@@@@@@@@
8
40 41 0
13 66 0
35 52 0
30 5 0
65 57 0
66 64 0
47 4 0
62 82 0

57 15 0
8 48 0
36 47 0
67 61 0
27 4 0
1 67 0
5 34 0
47 79 0
