width 86
height 86
@@@@@@@@@@@@@@@@@@@@@@@@@@@@@@@@@@@@@@@@@@@@@@@@@@@@@@@@@@@@@@@@@@@@@@@@@@@@@.....@...
@@@@@@@@@@@@@@@@@@@@@@@@@@@@@@@@@@@@@@@@@@@@@@@@@@@@@@@@@@@@@@@@@@@@@@@@@@@@@.........
@@@@@@@@@@@@@@@@@@@@@@@@@@@@@@@@@@@@@@@@@@@@@@@@@@@@@@@@@@@@@@@@@@@@@@@@@@@@@@@@......
@@@@@@@@@@@@@@@@@@@@@@@@@@@@@@@@@@@@@@@@@@@@@@@@@@@@@@@@@@@@@@@@@@@@@@@@@@@@@@.@.....@
@@@@@@@@@@@@@@@@@@@@@@@@@@@@@@@@@@@@@@@@@@@@@@@@@@@@@@@@@@@@@@@@@@@@@@@@@@@@@@.......@
@@@@@@@@@@@@@@@@@@@@@@@@@@@@@@@@@@@@@@@@@@@@@@@@@@@@@@@@@@@@@@@@@@@@@@@@@@@@@@.......@
@@@@@@@@@@@@@@@@@@@@@@@@@@@@@@@@@@@@@@@@@@@@@@@@@@@@@@@@@@@@@@@@@@@@@@@@@@@@.......@@@
@@@@@@@@@@@@@@@@@@@@@@@@@@.@@@@..@@@@@@@@@@@@@@@@@@@@@@@@@@@@@@..@..@@@@@@@@..@.....@@
@@@@@@@@@@@@@@@@@@@@@@@@@@.......@@@@@@@@@@@@@@@@@@@@@@@@@@@@@...@..@@@@@@@@..@...@...
@@@@@@@@@@@@@@@@@@@@@@@@@@.......@...@@@@@@@@@@@@@@@@@@@@@@..........@@@@@@@..........
@@@@@@@@@@@@@@@@@@@@@@@@@@......@@...@@@@@@@@@@@@@@@@@@@@@...........@@@@@@@@.@......@
@@@@@@@@@@@@@@@@@@@@@@@.@@.........@@@@@@@@@@@@@@@@@@@@@......@.......@@@@@...@......@
@@@@@@@@@@@@@@@@@@@@@@@..@.........@@@@@@@@@@@@@@@@@@@@....@...........@@............@
@@@@@@@@@@@@@@@@@@@@@@...............@@@@@@@@@@@@@@@@@............@...............@..@
@@@@@@@@@@@@@@@@@@@@@@..................@@@@@@@@@@@@@@.....@@@@...@....@.............@
@@@@@@@@@@@@@@@@@@@@@@...........@......@@@@@@@@@@@@@@@......@@.......................
@@@@@@@@@@@@@@@@@@@@....@.@..........@...@.@@@@@@@@@@@@@....@@......@........@........
@@@@@@@@@@@@@@@@@@@@...........@...........@@@@@@@@@@@@......@@.@@........@@.....@....
@@@@@@@@@@@@@@@@@@@@.........................@.@@@@@@@@.......@...@........@..........
@@@@@@@@@@@@@@@@@@@@..............@.@..........@@@@@.......@@.....@...................
@@@@@@@@@@@@@@@@@@@@@.@.....@...@@@......@@@...............@@..@......................
@@@@@@@@@@@@@@@@@@@@.......@@.@..............@............................@...........
@@@@@@@@@@@@@@@@@@.......@.................@..................@@.......@@.@....@@.....
@@@@@@@@@@@@@@@@@@..................@@@@.@.......@........@@@@@@...@...@@.............
@@@@@@@@@@@@@@@@@@@@.................@....................@@@@@@..@....@@.............
@@@@@@@@@@@@@@@@@@@@@............................@........@@@@@................@@.....
@@@@@@@@@@@@@@@@@@@@@.....................................@@@@.............@...@...@..
@@@@@@@@@@@@@@@@@@@........................@..@........@@.@@@@.....@@.............@...
@@@@@@@@@@@@@@@@@@......@@.@.......................@@.......@.....@@@@@.........@@@@@@
@@@@@@@@@@@@@@@@........@..........@.@.............@@@.@@....................@..@@@@@@
@@...@@@@@@@@@@@@@................@@@@@@...........@@@.................@@......@@@@@@@
@@...@@@@@@@@@@@@@..............@.@@@.......@..............................@......@@@@
@@@@.@@..@@@@@@@@@@...............@@@......@@@..............@..@..@.............@@@@@@
@@@@....@@@@@@@@@@@.....@.........@@.....................@......................@@@@@@
@@@@....@@@@@@@@@@@@......@@.............................@.................@....@@@@@@
@@@@....@@@@@@@@@@@@..................@.@@...@.....@.@.....................@@...@@@@@@
@@@@.....@@@@@@@@@@@..@.....@.........@.@@...@@...@@@@@.......@......@......@@@@@@@@@@
@@....@..@@@@@@@@@@.........@..@@@@@@@@...@@.@@...@@@@@@......@@@@@..@..@....@@@@@@@@@
@@......@@@@@@@@@@.............@@@@@@@@.......@.@@@@@@@@@....@@@@@............@@@@@@@@
@@@@@@....@@@@@@@@.............@@@@@@@.....@....@@@.@.@@@.....@@@@......@....@@@@@@@@@
@@@@......@@@@@@@@@..@..............@@..........@@.....@@....@@@@@@@@@@@@...@@@@@@@@@@
@@............@@@@@@@...............@@@@.@@..@.@........@...@@@@@@@@@@@@@...@@@@@@@@@@
@..............@@@@@@......@........@@.......@.....@........@@@@@@@@@@@.......@@@@@@@@
@....@@.............................@.....@................@@..@@@@@.............@@@@@
.....@.........@.@.................@@...........@.....@@.......@@@@@.....@@.......@@@@
.@.@@..............................@............@.....@.......@@@@@@@............@@@@@
@................................@..........@...@@....@......@@@@@@..@...@.......@@@@@
....@.....@@@....@@@@...........@@...................................................@
......@@@@....@@@@@.........@@..@@...@..@............................................@
......@@@@@@@@@@@@..........@@...@.......@@.........@@.............@.................@
......@@@@@@@@@@@.................@@@...............@@...............@.....@@@........
.....@@@@@@@@@@@@@@.............@@@@@...............@@....@...........@.....@.........
@@@@@@@@@@@@@@@@@@@@..............@@@@.@..................@@@@........@.....@........@
@@@@@@@@@@@@@@@@@@@.....@......@@.@@@@@...@..................@.............@@.........
@@@@@@@@@@@@@@@@@......@@.@..........@....@..........................................@
@@@@@@@@@@@@@@@@@...........@..........................................@@@@..........@
@@@@@@@@@@@@@@@@@@@@@.............@..@.......@..........................@@@...........
@@@@@@@@@@@@@@@@@..@@...........@.........................@.............@@@...........
@@@@@@@@@@@@@@@@.........@@.....@.......@.....@...@@.........@......@..@@@............
@@@@@@@@@@@@@@@@................................@@@..............@@....@@@@...........
@@@@@@@@@@@@@@@@@@@.......................@@....@.......@........@@....@@@@....@@.@..@
@@@@@@@@@@@@@@@@@@@....@.................@...@..@.......................@@@..@.@.....@
@@@@@@@@@@@@@@@@@@@@.......................@..................................@@...@@@
@@@@@@@@@@@@@@@@@@@...@@@........@.........@.......................................@@@
@@@@@@@@@@@@@@@@@@@...@@@....@@...@@@@.....@............................@.@....@....@@
@@@@@@@@@@@@@@@@@@@@@@@@@..........@@@.................@....@.....@@@@....@...@.....@@
@@@@@@@@@@@@@@@@@@@@@@@@@.......@@.@.....@........@...............@@@@...@...........@
@@@@@@@@@@@@@@@@@@@@@@@@@@.......@@@..........@@.@@@....@.@.......@@@@...............@
@@@@@@@@@@@@@@@@@@@@@@.@.@@.......@........@..@@....@.....@......@@@@@@@.............@
@@@@@@@@@@@@@@@@@@@@@@.........@@@@@@.........@..@..@.....@..@@@@@@@@@@@@........@@@@@
@@@@@@@@@@@@@@@@@@@@@@.........@..@...........@@..............@@@@@@@@@@@...@....@@@@@
@@@@@@@@@@@@@@@@@@@@@@@@.......@..@@.....@.....@.............@@@@@@@@@@@@@@@....@@@@@@
@@@@@@@@@@@@@@@@@@@@@@@@..@....@...@.........@..........@@...@@@@@@@@@@@@@@@.@@@@@@@@@
@@@@@@@@@@@@@@@@@@@@@@@@...@..@..............@...@...........@@@@@@@@@@@@@@@@@@@@@@@@@
@@@@@@@@@@@@@@@@@@@@@@@@....@.........@...@@@@@@@@@...@......@@@@@@@@@@@@@@@@@@@@@@@@@
@@@@@@@@@@@@@@@@@@@@@@@@..............@...@@@@@@@@@..@@.......@@@@@@@@@@@@@@@@@@@@@@@@
@@@@@@@@@@@@@@@@@@@@@@@@@@@.@@..@.........@@...@@....@@@......@@@@@@@@@@@@@@@@@@@@@@@@
@@@@@@@@@@@@@@@@@@@@@@@@@@@@@@@@@.........@..........@@@@......@@@@@@@@@@@@@@@@@@@@@@@
@@@@@@@@@@@@@@@@@@@@@@@@@@@@@@@@@....................@@@@......@@@@@@@@@@@@@@@@@@@@@@@
@@@@@@@@@@@@@@@@@@@@@@@@@@@@@@@@@@.....@@.........@.@@@@@@@.@@@@@@@@@@@@@@@@@@@@@@@@@@
@@@@@@@@@@@@@@@@@@@@@@@@@@@@@@@@@.......@.......@@@@@@@@@@@..@@@@@@@@@@@@@@@@@@@@@@@@@
@@@@@@@@@@@@@@@@@@@@@@@@@@@@@@@@@@@..............@@@@@@@@@...@@@@@@@@@@@@@@@@@@@@@@@@@
@@@@@@@@@@@@@@@@@@@@@@@@@@@@@@@...........@.......@@@@@@.....@@@@@@@@@@@@@@@@@@@@@@@@@
@@@@@@@@@@@@@@@@@@@@@@@@@@@@@@@@.......@@@@@@@....@@@@@@..@..@@@@@@@@@@@@@@@@@@@@@@@@@
@@@@@@@@@@@@@@@@@@@@@@@@@@@@@@@@.......@@@@@@@@..@@@@@@@......@@@@@@@@@@@@@@@@@@@@@@@@
@@@@@@@@@@@@@@@@@@@@@@@@@@@@@@@@@......@@@@@@@@@..@@@@@.......@@@@@@@@@@@@@@@@@@@@@@@@
8
69 58 0
40 24 0
45 46 0
65 47 0
27 18 0
75 62 0
83 0 0
44 59 0

32 41 0
83 68 0
69 30 0
29 11 0
31 41 0
39 48 0
83 5 0
28 39 0
