width 20
height 42
.....@@.............
......@.............
......@@........@...
........@...........
.@.@..@....@.@......
.....@.@@.....@.@...
........@...........
............@.......
......@........@....
................@.@.
@...................
.......@...@.@.@.@..
....................
....@..@..@.........
.....@.......@......
...@........@....@..
.....@.....@........
.......@.@.......@..
....................
....@..@............
.....@.........@....
.........@..@.......
...@....@...........
....@...........@...
..........@.@..@....
.......@...........@
..............@.....
@............@......
@.......@......@..@.
@@..................
@@@...@....@.@......
@...@.......@..@....
................@...
..........@..@......
..@..@...@...@......
....................
....@.@..@.@........
....................
.......@...@@..@....
@.@...@@.........@..
@@@....@............
@@@....@.@....@@....
6
2 26 0
1 20 0
9 4 0
18 25 1
18 14 1
4 32 1

13 3 0
3 34 0
14 28 0
1 2 1
17 40 1
16 37 1
