width 20
height 42
....................
...................@
....................
@...@...............
@.@..@....@.........
....................
....@....@..........
....................
....@.@....@........
....................
...@...@............
..@.....@....@...@@@
....@..........@.@@@
........@......@.@@@
.............@....@@
@.....@..@..........
..@..@.....@.@.@....
...@................
.............@..@...
...@..@.............
...........@@.......
.@.............@.@..
....................
.........@..@.......
....................
......@.@.@.........
................@...
.......@....@.......
...@........@..@....
....................
.....@.......@.....@
..@.................
........@@..........
...............@....
....@....@..@.......
..@....@.......@....
.....@.@@.@.........
....................
........@..@........
....................
@@@.........@......@
@@@@..............@@
6
0 34 0
13 41 0
14 10 0
11 24 1
5 35 1
14 39 1

10 15 0
11 41 0
14 10 0
7 17 1
3 6 1
2 3 1
