width 20
height 42
@...................
..@.@........@......
...........@........
........@@..@.......
.@.....@@@.....@....
.@@.........@.......
..@.......@.........
@................@..
...............@....
.....@..@...@.......
...@................
.....@.....@........
...........@........
..@.................
..................@.
.....@.........@....
...@................
....@.@..........@.@
.........@......@...
...@................
....@..@............
....................
.........@.@........
..@.@.@.....@...@...
.......@............
..@............@..@.
.......@............
........@..@....@..@
....................
...@.......@...@....
.@..@.@..@...@...@..
...............@....
....................
.........@...@..@...
............@.......
...@................
....@.......@.......
@@...@@@.@......@...
@@..@.@@............
@@@...............@.
@@@.@@..............
@@@@@@@.............
6
16 4 0
16 9 0
10 5 0
16 25 1
7 14 1
6 12 1

10 38 0
11 37 0
11 17 0
13 27 1
5 22 1
14 9 1
