width 68
height 68
@@@@@@...........@@...@@@@@@@..........@@....@@@@@@@@@..@@@@@@@@@@@@
@@@@@@@........@.......@@@@@@..........@@..@@@@@@@@@@@.....@@@@@@@@@
@@@@@@@@................@@@@@....@@........@@@@@@@@@@@@....@@@@@@@@@
@@@@@@@@@...............@@@@.....@@@......@@@@.@@@@@@@.....@@@@@@@@@
@@@@@@................@@@@@.........................@......@@@@@@@@@
@@@@@...........@@.......@@...........@@.................@@@@@@@@@@@
@@@@...................@..........@@...........@.........@.@@@@@@@@@
............@@.........@...@.......................@.......@@@@@@@@@
..............@............@...........@...........@..@@...@@@@@@@@@
@..............@...@......@@@.....................@@........@@@@@@@@
...................@........@...........@@@..................@@@@@@@
.......@@....@.....@..........@.........@@@@@..@@............@@@@@@@
...................@@....@......@@@........@@...@...........@@@@@@@@
...................@@....@.....@@.@..@@@................@@@...@@@@@@
.....................@@..............@.............@@@@.......@@@@@@
....@..@..................................@......@@@@@@@@...@...@@@@
......@...........@.............@@@.............@@@@@@@@@....@..@@@@
.......................@......@@......@......@...@@@@@@@@...@@.@@@@@
......................................@......@@@@@@@@@.........@@@@@
..............@..............@...............@@@@.@.@@.........@@@@@
@........@...........@......@................@@@@....@@..........@@.
......@..................@...................@@@@@....@.............
.................@.......@...........@....@......@.........@........
........@....@...@....@@@@.....................@.@....@.............
.........................@.....................@...@.@@.............
@.....@...............@.@......................@@@....@@@.....@....@
@..@...........................................@@@@@..@@@.....@.....
................@..............@@...............@@@@................
.......@@.....@@@@@.............@...............@@@@.@..............
.....@.@...@@@@@@@@..............................@@@...@...........@
......@@...@....@@@...........@..@...............@@@...@...........@
....@@@@........@@@@@@@@........................@.....@@..........@@
....@@@@.......@@@@@@@@..........................................@@@
....@@@@@......@@@@@@@@...........@............................@@@@@
....@@@@........@@@@@@@@.@..@..................................@@@@@
@@@@@@@.........@@@@@@@@@@@................................@@.......
@@@@@@@...............@@@..........@..................@...@@@@@@....
@@@@@@@.................@.........@..........@..............@@.@@@..
@@@@@@.........@...........@@......@.....@@.................@@..@...
@@@...........@......@@..@@@...........@@......@....@.@@@@..........
@@@@.....@..........@@@.................@.............@......@@....@
@@@@.....@............@..........@...@@.........@...................
@@@@@......@...@@.....@...................................@.........
@@@@@......@.......@.@..@@@@..@.....@......@....@....@@@@....@@.....
@@..@.....@........@@@..@...@@.......@..@..@@.......@@@@@.@..@@...@@
@@....@...@.........@...................@@@@@.......@@@@@....@@....@
......@...................@...........@@@@@.@........@@@@@...@@@...@
.......@@....@....@....................@@.............@@.....@@@....
@.........................@............@@........@...@@......@@.....
@.........................@@@........................@...@@@@@@@@.@@
................@@@@@@.@...@@............................@..@@@@@@@@
................@@@@.....@.@@....@..@@.......................@@@@@@@
................@@@......@@@@........@..............@....@...@@@@@@@
..........@.......@.@....@@@@........@..............@........@@@@@@@
..@..............................................@...........@@@@@@@
..@.......................................@......@.......@.@@@@@@@@@
.@.@......@.@...........@@..........@......................@@@@@@@@@
@@.....@..@@............@@.@@.......@@.............@@......@@@@@@@@@
@@.......@@@..........@............................@@....@@@@@@@@@@@
@@@.@...@@@........................@..@@@..........@@...@@@@@@@@@@@@
@@@.......................@@@..@@@.@..@@@@.........@@@@@@@@@@@@@@@@@
@@@@......@...............@@@..@@@@@@@@@@@.........@@@@@@@@@@@@@@@@@
@@@...@...@.......@@......@@@..@@@@@@@@@@@@...@........@@@@@@@@@@@@@
@@@@@..............@.....@@@@@@@@@@@@@@@.@@............@@@@@@@@@@@@@
@@@@@...@@@.@......@.....@@@@@@@@@@@@@@@..@....@.@......@@@@@@@@@@@@
@@@@@@@@@@@@.......@@@@..@@@@@@@@@@@@@@........@@@.....@@@@@@@@@@@@@
@@@@@@@@@@@@....@.....@@@@@@@@@@@@@@@@@........@@@..@.@@@@@@@@@@@@@@
@@@@@@@@@@@@....@.....@@@@@@@@@@@@@@@@...@...@.@@@@@@..@@@@@@@@@@@@@
8
13 12 0
19 14 0
32 55 0
40 22 0
49 13 0
9 55 0
30 31 0
11 18 0

55 64 0
55 1 0
7 21 0
67 24 0
4 62 0
58 1 0
54 67 0
12 18 0
