width 68
height 68
@@@@@@@@@@@@@@@@@@@@@@@@@@@.................@@........@.............
@@@@@@@@@@@@@@@@@@@@@@@@....................@.@......@........@.....
@@@@@@@@@@@@@@@@@@@@@@@@@@........@.......@...@.....@@...@..........
@@@@@@@@@@@@@@@@@@@@@@@@@@....@.....@.............@@@@...@..........
@@@@@@@@@@@@@@@@@@@@@@@@@@@@@@@@@................@@@@@...@@.........
@@@@@@@@@@@@@@@@@@@@@@@@@@@@@@@@...@............@@@@@...@@@...@.....
@@@@@@@@@@@@@@@@@@@@@@@@@@@@@@@@.....@..@..........@@@........@@....
@@@@@@@@@@@@@@@@@@@@@@@@@@@@@@@@.............@.....@@@........@....@
@@@@@@@@@@@@@@@@@@@@@@@@@@@@@@@@@.............@@....@@..........@...
@@@@@@@@@@@@@@@@@@@@@@@@@@@@@@@@@...@..........@@@..@@.@@.......@...
@@@@@@@@@@@@@@@@@@@@@@@@@@@@@@@@@.@...@........@@@.....@@...........
@@@@@@@@@@@@@@@@@@@@@@@@@@@@@@@@@......................@...@@@@.....
@@@@@@@@@@@@@@@@@@@@@@@@@@@@@.@@@@...@.@................@...@.......
@@@@@@@@@@@@@@@@@@@@@@@@@@@@...@@.............@.................@@@@
@@@@@@@@@@@@@@@@@@@@@@@@@@......@.@@.........@@........@@.......@@@@
@@@@@@@@@@@@@@@@@@@@@@@@.........@@..........@@...................@@
@@@@@@@@@@@@@@@@@@@@@@@@@.......@.@..........@@...................@@
@@@@@@@@@@@@@@@@@@@@@@@@@............@@......@@.....@............@@.
@@@@@@@@@@@@@@@@@@@@@@@@@..........@.@.................@@.....@..@..
@@@@@@@@@@@@@@@@@@@@@@@@@@.........@@.....@....@...@@.........@.....
@@@@@@@@@@@@@@@@@@@@@@@@@@..................@...........@....@@.....
@@@@@@@@@@@@@@@@@@@@@@@@@@..................@....@..................
@@@@@@@@@@@@@@@@@@@@@@@@@@..................@.......................
@@@@@@@@@@@@@@@@@@@@@@@@@@...............@@@@.@@....................
@@@@@@@@@@@@@@@@@@@@@@@@...........@.....@@@@@@@@@..................
@@@@@@@@@@@@@@@@@@@@@@@@.........@@@@@@...@@@@@@@......@.........@.@
@@@@@@@@@@@@@@@@@@@@@@@@@@@@@......@@@.....@@@@.@..@.......@........
@@@@@@@@@@@@@@@@@@@@@@@@@@@@@......@@..@....@@@.@................@@@
@@@@@@@@@@@@@@@@@@@@@@@@@@@@@.....@@@.@...........@..............@@@
@@@@@@@@@@@@@@@@@@@@@@@@@@@@@....@@@..........@@@..................@
@@@@@@@@@@@@@@@@@@@@@@@@@@@@@.....@@....@.....@...................@@
@@@@@@@@@@@@@@@@@@@@@@@@@@@@@@@....@@@.........@...................@
@@@@@@@@@@@@@@@@@@@@@@@@@@@@@......@@.....................@.........
@@@@@@@@@@@@@@.....@@@@@@@@@@@.@...@@@..............................
@@@@@@@@@@@@@.....@@@@@@@@@.......@@@........@............@.........
@@@@@@@@@@@@.......@@@@@@@@@........@.....@.@@..@@..................
@@@@@@@@@@........@@@@@@@@@@........@@...@@@@@@@@@@@.......@........
@@@@@@@@@@........@@@@@@@@@@........@....@@@@@@@@@@@.@@@............
@@@@@@@@@@@@.@....@@@@@@@@@@@@.....@@.....@@@@@@@@@@...@@...........
@@@@@@@@@@@@.....@@@@@@@@@@@@@@....@@@.....@@@@@..@@................
@@@@@@@@@@@@@.@@@@@@@@@@@@@@@@@@@..@@@@@....@@..................@...
@@@@@@..@@@@@.@@@@@@@@@@@@@@@@@@@...@@@@.......................@....
@@@@@@....@.......@@@@@@@@@@@@@@....@@@@@.............@....@.@.@..@@
@@..@@............@@@@@@@@@@@.....@....@.@.................@....@@@@
....@@..@......@....@@.....@@.....@....@........................@.@@
....@@@@@...@..............@@..........@@.....@@...................@
.....@@@........................@.....@@@.@..............@........@@
.....@@@@.......@.............@@@.....@@@.....@.........@@@........@
.....@@@@............@........@@@.............@..........@@..@......
......@@@....................................@@.@..@.@..............
.......@@@....@.............@........@@.@@@@@@@..............@......
..................................@@@...@@@@@@@@.............@@@....
..............................@....@@...@@@@@@@@@...................
@......@@@.........................@.....@@@@@@......@..............
@@.....@@@@...........@..................@@@@@@.@@..................
@@.@@@.@@@@..@............................@@@......@@@@....@.....@..
....@@@@@@@.@.............................@......@@@@@@.......@.....
.....@@@@@@.........@@@........@@.........@...@..@@@@@@@............
........@@@....@.................................@@@@@@@......@.....
........@@@........@@............................@@@@@@@............
@....@...@@......@..............@.@.@...........@@@@@@@@@...@@......
.......@@@@......@@............................@@@@@@@@@...@@....@.@
....@@.@@@@@....@..........................@..@@@@@@@@@@@@@@........
........@@@@....@@.....@@@.....................@@@@@@@@@@@@...@.....
..............@@@@...@@@@....@.@...............@@@@@@@@@@@@.........
@@............@@@@@....@.....@..............@@@@@@@@@@@@@@@@........
.......................@....@@@@.....@@@@@@.@@@@@@@@@@@@@@@@@@@.....
@.....@...........@.@@......@@@@..@@@@@@@@@@@@@@@@@@@@@@@@@@@@@.....
8
60 33 0
58 20 0
3 63 0
27 17 0
55 44 0
0 56 0
58 2 0
28 35 0

21 61 0
13 39 0
62 26 0
2 66 0
58 45 0
12 47 0
15 47 0
33 46 0
