width 20
height 36
...@................
.........@...@..@...
...@.......@......@.
....................
@.@..@...@..........
.....@@.....@......@
...............@...@
...@................
..@...@..@...@.@....
....................
@....@..@.........@.
...........@...@....
.......@.@..........
.................@..
........@....@......
....@...............
.@.....@.@..@.@.....
.@....@.............
.......@............
..@........@.@..@.@.
.....@.......@......
......@.............
.@.......@..........
...........@........
....@.......@.......
...@.........@.@....
........@...........
.......@............
.....@.....@....@...
.......@......@.....
..@......@......@...
...@................
............@.......
@@........@.@@......
@@......@@..........
@....@..............
6
1 30 0
2 21 0
11 15 0
18 16 1
6 15 1
4 5 1

14 3 0
15 23 0
12 13 0
3 34 1
6 13 1
10 10 1
