width 20
height 36
....................
...............@....
...@..@.............
.@...........@...@..
@...................
....@...............
........@......@....
....................
..@..@.@............
............@..@....
.@.......@..........
........@.......@...
....@.......@......@
@.............@....@
....................
.......@............
.@...@@........@....
...@................
.........@..........
....@...............
..@.................
@@@@....@....@...@..
@@.@...@......@...@.
....@...............
....................
.......@..@..@......
..@.............@...
...............@....
...@......@.........
..............@.....
.......@...@...@....
.....@..............
................@...
@.........@..@......
@....@...@..........
....................
6
3 34 0
17 32 0
17 18 0
10 12 1
9 28 1
14 3 1

11 18 0
6 1 0
5 11 0
7 18 1
15 22 1
0 35 1
