width 20
height 36
....................
..............@.....
...........@........
...@...@............
......@.............
...@.....@.....@....
..................@.
.....@.@......@...@.
...@.......@........
..@......@......@...
.....@.....@........
...@.....@........@.
@.............@.....
.......@.@..........
.@..................
...@...@....@.......
....@...............
...............@....
....................
..@.................
...@.......@.@.@....
....@.........@...@.
......@.............
.@..................
........@...@.......
.......@...@..@.....
....@...............
..........@.......@.
....@.........@.@...
....................
......@.......@...@.
..@......@......@...
....................
@..@.....@@.........
.......@@@@.........
.......@@@@.........
6
13 15 0
10 28 0
16 30 0
3 35 1
9 27 1
8 25 1

15 23 0
6 33 0
15 24 0
10 7 1
19 5 1
11 24 1
