width 20
height 36
....................
...............@....
.@.......@.........@
................@...
............@.......
....@....@..........
......@.............
............@.......
...@....@......@....
.......@.@.@........
....................
..@....@.@...@......
.....@...........@@.
....@.............@.
.............@......
.......@............
................@...
....@.@.............
.@..............@...
.@..........@.....@.
............@@......
...@................
..@....@.......@..@.
....@.....@.........
.@..............@.@.
............@.@...@@
.......@..........@@
........@.....@...@@
..........@.........
@............@..@...
.......@.@.....@....
..........@.@......@
.....@........@.....
................@...
...@................
..........@.@.......
6
1 4 0
9 27 0
9 0 0
0 5 1
11 13 1
6 29 1

1 23 0
11 23 0
10 3 0
15 11 1
0 35 1
12 18 1
