width 20
height 36
....................
..........@.........
....@.@...@.........
.@...........@......
...@...........@.@..
.......@..@.........
.......@..........@.
....................
...................@
..@......@........@.
....................
....................
.@.....@....@....@..
....@...............
.......@..@.@.......
................@...
.............@......
..........@.........
..@...@...........@.
.......@.....@......
..............@.....
..@.................
.............@......
....@..@......@.....
...@...@............
.....@..@....@...@..
.@..............@...
.......@............
......@..@.@........
...@...........@....
.............@......
.......@............
............@.....@.
...@................
.........@........@.
....................
6
14 8 0
18 7 0
11 3 0
2 25 1
15 9 1
12 11 1

17 31 0
0 35 0
0 14 0
14 30 1
5 24 1
8 0 1
